planet_id,planet_layer_material_id,planet_layer_id,item_id,item_name,item_description,image_path,material_rarity,total_amount,prepared_amount,extracted_amount,preparable_amount,extractable_amount
3,766,3,112,Amphoteric Substances,"Amphoteric Substances are refined and crafted into components, modules and other items.",Amphoteric_Substances.png,common,5051,0,0,5051,0
3,11287,3,53,Ignis Ore,"Ignis Ore is refined and crafted into components, modules and other items.",Ignis_Ore.png,rare,851,0,0,851,0
3,11288,3,105,Silicates,"Silicates are refined and crafted into components, modules and other items.",Silicates.png,abundant,2521,0,0,2521,0
3,11289,3,54,Hyperspecular Crystals,"Hyperspecular Crystals are refined and crafted into components, modules and other items.",Hyperspecular_Crystals.png,uncommon,2544,0,0,2544,0
3,585,6103,52,Organic Compounds,"Organic Compounds are refined and crafted into components, modules and other items.",Organic_Compound.png,common,1350,1350,0,0,1350
3,586,6103,118,Platinyx,"Platinyx is refined and crafted into components, modules and other items.",Platinyx.png,uncommon,1147,230,0,917,230
3,9538,6103,42,Base Minerals,"Base Minerals are refined and crafted into components, modules and other items.",Base_Mineral.png,abundant,2987,374,0,2613,374
3,9539,6103,105,Silicates,"Silicates are refined and crafted into components, modules and other items.",Silicates.png,abundant,4386,439,0,3947,439
7,57,7,110,Plutonium,"Plutonium is refined and crafted into components, modules and other items.",Plutonium.png,common,5945,5945,0,0,5945
7,58,7,105,Silicates,"Silicates are refined and crafted into components, modules and other items.",Silicates.png,abundant,4000,4000,0,0,4000
7,155,7,105,Silicates,"Silicates are refined and crafted into components, modules and other items.",Silicates.png,abundant,2410,2410,0,0,2410
7,156,7,105,Silicates,"Silicates are refined and crafted into components, modules and other items.",Silicates.png,abundant,2571,2571,0,0,2571
7,157,7,128,Tchaikovium,"Tchaikovium is refined and crafted into components, modules and other items.",Tchaikovium.png,rare,763,763,0,0,763
7,13235,6107,110,Plutonium,"Plutonium is refined and crafted into components, modules and other items.",Plutonium.png,common,1217,1217,0,0,1217
7,13236,6107,118,Platinyx,"Platinyx is refined and crafted into components, modules and other items.",Platinyx.png,uncommon,2829,2829,0,0,2829
7,13237,6107,105,Silicates,"Silicates are refined and crafted into components, modules and other items.",Silicates.png,abundant,5752,5752,0,0,5752
10,1413,10,53,Ignis Ore,"Ignis Ore is refined and crafted into components, modules and other items.",Ignis_Ore.png,rare,884,0,0,884,0
10,1414,10,120,Metamagnetic Ore,"Metamagnetic Ore is refined and crafted into components, modules and other items.",Metamagnetic_Ore.png,uncommon,2311,0,0,2311,0
10,1415,10,106,Elastomers,"Elastomers are refined and crafted into components, modules and other items.",Elastomers.png,abundant,4458,0,0,4458,0
10,1416,6110,112,Amphoteric Substances,"Amphoteric Substances are refined and crafted into components, modules and other items.",Amphoteric_Substances.png,common,1195,0,0,1195,0
10,1417,6110,53,Ignis Ore,"Ignis Ore is refined and crafted into components, modules and other items.",Ignis_Ore.png,rare,1304,0,0,1304,0
10,1418,6110,105,Silicates,"Silicates are refined and crafted into components, modules and other items.",Silicates.png,abundant,5971,0,0,5971,0
13,187,13,107,H2O,"H2O is refined and crafted into components, modules and other items.",H20.png,abundant,2405,602,0,1803,602
13,192,13,106,Elastomers,"Elastomers are refined and crafted into components, modules and other items.",Elastomers.png,abundant,4224,0,0,4224,0
13,571,13,110,Plutonium,"Plutonium is refined and crafted into components, modules and other items.",Plutonium.png,common,1322,0,0,1322,0
13,572,6113,41,Xensium,"Xensium is refined and crafted into components, modules and other items.",Xensium.png,uncommon,2034,0,0,2034,0
13,1968,6113,120,Metamagnetic Ore,"Metamagnetic Ore is refined and crafted into components, modules and other items.",Metamagnetic_Ore.png,uncommon,1453,291,0,1162,291
13,7517,6113,40,Polymetals,"Polymetals are refined and crafted into components, modules and other items.",Polymetals.png,common,4830,0,0,4830,0
14,10297,14,110,Plutonium,"Plutonium is refined and crafted into components, modules and other items.",Plutonium.png,common,1146,0,0,1146,0
14,10367,14,119,Novis Compounds,"Novis Compounds are refined and crafted into components, modules and other items.",Novis_Compound.png,uncommon,2746,0,0,2746,0
14,10368,14,52,Organic Compounds,"Organic Compounds are refined and crafted into components, modules and other items.",Organic_Compound.png,common,2159,0,0,2159,0
14,10396,14,42,Base Minerals,"Base Minerals are refined and crafted into components, modules and other items.",Base_Mineral.png,abundant,4576,0,0,4576,0
23,1159,23,128,Tchaikovium,"Tchaikovium is refined and crafted into components, modules and other items.",Tchaikovium.png,rare,641,0,0,641,0
23,1160,23,105,Silicates,"Silicates are refined and crafted into components, modules and other items.",Silicates.png,abundant,2479,310,0,2169,310
23,1282,23,42,Base Minerals,"Base Minerals are refined and crafted into components, modules and other items.",Base_Mineral.png,abundant,5143,0,0,5143,0
23,4769,6123,121,Hypoatomic Substances,"Hypoatomic Substances are refined and crafted into components, modules and other items.",Hypoatomic_Substances.png,uncommon,1356,0,0,1356,0
23,4774,6123,40,Polymetals,"Polymetals are refined and crafted into components, modules and other items.",Polymetals.png,common,2963,0,0,2963,0
23,4805,6123,105,Silicates,"Silicates are refined and crafted into components, modules and other items.",Silicates.png,abundant,4698,0,0,4698,0
26,91,26,105,Silicates,"Silicates are refined and crafted into components, modules and other items.",Silicates.png,abundant,2527,1896,0,631,1896
26,104,26,121,Hypoatomic Substances,"Hypoatomic Substances are refined and crafted into components, modules and other items.",Hypoatomic_Substances.png,uncommon,1081,217,0,864,217
26,367,26,115,Nanofluids,"Nanofluids are refined and crafted into components, modules and other items.",Nanofluids.png,common,5551,0,0,5551,0
26,815,6126,126,Bruma Particles,"Bruma Particles are refined and crafted into components, modules and other items.",Bruma_Particle.png,rare,899,180,0,719,180
26,816,6126,121,Hypoatomic Substances,"Hypoatomic Substances are refined and crafted into components, modules and other items.",Hypoatomic_Substances.png,uncommon,1235,247,0,988,247
26,1519,6126,107,H2O,"H2O is refined and crafted into components, modules and other items.",H20.png,abundant,2185,274,0,1911,274
26,1627,6126,105,Silicates,"Silicates are refined and crafted into components, modules and other items.",Silicates.png,abundant,4180,2090,0,2090,2090
26,1628,6126,105,Silicates,"Silicates are refined and crafted into components, modules and other items.",Silicates.png,abundant,4137,2070,0,2067,2070
37,1015,37,109,Titanium,"Titanium is refined and crafted into components, modules and other items.",Titanium.png,common,1201,241,0,960,241
37,1016,37,110,Plutonium,"Plutonium is refined and crafted into components, modules and other items.",Plutonium.png,common,2044,256,0,1788,256
37,1017,37,109,Titanium,"Titanium is refined and crafted into components, modules and other items.",Titanium.png,common,2721,341,0,2380,341
37,1018,37,42,Base Minerals,"Base Minerals are refined and crafted into components, modules and other items.",Base_Mineral.png,abundant,4321,433,0,3888,433
37,1169,6137,126,Bruma Particles,"Bruma Particles are refined and crafted into components, modules and other items.",Bruma_Particle.png,rare,715,143,0,572,143
37,2225,6137,105,Silicates,"Silicates are refined and crafted into components, modules and other items.",Silicates.png,abundant,4773,956,0,3817,956
37,2274,6137,113,Aerogens,"Aerogens are refined and crafted into components, modules and other items.",Aerogens.png,common,2081,261,0,1820,261
38,873,38,106,Elastomers,"Elastomers are refined and crafted into components, modules and other items.",Elastomers.png,abundant,4437,0,0,4437,0
38,1343,38,109,Titanium,"Titanium is refined and crafted into components, modules and other items.",Titanium.png,common,2795,1050,0,1745,1050
38,4313,38,121,Hypoatomic Substances,"Hypoatomic Substances are refined and crafted into components, modules and other items.",Hypoatomic_Substances.png,uncommon,1072,0,0,1072,0
38,1117,6138,121,Hypoatomic Substances,"Hypoatomic Substances are refined and crafted into components, modules and other items.",Hypoatomic_Substances.png,uncommon,2507,0,0,2507,0
38,1212,6138,105,Silicates,"Silicates are refined and crafted into components, modules and other items.",Silicates.png,abundant,5552,556,0,4996,556
38,1307,6138,117,Yprasium,"Yprasium is refined and crafted into components, modules and other items.",Yprasium.png,uncommon,1141,0,0,1141,0
40,1824,40,118,Platinyx,"Platinyx is refined and crafted into components, modules and other items.",Platinyx.png,uncommon,1441,0,0,1441,0
40,1825,40,105,Silicates,"Silicates are refined and crafted into components, modules and other items.",Silicates.png,abundant,2406,0,0,2406,0
40,1826,40,42,Base Minerals,"Base Minerals are refined and crafted into components, modules and other items.",Base_Mineral.png,abundant,5608,0,0,5608,0
40,1827,6140,106,Elastomers,"Elastomers are refined and crafted into components, modules and other items.",Elastomers.png,abundant,2887,0,0,2887,0
40,5513,6140,106,Elastomers,"Elastomers are refined and crafted into components, modules and other items.",Elastomers.png,abundant,5912,0,0,5912,0
40,14587,6140,128,Tchaikovium,"Tchaikovium is refined and crafted into components, modules and other items.",Tchaikovium.png,rare,695,0,0,695,0
42,407,42,114,Ectopolymers,"Ectopolymers are refined and crafted into components, modules and other items.",Ectopolymers.png,common,2755,0,0,2755,0
42,418,42,119,Novis Compounds,"Novis Compounds are refined and crafted into components, modules and other items.",Novis_Compound.png,uncommon,1136,0,0,1136,0
42,489,42,105,Silicates,"Silicates are refined and crafted into components, modules and other items.",Silicates.png,abundant,5654,0,0,5654,0
42,17994,6142,120,Metamagnetic Ore,"Metamagnetic Ore is refined and crafted into components, modules and other items.",Metamagnetic_Ore.png,uncommon,1162,0,0,1162,0
42,17995,6142,110,Plutonium,"Plutonium is refined and crafted into components, modules and other items.",Plutonium.png,common,2266,0,0,2266,0
42,17996,6142,106,Elastomers,"Elastomers are refined and crafted into components, modules and other items.",Elastomers.png,abundant,5620,0,0,5620,0
47,1436,47,40,Polymetals,"Polymetals are refined and crafted into components, modules and other items.",Polymetals.png,common,1205,0,0,1205,0
47,1437,47,110,Plutonium,"Plutonium is refined and crafted into components, modules and other items.",Plutonium.png,common,2800,0,0,2800,0
47,1438,47,42,Base Minerals,"Base Minerals are refined and crafted into components, modules and other items.",Base_Mineral.png,abundant,4386,0,0,4386,0
47,1439,6147,128,Tchaikovium,"Tchaikovium is refined and crafted into components, modules and other items.",Tchaikovium.png,rare,689,0,0,689,0
47,1440,6147,42,Base Minerals,"Base Minerals are refined and crafted into components, modules and other items.",Base_Mineral.png,abundant,4906,0,0,4906,0
47,1470,6147,110,Plutonium,"Plutonium is refined and crafted into components, modules and other items.",Plutonium.png,common,2714,0,0,2714,0
48,18448,6148,40,Polymetals,"Polymetals are refined and crafted into components, modules and other items.",Polymetals.png,common,5215,0,0,5215,0
48,18449,6148,105,Silicates,"Silicates are refined and crafted into components, modules and other items.",Silicates.png,abundant,4793,0,0,4793,0
48,18450,6148,118,Platinyx,"Platinyx is refined and crafted into components, modules and other items.",Platinyx.png,uncommon,2654,0,0,2654,0
69,269,69,127,Microorganisms,"Microorganisms are refined and crafted into components, modules and other items.",Microorganism.png,rare,852,0,0,852,0
69,270,69,112,Amphoteric Substances,"Amphoteric Substances are refined and crafted into components, modules and other items.",Amphoteric_Substances.png,common,2252,0,0,2252,0
69,271,69,106,Elastomers,"Elastomers are refined and crafted into components, modules and other items.",Elastomers.png,abundant,4520,0,0,4520,0
69,3966,6169,41,Xensium,"Xensium is refined and crafted into components, modules and other items.",Xensium.png,uncommon,1056,0,0,1056,0
69,3967,6169,40,Polymetals,"Polymetals are refined and crafted into components, modules and other items.",Polymetals.png,common,2161,0,0,2161,0
69,3968,6169,41,Xensium,"Xensium is refined and crafted into components, modules and other items.",Xensium.png,uncommon,5373,0,0,5373,0
69,3969,6169,106,Elastomers,"Elastomers are refined and crafted into components, modules and other items.",Elastomers.png,abundant,4587,0,0,4587,0
70,18297,70,123,Neolysium,"Neolysium is refined and crafted into components, modules and other items.",Neolysium.png,uncommon,1479,0,0,1479,0
70,18298,70,42,Base Minerals,"Base Minerals are refined and crafted into components, modules and other items.",Base_Mineral.png,abundant,2606,0,0,2606,0
70,18299,70,115,Nanofluids,"Nanofluids are refined and crafted into components, modules and other items.",Nanofluids.png,common,5511,0,0,5511,0
70,18518,6170,115,Nanofluids,"Nanofluids are refined and crafted into components, modules and other items.",Nanofluids.png,common,1375,0,0,1375,0
70,18519,6170,109,Titanium,"Titanium is refined and crafted into components, modules and other items.",Titanium.png,common,2763,0,0,2763,0
70,18520,6170,109,Titanium,"Titanium is refined and crafted into components, modules and other items.",Titanium.png,common,4002,0,0,4002,0
71,1292,71,127,Microorganisms,"Microorganisms are refined and crafted into components, modules and other items.",Microorganism.png,rare,818,0,0,818,0
71,1326,71,42,Base Minerals,"Base Minerals are refined and crafted into components, modules and other items.",Base_Mineral.png,abundant,4694,0,0,4694,0
71,1327,71,123,Neolysium,"Neolysium is refined and crafted into components, modules and other items.",Neolysium.png,uncommon,4296,0,0,4296,0
71,1542,71,123,Neolysium,"Neolysium is refined and crafted into components, modules and other items.",Neolysium.png,uncommon,2780,0,0,2780,0
71,3970,6171,120,Metamagnetic Ore,"Metamagnetic Ore is refined and crafted into components, modules and other items.",Metamagnetic_Ore.png,uncommon,1402,0,0,1402,0
71,3971,6171,123,Neolysium,"Neolysium is refined and crafted into components, modules and other items.",Neolysium.png,uncommon,2058,0,0,2058,0
71,3972,6171,42,Base Minerals,"Base Minerals are refined and crafted into components, modules and other items.",Base_Mineral.png,abundant,4643,0,0,4643,0
74,10099,74,127,Microorganisms,"Microorganisms are refined and crafted into components, modules and other items.",Microorganism.png,rare,658,0,0,658,0
74,10132,74,113,Aerogens,"Aerogens are refined and crafted into components, modules and other items.",Aerogens.png,common,2230,0,0,2230,0
74,10231,74,113,Aerogens,"Aerogens are refined and crafted into components, modules and other items.",Aerogens.png,common,4441,0,0,4441,0
76,1137,76,52,Organic Compounds,"Organic Compounds are refined and crafted into components, modules and other items.",Organic_Compound.png,common,2349,0,0,2349,0
76,1199,76,52,Organic Compounds,"Organic Compounds are refined and crafted into components, modules and other items.",Organic_Compound.png,common,1032,0,0,1032,0
76,1286,76,107,H2O,"H2O is refined and crafted into components, modules and other items.",H20.png,abundant,5023,0,0,5023,0
76,1287,76,53,Ignis Ore,"Ignis Ore is refined and crafted into components, modules and other items.",Ignis_Ore.png,rare,2979,0,0,2979,0
78,20794,78,110,Plutonium,"Plutonium is refined and crafted into components, modules and other items.",Plutonium.png,common,2407,0,0,2407,0
78,20832,78,110,Plutonium,"Plutonium is refined and crafted into components, modules and other items.",Plutonium.png,common,1462,0,0,1462,0
78,20837,78,40,Polymetals,"Polymetals are refined and crafted into components, modules and other items.",Polymetals.png,common,4834,0,0,4834,0
82,517,82,40,Polymetals,"Polymetals are refined and crafted into components, modules and other items.",Polymetals.png,common,1123,225,0,898,225
82,518,82,112,Amphoteric Substances,"Amphoteric Substances are refined and crafted into components, modules and other items.",Amphoteric_Substances.png,common,2410,302,0,2108,302
82,519,82,42,Base Minerals,"Base Minerals are refined and crafted into components, modules and other items.",Base_Mineral.png,abundant,4230,423,0,3807,423
82,1153,6182,112,Amphoteric Substances,"Amphoteric Substances are refined and crafted into components, modules and other items.",Amphoteric_Substances.png,common,1145,229,0,916,229
82,1210,6182,109,Titanium,"Titanium is refined and crafted into components, modules and other items.",Titanium.png,common,2951,369,0,2582,369
82,2226,6182,105,Silicates,"Silicates are refined and crafted into components, modules and other items.",Silicates.png,abundant,5920,592,0,5328,592
88,1019,88,123,Neolysium,"Neolysium is refined and crafted into components, modules and other items.",Neolysium.png,uncommon,1264,253,0,1011,253
88,1020,88,107,H2O,"H2O is refined and crafted into components, modules and other items.",H20.png,abundant,5127,513,0,4614,513
88,1152,88,123,Neolysium,"Neolysium is refined and crafted into components, modules and other items.",Neolysium.png,uncommon,2729,342,0,2387,342
88,1450,6188,54,Hyperspecular Crystals,"Hyperspecular Crystals are refined and crafted into components, modules and other items.",Hyperspecular_Crystals.png,uncommon,1058,212,0,846,212
88,1451,6188,53,Ignis Ore,"Ignis Ore is refined and crafted into components, modules and other items.",Ignis_Ore.png,rare,1870,234,0,1636,234
88,1452,6188,115,Nanofluids,"Nanofluids are refined and crafted into components, modules and other items.",Nanofluids.png,common,2431,304,0,2127,304
88,2275,6188,107,H2O,"H2O is refined and crafted into components, modules and other items.",H20.png,abundant,4003,401,0,3602,401
90,6997,90,121,Hypoatomic Substances,"Hypoatomic Substances are refined and crafted into components, modules and other items.",Hypoatomic_Substances.png,uncommon,1458,0,0,1458,0
90,6998,90,106,Elastomers,"Elastomers are refined and crafted into components, modules and other items.",Elastomers.png,abundant,2446,306,0,2140,306
90,6999,90,107,H2O,"H2O is refined and crafted into components, modules and other items.",H20.png,abundant,4023,806,0,3217,806
90,7000,6190,106,Elastomers,"Elastomers are refined and crafted into components, modules and other items.",Elastomers.png,abundant,2510,0,0,2510,0
90,7001,6190,115,Nanofluids,"Nanofluids are refined and crafted into components, modules and other items.",Nanofluids.png,common,5684,0,0,5684,0
90,9821,6190,127,Microorganisms,"Microorganisms are refined and crafted into components, modules and other items.",Microorganism.png,rare,864,0,0,864,0
91,14457,91,113,Aerogens,"Aerogens are refined and crafted into components, modules and other items.",Aerogens.png,common,5725,0,0,5725,0
91,14458,91,41,Xensium,"Xensium is refined and crafted into components, modules and other items.",Xensium.png,uncommon,2146,0,0,2146,0
91,14459,91,123,Neolysium,"Neolysium is refined and crafted into components, modules and other items.",Neolysium.png,uncommon,1363,0,0,1363,0
91,14460,6191,42,Base Minerals,"Base Minerals are refined and crafted into components, modules and other items.",Base_Mineral.png,abundant,4288,0,0,4288,0
91,14461,6191,112,Amphoteric Substances,"Amphoteric Substances are refined and crafted into components, modules and other items.",Amphoteric_Substances.png,common,2361,0,0,2361,0
91,14462,6191,112,Amphoteric Substances,"Amphoteric Substances are refined and crafted into components, modules and other items.",Amphoteric_Substances.png,common,1458,0,0,1458,0
93,18557,93,128,Tchaikovium,"Tchaikovium is refined and crafted into components, modules and other items.",Tchaikovium.png,rare,1786,224,0,1562,224
93,18561,93,105,Silicates,"Silicates are refined and crafted into components, modules and other items.",Silicates.png,abundant,4097,0,0,4097,0
94,1161,94,121,Hypoatomic Substances,"Hypoatomic Substances are refined and crafted into components, modules and other items.",Hypoatomic_Substances.png,uncommon,2249,0,0,2249,0
94,1164,94,126,Bruma Particles,"Bruma Particles are refined and crafted into components, modules and other items.",Bruma_Particle.png,rare,814,0,0,814,0
94,1305,94,106,Elastomers,"Elastomers are refined and crafted into components, modules and other items.",Elastomers.png,abundant,4789,479,0,4310,479
94,4823,6194,117,Yprasium,"Yprasium is refined and crafted into components, modules and other items.",Yprasium.png,uncommon,1321,0,0,1321,0
94,4847,6194,110,Plutonium,"Plutonium is refined and crafted into components, modules and other items.",Plutonium.png,common,2290,0,0,2290,0
94,4860,6194,106,Elastomers,"Elastomers are refined and crafted into components, modules and other items.",Elastomers.png,abundant,5825,0,0,5825,0
98,177,98,119,Novis Compounds,"Novis Compounds are refined and crafted into components, modules and other items.",Novis_Compound.png,uncommon,1355,0,0,1355,0
98,315,98,42,Base Minerals,"Base Minerals are refined and crafted into components, modules and other items.",Base_Mineral.png,abundant,5490,0,0,5490,0
98,316,98,123,Neolysium,"Neolysium is refined and crafted into components, modules and other items.",Neolysium.png,uncommon,5311,0,0,5311,0
98,441,98,118,Platinyx,"Platinyx is refined and crafted into components, modules and other items.",Platinyx.png,uncommon,2220,0,0,2220,0
98,370,6198,53,Ignis Ore,"Ignis Ore is refined and crafted into components, modules and other items.",Ignis_Ore.png,rare,747,0,0,747,0
98,371,6198,109,Titanium,"Titanium is refined and crafted into components, modules and other items.",Titanium.png,common,1012,0,0,1012,0
98,701,6198,42,Base Minerals,"Base Minerals are refined and crafted into components, modules and other items.",Base_Mineral.png,abundant,2362,0,0,2362,0
98,808,6198,41,Xensium,"Xensium is refined and crafted into components, modules and other items.",Xensium.png,uncommon,5573,0,0,5573,0
99,70,99,106,Elastomers,"Elastomers are refined and crafted into components, modules and other items.",Elastomers.png,abundant,5059,5059,0,0,5059
99,184,99,54,Hyperspecular Crystals,"Hyperspecular Crystals are refined and crafted into components, modules and other items.",Hyperspecular_Crystals.png,uncommon,1352,1352,0,0,1352
99,433,99,127,Microorganisms,"Microorganisms are refined and crafted into components, modules and other items.",Microorganism.png,rare,1564,1564,0,0,1564
99,14191,6199,107,H2O,"H2O is refined and crafted into components, modules and other items.",H20.png,abundant,4817,4817,0,0,4817
99,14192,6199,114,Ectopolymers,"Ectopolymers are refined and crafted into components, modules and other items.",Ectopolymers.png,common,2629,2629,0,0,2629
99,14193,6199,54,Hyperspecular Crystals,"Hyperspecular Crystals are refined and crafted into components, modules and other items.",Hyperspecular_Crystals.png,uncommon,1008,1008,0,0,1008
101,3892,101,53,Ignis Ore,"Ignis Ore is refined and crafted into components, modules and other items.",Ignis_Ore.png,rare,1450,0,0,1450,0
101,4824,101,114,Ectopolymers,"Ectopolymers are refined and crafted into components, modules and other items.",Ectopolymers.png,common,1015,0,0,1015,0
101,20732,6201,119,Novis Compounds,"Novis Compounds are refined and crafted into components, modules and other items.",Novis_Compound.png,uncommon,1431,0,0,1431,0
104,1201,104,53,Ignis Ore,"Ignis Ore is refined and crafted into components, modules and other items.",Ignis_Ore.png,rare,759,0,0,759,0
104,1202,104,53,Ignis Ore,"Ignis Ore is refined and crafted into components, modules and other items.",Ignis_Ore.png,rare,664,0,0,664,0
104,1264,104,52,Organic Compounds,"Organic Compounds are refined and crafted into components, modules and other items.",Organic_Compound.png,common,2997,0,0,2997,0
104,1290,104,52,Organic Compounds,"Organic Compounds are refined and crafted into components, modules and other items.",Organic_Compound.png,common,5105,0,0,5105,0
106,4606,106,118,Platinyx,"Platinyx is refined and crafted into components, modules and other items.",Platinyx.png,uncommon,2728,0,0,2728,0
106,4640,106,105,Silicates,"Silicates are refined and crafted into components, modules and other items.",Silicates.png,abundant,4805,0,0,4805,0
106,4670,106,120,Metamagnetic Ore,"Metamagnetic Ore is refined and crafted into components, modules and other items.",Metamagnetic_Ore.png,uncommon,1103,0,0,1103,0
106,15948,6206,120,Metamagnetic Ore,"Metamagnetic Ore is refined and crafted into components, modules and other items.",Metamagnetic_Ore.png,uncommon,1286,0,0,1286,0
106,17359,6206,120,Metamagnetic Ore,"Metamagnetic Ore is refined and crafted into components, modules and other items.",Metamagnetic_Ore.png,uncommon,2096,0,0,2096,0
106,17360,6206,105,Silicates,"Silicates are refined and crafted into components, modules and other items.",Silicates.png,abundant,4241,0,0,4241,0
109,3346,109,53,Ignis Ore,"Ignis Ore is refined and crafted into components, modules and other items.",Ignis_Ore.png,rare,746,0,0,746,0
109,3347,109,52,Organic Compounds,"Organic Compounds are refined and crafted into components, modules and other items.",Organic_Compound.png,common,2327,0,0,2327,0
109,3348,109,105,Silicates,"Silicates are refined and crafted into components, modules and other items.",Silicates.png,abundant,5535,0,0,5535,0
112,434,112,41,Xensium,"Xensium is refined and crafted into components, modules and other items.",Xensium.png,uncommon,1168,1168,0,0,1168
112,14422,112,107,H2O,"H2O is refined and crafted into components, modules and other items.",H20.png,abundant,2555,2555,0,0,2555
112,14423,112,42,Base Minerals,"Base Minerals are refined and crafted into components, modules and other items.",Base_Mineral.png,abundant,5932,5932,0,0,5932
112,14424,112,107,H2O,"H2O is refined and crafted into components, modules and other items.",H20.png,abundant,5282,5282,0,0,5282
112,14425,6212,107,H2O,"H2O is refined and crafted into components, modules and other items.",H20.png,abundant,4411,0,0,4411,0
112,14426,6212,107,H2O,"H2O is refined and crafted into components, modules and other items.",H20.png,abundant,5673,0,0,5673,0
112,14427,6212,115,Nanofluids,"Nanofluids are refined and crafted into components, modules and other items.",Nanofluids.png,common,2920,0,0,2920,0
112,14428,6212,115,Nanofluids,"Nanofluids are refined and crafted into components, modules and other items.",Nanofluids.png,common,2182,0,0,2182,0
112,14429,6212,52,Organic Compounds,"Organic Compounds are refined and crafted into components, modules and other items.",Organic_Compound.png,common,1396,0,0,1396,0
114,14430,114,41,Xensium,"Xensium is refined and crafted into components, modules and other items.",Xensium.png,uncommon,5506,0,0,5506,0
114,14431,114,115,Nanofluids,"Nanofluids are refined and crafted into components, modules and other items.",Nanofluids.png,common,2820,0,0,2820,0
114,14432,114,41,Xensium,"Xensium is refined and crafted into components, modules and other items.",Xensium.png,uncommon,1055,0,0,1055,0
114,14433,6214,115,Nanofluids,"Nanofluids are refined and crafted into components, modules and other items.",Nanofluids.png,common,5918,0,0,5918,0
114,14434,6214,41,Xensium,"Xensium is refined and crafted into components, modules and other items.",Xensium.png,uncommon,2779,0,0,2779,0
114,14435,6214,112,Amphoteric Substances,"Amphoteric Substances are refined and crafted into components, modules and other items.",Amphoteric_Substances.png,common,1238,0,0,1238,0
115,1203,115,119,Novis Compounds,"Novis Compounds are refined and crafted into components, modules and other items.",Novis_Compound.png,uncommon,1005,0,0,1005,0
115,1204,115,128,Tchaikovium,"Tchaikovium is refined and crafted into components, modules and other items.",Tchaikovium.png,rare,708,0,0,708,0
115,1265,115,121,Hypoatomic Substances,"Hypoatomic Substances are refined and crafted into components, modules and other items.",Hypoatomic_Substances.png,uncommon,2127,0,0,2127,0
115,1458,115,110,Plutonium,"Plutonium is refined and crafted into components, modules and other items.",Plutonium.png,common,5095,0,0,5095,0
115,1459,115,107,H2O,"H2O is refined and crafted into components, modules and other items.",H20.png,abundant,4770,0,0,4770,0
117,249,117,42,Base Minerals,"Base Minerals are refined and crafted into components, modules and other items.",Base_Mineral.png,abundant,4671,0,0,4671,0
117,474,117,118,Platinyx,"Platinyx is refined and crafted into components, modules and other items.",Platinyx.png,uncommon,1342,0,0,1342,0
117,4513,117,107,H2O,"H2O is refined and crafted into components, modules and other items.",H20.png,abundant,2304,0,0,2304,0
117,4514,6217,120,Metamagnetic Ore,"Metamagnetic Ore is refined and crafted into components, modules and other items.",Metamagnetic_Ore.png,uncommon,2843,0,0,2843,0
117,4515,6217,112,Amphoteric Substances,"Amphoteric Substances are refined and crafted into components, modules and other items.",Amphoteric_Substances.png,common,5445,0,0,5445,0
118,1168,118,113,Aerogens,"Aerogens are refined and crafted into components, modules and other items.",Aerogens.png,common,4755,476,0,4279,476
118,1560,118,126,Bruma Particles,"Bruma Particles are refined and crafted into components, modules and other items.",Bruma_Particle.png,rare,872,175,0,697,175
118,2340,118,123,Neolysium,"Neolysium is refined and crafted into components, modules and other items.",Neolysium.png,uncommon,2044,256,0,1788,256
118,2341,118,123,Neolysium,"Neolysium is refined and crafted into components, modules and other items.",Neolysium.png,uncommon,2236,280,0,1956,280
118,1453,6218,126,Bruma Particles,"Bruma Particles are refined and crafted into components, modules and other items.",Bruma_Particle.png,rare,898,180,0,718,180
118,2309,6218,42,Base Minerals,"Base Minerals are refined and crafted into components, modules and other items.",Base_Mineral.png,abundant,2721,341,0,2380,341
118,2310,6218,42,Base Minerals,"Base Minerals are refined and crafted into components, modules and other items.",Base_Mineral.png,abundant,5613,562,0,5051,562
120,1283,120,112,Amphoteric Substances,"Amphoteric Substances are refined and crafted into components, modules and other items.",Amphoteric_Substances.png,common,1142,0,0,1142,0
120,1328,120,40,Polymetals,"Polymetals are refined and crafted into components, modules and other items.",Polymetals.png,common,5418,0,0,5418,0
120,1548,120,41,Xensium,"Xensium is refined and crafted into components, modules and other items.",Xensium.png,uncommon,2915,0,0,2915,0
120,3973,6220,40,Polymetals,"Polymetals are refined and crafted into components, modules and other items.",Polymetals.png,common,1475,0,0,1475,0
120,3974,6220,118,Platinyx,"Platinyx is refined and crafted into components, modules and other items.",Platinyx.png,uncommon,2258,0,0,2258,0
120,3975,6220,115,Nanofluids,"Nanofluids are refined and crafted into components, modules and other items.",Nanofluids.png,common,5065,0,0,5065,0
126,2051,126,128,Tchaikovium,"Tchaikovium is refined and crafted into components, modules and other items.",Tchaikovium.png,rare,807,162,0,645,162
126,2052,126,54,Hyperspecular Crystals,"Hyperspecular Crystals are refined and crafted into components, modules and other items.",Hyperspecular_Crystals.png,uncommon,2345,0,0,2345,0
126,2053,126,106,Elastomers,"Elastomers are refined and crafted into components, modules and other items.",Elastomers.png,abundant,5534,0,0,5534,0
126,7727,6226,114,Ectopolymers,"Ectopolymers are refined and crafted into components, modules and other items.",Ectopolymers.png,common,2172,0,0,2172,0
126,7954,6226,42,Base Minerals,"Base Minerals are refined and crafted into components, modules and other items.",Base_Mineral.png,abundant,4649,0,0,4649,0
126,7956,6226,126,Bruma Particles,"Bruma Particles are refined and crafted into components, modules and other items.",Bruma_Particle.png,rare,678,0,0,678,0
126,7957,6226,128,Tchaikovium,"Tchaikovium is refined and crafted into components, modules and other items.",Tchaikovium.png,rare,812,0,0,812,0
128,354,128,128,Tchaikovium,"Tchaikovium is refined and crafted into components, modules and other items.",Tchaikovium.png,rare,1672,0,0,1672,0
128,355,128,42,Base Minerals,"Base Minerals are refined and crafted into components, modules and other items.",Base_Mineral.png,abundant,4239,0,0,4239,0
128,360,128,118,Platinyx,"Platinyx is refined and crafted into components, modules and other items.",Platinyx.png,uncommon,1061,0,0,1061,0
136,4610,136,113,Aerogens,"Aerogens are refined and crafted into components, modules and other items.",Aerogens.png,common,1377,276,0,1101,276
136,4611,136,40,Polymetals,"Polymetals are refined and crafted into components, modules and other items.",Polymetals.png,common,1155,0,0,1155,0
136,4612,136,40,Polymetals,"Polymetals are refined and crafted into components, modules and other items.",Polymetals.png,common,2280,0,0,2280,0
136,4613,136,105,Silicates,"Silicates are refined and crafted into components, modules and other items.",Silicates.png,abundant,2500,0,0,2500,0
136,4614,136,112,Amphoteric Substances,"Amphoteric Substances are refined and crafted into components, modules and other items.",Amphoteric_Substances.png,common,4756,0,0,4756,0
136,4615,6236,41,Xensium,"Xensium is refined and crafted into components, modules and other items.",Xensium.png,uncommon,1201,0,0,1201,0
136,4616,6236,127,Microorganisms,"Microorganisms are refined and crafted into components, modules and other items.",Microorganism.png,rare,815,163,0,652,163
136,4617,6236,42,Base Minerals,"Base Minerals are refined and crafted into components, modules and other items.",Base_Mineral.png,abundant,2970,372,0,2598,372
136,4618,6236,112,Amphoteric Substances,"Amphoteric Substances are refined and crafted into components, modules and other items.",Amphoteric_Substances.png,common,2793,0,0,2793,0
136,4619,6236,106,Elastomers,"Elastomers are refined and crafted into components, modules and other items.",Elastomers.png,abundant,4044,405,0,3639,405
140,6575,140,113,Aerogens,"Aerogens are refined and crafted into components, modules and other items.",Aerogens.png,common,1034,0,0,1034,0
140,6576,140,112,Amphoteric Substances,"Amphoteric Substances are refined and crafted into components, modules and other items.",Amphoteric_Substances.png,common,2863,0,0,2863,0
140,6577,140,115,Nanofluids,"Nanofluids are refined and crafted into components, modules and other items.",Nanofluids.png,common,4164,0,0,4164,0
140,6578,140,106,Elastomers,"Elastomers are refined and crafted into components, modules and other items.",Elastomers.png,abundant,5790,0,0,5790,0
140,10694,6240,107,H2O,"H2O is refined and crafted into components, modules and other items.",H20.png,abundant,4090,0,0,4090,0
140,15841,6240,112,Amphoteric Substances,"Amphoteric Substances are refined and crafted into components, modules and other items.",Amphoteric_Substances.png,common,1393,0,0,1393,0
140,16204,6240,119,Novis Compounds,"Novis Compounds are refined and crafted into components, modules and other items.",Novis_Compound.png,uncommon,2423,0,0,2423,0
141,6572,141,126,Bruma Particles,"Bruma Particles are refined and crafted into components, modules and other items.",Bruma_Particle.png,rare,803,161,0,642,161
141,6573,141,115,Nanofluids,"Nanofluids are refined and crafted into components, modules and other items.",Nanofluids.png,common,2082,0,0,2082,0
141,6574,141,107,H2O,"H2O is refined and crafted into components, modules and other items.",H20.png,abundant,5115,0,0,5115,0
141,16336,6241,54,Hyperspecular Crystals,"Hyperspecular Crystals are refined and crafted into components, modules and other items.",Hyperspecular_Crystals.png,uncommon,1218,244,0,974,244
141,16342,6241,121,Hypoatomic Substances,"Hypoatomic Substances are refined and crafted into components, modules and other items.",Hypoatomic_Substances.png,uncommon,2046,0,0,2046,0
141,16600,6241,110,Plutonium,"Plutonium is refined and crafted into components, modules and other items.",Plutonium.png,common,5160,0,0,5160,0
143,5479,143,109,Titanium,"Titanium is refined and crafted into components, modules and other items.",Titanium.png,common,1455,291,0,1164,291
143,5480,143,123,Neolysium,"Neolysium is refined and crafted into components, modules and other items.",Neolysium.png,uncommon,2267,0,0,2267,0
143,5481,143,106,Elastomers,"Elastomers are refined and crafted into components, modules and other items.",Elastomers.png,abundant,4279,0,0,4279,0
143,6078,6243,105,Silicates,"Silicates are refined and crafted into components, modules and other items.",Silicates.png,abundant,4217,422,0,3795,422
143,11486,6243,109,Titanium,"Titanium is refined and crafted into components, modules and other items.",Titanium.png,common,1303,0,0,1303,0
143,16343,6243,106,Elastomers,"Elastomers are refined and crafted into components, modules and other items.",Elastomers.png,abundant,2171,0,0,2171,0
144,7007,144,127,Microorganisms,"Microorganisms are refined and crafted into components, modules and other items.",Microorganism.png,rare,878,176,0,702,176
144,7008,144,119,Novis Compounds,"Novis Compounds are refined and crafted into components, modules and other items.",Novis_Compound.png,uncommon,2910,0,0,2910,0
144,7009,144,107,H2O,"H2O is refined and crafted into components, modules and other items.",H20.png,abundant,4170,0,0,4170,0
144,11485,6244,107,H2O,"H2O is refined and crafted into components, modules and other items.",H20.png,abundant,4941,0,0,4941,0
144,16344,6244,127,Microorganisms,"Microorganisms are refined and crafted into components, modules and other items.",Microorganism.png,rare,869,0,0,869,0
144,16469,6244,107,H2O,"H2O is refined and crafted into components, modules and other items.",H20.png,abundant,2963,0,0,2963,0
145,7002,145,54,Hyperspecular Crystals,"Hyperspecular Crystals are refined and crafted into components, modules and other items.",Hyperspecular_Crystals.png,uncommon,1221,0,0,1221,0
145,7003,145,112,Amphoteric Substances,"Amphoteric Substances are refined and crafted into components, modules and other items.",Amphoteric_Substances.png,common,1354,0,0,1354,0
145,7004,145,119,Novis Compounds,"Novis Compounds are refined and crafted into components, modules and other items.",Novis_Compound.png,uncommon,2364,0,0,2364,0
145,7005,145,110,Plutonium,"Plutonium is refined and crafted into components, modules and other items.",Plutonium.png,common,2691,0,0,2691,0
145,7006,145,106,Elastomers,"Elastomers are refined and crafted into components, modules and other items.",Elastomers.png,abundant,4920,492,0,4428,492
145,7459,6245,42,Base Minerals,"Base Minerals are refined and crafted into components, modules and other items.",Base_Mineral.png,abundant,5209,0,0,5209,0
145,16831,6245,119,Novis Compounds,"Novis Compounds are refined and crafted into components, modules and other items.",Novis_Compound.png,uncommon,1214,0,0,1214,0
145,17295,6245,107,H2O,"H2O is refined and crafted into components, modules and other items.",H20.png,abundant,2043,0,0,2043,0
148,61,148,126,Bruma Particles,"Bruma Particles are refined and crafted into components, modules and other items.",Bruma_Particle.png,rare,816,816,0,0,816
148,62,148,126,Bruma Particles,"Bruma Particles are refined and crafted into components, modules and other items.",Bruma_Particle.png,rare,791,791,0,0,791
148,115,148,113,Aerogens,"Aerogens are refined and crafted into components, modules and other items.",Aerogens.png,common,2475,0,0,2475,0
148,345,148,107,H2O,"H2O is refined and crafted into components, modules and other items.",H20.png,abundant,4201,4201,0,0,4201
148,1907,6248,123,Neolysium,"Neolysium is refined and crafted into components, modules and other items.",Neolysium.png,uncommon,1233,0,0,1233,0
148,2153,6248,121,Hypoatomic Substances,"Hypoatomic Substances are refined and crafted into components, modules and other items.",Hypoatomic_Substances.png,uncommon,2059,0,0,2059,0
148,2408,6248,107,H2O,"H2O is refined and crafted into components, modules and other items.",H20.png,abundant,5937,5937,0,0,5937
151,6403,151,53,Ignis Ore,"Ignis Ore is refined and crafted into components, modules and other items.",Ignis_Ore.png,rare,854,0,0,854,0
151,6404,151,53,Ignis Ore,"Ignis Ore is refined and crafted into components, modules and other items.",Ignis_Ore.png,rare,790,0,0,790,0
151,6405,151,123,Neolysium,"Neolysium is refined and crafted into components, modules and other items.",Neolysium.png,uncommon,2148,0,0,2148,0
151,6406,151,112,Amphoteric Substances,"Amphoteric Substances are refined and crafted into components, modules and other items.",Amphoteric_Substances.png,common,5340,0,0,5340,0
151,6407,6251,128,Tchaikovium,"Tchaikovium is refined and crafted into components, modules and other items.",Tchaikovium.png,rare,671,135,0,536,135
151,6408,6251,42,Base Minerals,"Base Minerals are refined and crafted into components, modules and other items.",Base_Mineral.png,abundant,2468,618,0,1850,618
151,6409,6251,109,Titanium,"Titanium is refined and crafted into components, modules and other items.",Titanium.png,common,4006,802,0,3204,802
151,6410,6251,123,Neolysium,"Neolysium is refined and crafted into components, modules and other items.",Neolysium.png,uncommon,5065,0,0,5065,0
152,5119,152,127,Microorganisms,"Microorganisms are refined and crafted into components, modules and other items.",Microorganism.png,rare,609,0,0,609,0
152,5120,152,107,H2O,"H2O is refined and crafted into components, modules and other items.",H20.png,abundant,2561,0,0,2561,0
152,5121,152,52,Organic Compounds,"Organic Compounds are refined and crafted into components, modules and other items.",Organic_Compound.png,common,2798,350,0,2448,350
152,5122,152,113,Aerogens,"Aerogens are refined and crafted into components, modules and other items.",Aerogens.png,common,4433,444,0,3989,444
152,5123,152,115,Nanofluids,"Nanofluids are refined and crafted into components, modules and other items.",Nanofluids.png,common,5186,0,0,5186,0
152,15478,6252,121,Hypoatomic Substances,"Hypoatomic Substances are refined and crafted into components, modules and other items.",Hypoatomic_Substances.png,uncommon,1187,0,0,1187,0
152,15479,6252,52,Organic Compounds,"Organic Compounds are refined and crafted into components, modules and other items.",Organic_Compound.png,common,2436,0,0,2436,0
152,17374,6252,106,Elastomers,"Elastomers are refined and crafted into components, modules and other items.",Elastomers.png,abundant,5269,0,0,5269,0
152,17375,6252,107,H2O,"H2O is refined and crafted into components, modules and other items.",H20.png,abundant,5382,0,0,5382,0
156,285,156,106,Elastomers,"Elastomers are refined and crafted into components, modules and other items.",Elastomers.png,abundant,2582,0,0,2582,0
156,286,156,115,Nanofluids,"Nanofluids are refined and crafted into components, modules and other items.",Nanofluids.png,common,2435,0,0,2435,0
156,287,156,105,Silicates,"Silicates are refined and crafted into components, modules and other items.",Silicates.png,abundant,5535,0,0,5535,0
156,299,156,52,Organic Compounds,"Organic Compounds are refined and crafted into components, modules and other items.",Organic_Compound.png,common,1384,0,0,1384,0
156,3976,6256,41,Xensium,"Xensium is refined and crafted into components, modules and other items.",Xensium.png,uncommon,1386,0,0,1386,0
156,3977,6256,127,Microorganisms,"Microorganisms are refined and crafted into components, modules and other items.",Microorganism.png,rare,1416,0,0,1416,0
156,3978,6256,107,H2O,"H2O is refined and crafted into components, modules and other items.",H20.png,abundant,4730,0,0,4730,0
159,6568,159,40,Polymetals,"Polymetals are refined and crafted into components, modules and other items.",Polymetals.png,common,1108,0,0,1108,0
159,6569,159,119,Novis Compounds,"Novis Compounds are refined and crafted into components, modules and other items.",Novis_Compound.png,uncommon,2848,0,0,2848,0
159,6570,159,123,Neolysium,"Neolysium is refined and crafted into components, modules and other items.",Neolysium.png,uncommon,5240,0,0,5240,0
159,6571,6259,42,Base Minerals,"Base Minerals are refined and crafted into components, modules and other items.",Base_Mineral.png,abundant,5370,537,0,4833,537
159,17307,6259,41,Xensium,"Xensium is refined and crafted into components, modules and other items.",Xensium.png,uncommon,1452,0,0,1452,0
159,17557,6259,112,Amphoteric Substances,"Amphoteric Substances are refined and crafted into components, modules and other items.",Amphoteric_Substances.png,common,2210,0,0,2210,0
159,17558,6259,40,Polymetals,"Polymetals are refined and crafted into components, modules and other items.",Polymetals.png,common,2000,0,0,2000,0
167,7,167,120,Metamagnetic Ore,"Metamagnetic Ore is refined and crafted into components, modules and other items.",Metamagnetic_Ore.png,uncommon,1080,0,0,1080,0
167,570,167,107,H2O,"H2O is refined and crafted into components, modules and other items.",H20.png,abundant,4951,4951,0,0,4951
167,689,167,42,Base Minerals,"Base Minerals are refined and crafted into components, modules and other items.",Base_Mineral.png,abundant,2883,1083,0,1800,1083
167,1185,6267,105,Silicates,"Silicates are refined and crafted into components, modules and other items.",Silicates.png,abundant,5652,1698,0,3954,1698
167,1246,6267,53,Ignis Ore,"Ignis Ore is refined and crafted into components, modules and other items.",Ignis_Ore.png,rare,806,324,0,482,324
167,1299,6267,109,Titanium,"Titanium is refined and crafted into components, modules and other items.",Titanium.png,common,2611,2289,0,322,2289
168,9769,168,115,Nanofluids,"Nanofluids are refined and crafted into components, modules and other items.",Nanofluids.png,common,4864,0,0,4864,0
168,9770,168,114,Ectopolymers,"Ectopolymers are refined and crafted into components, modules and other items.",Ectopolymers.png,common,5437,0,0,5437,0
168,9771,168,54,Hyperspecular Crystals,"Hyperspecular Crystals are refined and crafted into components, modules and other items.",Hyperspecular_Crystals.png,uncommon,2185,0,0,2185,0
168,9772,168,128,Tchaikovium,"Tchaikovium is refined and crafted into components, modules and other items.",Tchaikovium.png,rare,880,176,0,704,176
168,17749,6268,105,Silicates,"Silicates are refined and crafted into components, modules and other items.",Silicates.png,abundant,2262,0,0,2262,0
168,19637,6268,128,Tchaikovium,"Tchaikovium is refined and crafted into components, modules and other items.",Tchaikovium.png,rare,606,0,0,606,0
168,19768,6268,105,Silicates,"Silicates are refined and crafted into components, modules and other items.",Silicates.png,abundant,5426,0,0,5426,0
171,14917,171,107,H2O,"H2O is refined and crafted into components, modules and other items.",H20.png,abundant,4837,0,0,4837,0
171,14918,171,113,Aerogens,"Aerogens are refined and crafted into components, modules and other items.",Aerogens.png,common,2964,0,0,2964,0
171,14919,171,127,Microorganisms,"Microorganisms are refined and crafted into components, modules and other items.",Microorganism.png,rare,733,0,0,733,0
171,14920,171,126,Bruma Particles,"Bruma Particles are refined and crafted into components, modules and other items.",Bruma_Particle.png,rare,898,0,0,898,0
171,14950,6271,115,Nanofluids,"Nanofluids are refined and crafted into components, modules and other items.",Nanofluids.png,common,5820,0,0,5820,0
171,14951,6271,42,Base Minerals,"Base Minerals are refined and crafted into components, modules and other items.",Base_Mineral.png,abundant,2444,0,0,2444,0
171,14952,6271,109,Titanium,"Titanium is refined and crafted into components, modules and other items.",Titanium.png,common,1368,0,0,1368,0
172,9773,172,128,Tchaikovium,"Tchaikovium is refined and crafted into components, modules and other items.",Tchaikovium.png,rare,756,0,0,756,0
172,9774,172,42,Base Minerals,"Base Minerals are refined and crafted into components, modules and other items.",Base_Mineral.png,abundant,2705,0,0,2705,0
172,9775,172,114,Ectopolymers,"Ectopolymers are refined and crafted into components, modules and other items.",Ectopolymers.png,common,2950,0,0,2950,0
172,9776,172,105,Silicates,"Silicates are refined and crafted into components, modules and other items.",Silicates.png,abundant,5319,0,0,5319,0
172,19141,6272,105,Silicates,"Silicates are refined and crafted into components, modules and other items.",Silicates.png,abundant,2226,0,0,2226,0
172,19901,6272,119,Novis Compounds,"Novis Compounds are refined and crafted into components, modules and other items.",Novis_Compound.png,uncommon,1471,0,0,1471,0
172,20032,6272,114,Ectopolymers,"Ectopolymers are refined and crafted into components, modules and other items.",Ectopolymers.png,common,4673,0,0,4673,0
179,201,179,109,Titanium,"Titanium is refined and crafted into components, modules and other items.",Titanium.png,common,1346,0,0,1346,0
179,372,179,112,Amphoteric Substances,"Amphoteric Substances are refined and crafted into components, modules and other items.",Amphoteric_Substances.png,common,4412,0,0,4412,0
179,639,179,112,Amphoteric Substances,"Amphoteric Substances are refined and crafted into components, modules and other items.",Amphoteric_Substances.png,common,2936,0,0,2936,0
179,640,179,113,Aerogens,"Aerogens are refined and crafted into components, modules and other items.",Aerogens.png,common,2673,0,0,2673,0
179,627,6279,123,Neolysium,"Neolysium is refined and crafted into components, modules and other items.",Neolysium.png,uncommon,1421,0,0,1421,0
179,763,6279,105,Silicates,"Silicates are refined and crafted into components, modules and other items.",Silicates.png,abundant,2545,0,0,2545,0
179,821,6279,112,Amphoteric Substances,"Amphoteric Substances are refined and crafted into components, modules and other items.",Amphoteric_Substances.png,common,5397,0,0,5397,0
181,9777,181,41,Xensium,"Xensium is refined and crafted into components, modules and other items.",Xensium.png,uncommon,1415,0,0,1415,0
181,9778,181,128,Tchaikovium,"Tchaikovium is refined and crafted into components, modules and other items.",Tchaikovium.png,rare,1804,0,0,1804,0
181,9779,181,106,Elastomers,"Elastomers are refined and crafted into components, modules and other items.",Elastomers.png,abundant,5583,0,0,5583,0
181,19902,6281,127,Microorganisms,"Microorganisms are refined and crafted into components, modules and other items.",Microorganism.png,rare,1513,0,0,1513,0
181,20004,6281,106,Elastomers,"Elastomers are refined and crafted into components, modules and other items.",Elastomers.png,abundant,5021,0,0,5021,0
181,20033,6281,127,Microorganisms,"Microorganisms are refined and crafted into components, modules and other items.",Microorganism.png,rare,805,0,0,805,0
183,9780,183,107,H2O,"H2O is refined and crafted into components, modules and other items.",H20.png,abundant,2717,0,0,2717,0
183,9781,183,107,H2O,"H2O is refined and crafted into components, modules and other items.",H20.png,abundant,5081,0,0,5081,0
183,13090,183,126,Bruma Particles,"Bruma Particles are refined and crafted into components, modules and other items.",Bruma_Particle.png,rare,847,0,0,847,0
183,20034,6283,53,Ignis Ore,"Ignis Ore is refined and crafted into components, modules and other items.",Ignis_Ore.png,rare,793,0,0,793,0
183,20035,6283,114,Ectopolymers,"Ectopolymers are refined and crafted into components, modules and other items.",Ectopolymers.png,common,2490,0,0,2490,0
183,20036,6283,114,Ectopolymers,"Ectopolymers are refined and crafted into components, modules and other items.",Ectopolymers.png,common,5715,0,0,5715,0
191,469,191,106,Elastomers,"Elastomers are refined and crafted into components, modules and other items.",Elastomers.png,abundant,5590,0,0,5590,0
191,624,191,40,Polymetals,"Polymetals are refined and crafted into components, modules and other items.",Polymetals.png,common,1443,0,0,1443,0
191,655,191,106,Elastomers,"Elastomers are refined and crafted into components, modules and other items.",Elastomers.png,abundant,2575,0,0,2575,0
191,641,6291,40,Polymetals,"Polymetals are refined and crafted into components, modules and other items.",Polymetals.png,common,1015,0,0,1015,0
191,867,6291,119,Novis Compounds,"Novis Compounds are refined and crafted into components, modules and other items.",Novis_Compound.png,uncommon,2465,0,0,2465,0
191,895,6291,105,Silicates,"Silicates are refined and crafted into components, modules and other items.",Silicates.png,abundant,4403,0,0,4403,0
197,19774,197,105,Silicates,"Silicates are refined and crafted into components, modules and other items.",Silicates.png,abundant,5852,586,0,5266,586
197,19775,197,119,Novis Compounds,"Novis Compounds are refined and crafted into components, modules and other items.",Novis_Compound.png,uncommon,2356,295,0,2061,295
197,19778,197,119,Novis Compounds,"Novis Compounds are refined and crafted into components, modules and other items.",Novis_Compound.png,uncommon,1461,293,0,1168,293
197,19776,6297,119,Novis Compounds,"Novis Compounds are refined and crafted into components, modules and other items.",Novis_Compound.png,uncommon,1052,211,0,841,211
197,19777,6297,112,Amphoteric Substances,"Amphoteric Substances are refined and crafted into components, modules and other items.",Amphoteric_Substances.png,common,2404,301,0,2103,301
197,19779,6297,106,Elastomers,"Elastomers are refined and crafted into components, modules and other items.",Elastomers.png,abundant,4189,419,0,3770,419
198,1205,198,112,Amphoteric Substances,"Amphoteric Substances are refined and crafted into components, modules and other items.",Amphoteric_Substances.png,common,1273,0,0,1273,0
198,1206,198,128,Tchaikovium,"Tchaikovium is refined and crafted into components, modules and other items.",Tchaikovium.png,rare,748,0,0,748,0
198,1266,198,106,Elastomers,"Elastomers are refined and crafted into components, modules and other items.",Elastomers.png,abundant,2809,0,0,2809,0
198,1267,198,120,Metamagnetic Ore,"Metamagnetic Ore is refined and crafted into components, modules and other items.",Metamagnetic_Ore.png,uncommon,2006,0,0,2006,0
198,1460,198,42,Base Minerals,"Base Minerals are refined and crafted into components, modules and other items.",Base_Mineral.png,abundant,4929,0,0,4929,0
206,1207,206,110,Plutonium,"Plutonium is refined and crafted into components, modules and other items.",Plutonium.png,common,1500,0,0,1500,0
206,2296,206,110,Plutonium,"Plutonium is refined and crafted into components, modules and other items.",Plutonium.png,common,2811,0,0,2811,0
206,2297,206,105,Silicates,"Silicates are refined and crafted into components, modules and other items.",Silicates.png,abundant,5341,0,0,5341,0
210,9782,210,52,Organic Compounds,"Organic Compounds are refined and crafted into components, modules and other items.",Organic_Compound.png,common,2674,335,0,2339,335
210,9783,210,42,Base Minerals,"Base Minerals are refined and crafted into components, modules and other items.",Base_Mineral.png,abundant,2332,0,0,2332,0
210,9784,210,115,Nanofluids,"Nanofluids are refined and crafted into components, modules and other items.",Nanofluids.png,common,4646,0,0,4646,0
210,13091,210,121,Hypoatomic Substances,"Hypoatomic Substances are refined and crafted into components, modules and other items.",Hypoatomic_Substances.png,uncommon,1388,0,0,1388,0
210,20037,6310,128,Tchaikovium,"Tchaikovium is refined and crafted into components, modules and other items.",Tchaikovium.png,rare,791,0,0,791,0
210,20038,6310,118,Platinyx,"Platinyx is refined and crafted into components, modules and other items.",Platinyx.png,uncommon,2133,0,0,2133,0
210,20039,6310,106,Elastomers,"Elastomers are refined and crafted into components, modules and other items.",Elastomers.png,abundant,4272,0,0,4272,0
210,20040,6310,115,Nanofluids,"Nanofluids are refined and crafted into components, modules and other items.",Nanofluids.png,common,5834,0,0,5834,0
213,1277,213,123,Neolysium,"Neolysium is refined and crafted into components, modules and other items.",Neolysium.png,uncommon,1060,0,0,1060,0
213,1549,213,42,Base Minerals,"Base Minerals are refined and crafted into components, modules and other items.",Base_Mineral.png,abundant,2507,0,0,2507,0
213,1583,213,105,Silicates,"Silicates are refined and crafted into components, modules and other items.",Silicates.png,abundant,4448,0,0,4448,0
213,3979,6313,123,Neolysium,"Neolysium is refined and crafted into components, modules and other items.",Neolysium.png,uncommon,1070,0,0,1070,0
213,3980,6313,112,Amphoteric Substances,"Amphoteric Substances are refined and crafted into components, modules and other items.",Amphoteric_Substances.png,common,2756,0,0,2756,0
213,3981,6313,109,Titanium,"Titanium is refined and crafted into components, modules and other items.",Titanium.png,common,5961,0,0,5961,0
214,68,214,106,Elastomers,"Elastomers are refined and crafted into components, modules and other items.",Elastomers.png,abundant,4133,0,0,4133,0
214,4216,214,115,Nanofluids,"Nanofluids are refined and crafted into components, modules and other items.",Nanofluids.png,common,2801,0,0,2801,0
214,12871,214,117,Yprasium,"Yprasium is refined and crafted into components, modules and other items.",Yprasium.png,uncommon,1130,0,0,1130,0
214,4318,6314,127,Microorganisms,"Microorganisms are refined and crafted into components, modules and other items.",Microorganism.png,rare,775,0,0,775,0
214,17460,6314,121,Hypoatomic Substances,"Hypoatomic Substances are refined and crafted into components, modules and other items.",Hypoatomic_Substances.png,uncommon,2988,0,0,2988,0
219,2948,219,106,Elastomers,"Elastomers are refined and crafted into components, modules and other items.",Elastomers.png,abundant,4545,0,0,4545,0
219,3357,219,126,Bruma Particles,"Bruma Particles are refined and crafted into components, modules and other items.",Bruma_Particle.png,rare,1523,1337,0,186,1337
219,3575,219,127,Microorganisms,"Microorganisms are refined and crafted into components, modules and other items.",Microorganism.png,rare,635,508,0,127,508
219,5520,6319,106,Elastomers,"Elastomers are refined and crafted into components, modules and other items.",Elastomers.png,abundant,2276,0,0,2276,0
219,5521,6319,127,Microorganisms,"Microorganisms are refined and crafted into components, modules and other items.",Microorganism.png,rare,1828,1374,0,454,1374
219,7696,6319,113,Aerogens,"Aerogens are refined and crafted into components, modules and other items.",Aerogens.png,common,1421,0,0,1421,0
219,7697,6319,52,Organic Compounds,"Organic Compounds are refined and crafted into components, modules and other items.",Organic_Compound.png,common,1081,0,0,1081,0
219,7824,6319,106,Elastomers,"Elastomers are refined and crafted into components, modules and other items.",Elastomers.png,abundant,5567,0,0,5567,0
222,14983,222,106,Elastomers,"Elastomers are refined and crafted into components, modules and other items.",Elastomers.png,abundant,5067,0,0,5067,0
222,14984,222,42,Base Minerals,"Base Minerals are refined and crafted into components, modules and other items.",Base_Mineral.png,abundant,2912,0,0,2912,0
222,14985,222,128,Tchaikovium,"Tchaikovium is refined and crafted into components, modules and other items.",Tchaikovium.png,rare,876,0,0,876,0
222,14986,6322,106,Elastomers,"Elastomers are refined and crafted into components, modules and other items.",Elastomers.png,abundant,4514,0,0,4514,0
222,14987,6322,106,Elastomers,"Elastomers are refined and crafted into components, modules and other items.",Elastomers.png,abundant,5111,0,0,5111,0
222,14988,6322,52,Organic Compounds,"Organic Compounds are refined and crafted into components, modules and other items.",Organic_Compound.png,common,2892,0,0,2892,0
222,14989,6322,41,Xensium,"Xensium is refined and crafted into components, modules and other items.",Xensium.png,uncommon,1048,0,0,1048,0
225,6074,225,126,Bruma Particles,"Bruma Particles are refined and crafted into components, modules and other items.",Bruma_Particle.png,rare,665,0,0,665,0
225,6075,225,109,Titanium,"Titanium is refined and crafted into components, modules and other items.",Titanium.png,common,2255,0,0,2255,0
225,6076,225,42,Base Minerals,"Base Minerals are refined and crafted into components, modules and other items.",Base_Mineral.png,abundant,4033,0,0,4033,0
225,6077,6325,107,H2O,"H2O is refined and crafted into components, modules and other items.",H20.png,abundant,5925,0,0,5925,0
225,20041,6325,126,Bruma Particles,"Bruma Particles are refined and crafted into components, modules and other items.",Bruma_Particle.png,rare,713,0,0,713,0
225,20042,6325,109,Titanium,"Titanium is refined and crafted into components, modules and other items.",Titanium.png,common,1249,0,0,1249,0
225,20043,6325,109,Titanium,"Titanium is refined and crafted into components, modules and other items.",Titanium.png,common,2954,0,0,2954,0
225,20044,6325,107,H2O,"H2O is refined and crafted into components, modules and other items.",H20.png,abundant,2509,0,0,2509,0
228,14990,228,106,Elastomers,"Elastomers are refined and crafted into components, modules and other items.",Elastomers.png,abundant,5904,0,0,5904,0
228,14991,228,115,Nanofluids,"Nanofluids are refined and crafted into components, modules and other items.",Nanofluids.png,common,2441,0,0,2441,0
228,14992,228,127,Microorganisms,"Microorganisms are refined and crafted into components, modules and other items.",Microorganism.png,rare,858,0,0,858,0
228,14993,6328,106,Elastomers,"Elastomers are refined and crafted into components, modules and other items.",Elastomers.png,abundant,4212,0,0,4212,0
228,14994,6328,52,Organic Compounds,"Organic Compounds are refined and crafted into components, modules and other items.",Organic_Compound.png,common,2769,0,0,2769,0
228,14995,6328,123,Neolysium,"Neolysium is refined and crafted into components, modules and other items.",Neolysium.png,uncommon,1013,0,0,1013,0
229,568,229,126,Bruma Particles,"Bruma Particles are refined and crafted into components, modules and other items.",Bruma_Particle.png,rare,673,673,0,0,673
229,569,229,52,Organic Compounds,"Organic Compounds are refined and crafted into components, modules and other items.",Organic_Compound.png,common,5878,5878,0,0,5878
229,690,229,118,Platinyx,"Platinyx is refined and crafted into components, modules and other items.",Platinyx.png,uncommon,2877,2877,0,0,2877
229,1248,6329,52,Organic Compounds,"Organic Compounds are refined and crafted into components, modules and other items.",Organic_Compound.png,common,1370,1370,0,0,1370
229,1511,6329,54,Hyperspecular Crystals,"Hyperspecular Crystals are refined and crafted into components, modules and other items.",Hyperspecular_Crystals.png,uncommon,2709,2709,0,0,2709
229,1512,6329,106,Elastomers,"Elastomers are refined and crafted into components, modules and other items.",Elastomers.png,abundant,5326,5326,0,0,5326
231,1461,231,128,Tchaikovium,"Tchaikovium is refined and crafted into components, modules and other items.",Tchaikovium.png,rare,898,0,0,898,0
231,2298,231,110,Plutonium,"Plutonium is refined and crafted into components, modules and other items.",Plutonium.png,common,2436,0,0,2436,0
231,2299,231,114,Ectopolymers,"Ectopolymers are refined and crafted into components, modules and other items.",Ectopolymers.png,common,4624,0,0,4624,0
232,9785,232,52,Organic Compounds,"Organic Compounds are refined and crafted into components, modules and other items.",Organic_Compound.png,common,2336,0,0,2336,0
232,9786,232,106,Elastomers,"Elastomers are refined and crafted into components, modules and other items.",Elastomers.png,abundant,4935,0,0,4935,0
232,14629,232,114,Ectopolymers,"Ectopolymers are refined and crafted into components, modules and other items.",Ectopolymers.png,common,1384,0,0,1384,0
232,20045,6332,118,Platinyx,"Platinyx is refined and crafted into components, modules and other items.",Platinyx.png,uncommon,1307,0,0,1307,0
232,20046,6332,114,Ectopolymers,"Ectopolymers are refined and crafted into components, modules and other items.",Ectopolymers.png,common,2081,0,0,2081,0
232,20047,6332,114,Ectopolymers,"Ectopolymers are refined and crafted into components, modules and other items.",Ectopolymers.png,common,2256,0,0,2256,0
232,20048,6332,105,Silicates,"Silicates are refined and crafted into components, modules and other items.",Silicates.png,abundant,4261,0,0,4261,0
233,1594,233,107,H2O,"H2O is refined and crafted into components, modules and other items.",H20.png,abundant,4136,828,0,3308,828
233,1684,233,127,Microorganisms,"Microorganisms are refined and crafted into components, modules and other items.",Microorganism.png,rare,882,882,0,0,882
233,1685,233,54,Hyperspecular Crystals,"Hyperspecular Crystals are refined and crafted into components, modules and other items.",Hyperspecular_Crystals.png,uncommon,1140,0,0,1140,0
233,1947,233,42,Base Minerals,"Base Minerals are refined and crafted into components, modules and other items.",Base_Mineral.png,abundant,2392,0,0,2392,0
233,1686,6333,107,H2O,"H2O is refined and crafted into components, modules and other items.",H20.png,abundant,2315,0,0,2315,0
233,2024,6333,113,Aerogens,"Aerogens are refined and crafted into components, modules and other items.",Aerogens.png,common,1404,0,0,1404,0
233,4325,6333,42,Base Minerals,"Base Minerals are refined and crafted into components, modules and other items.",Base_Mineral.png,abundant,5854,0,0,5854,0
244,694,244,53,Ignis Ore,"Ignis Ore is refined and crafted into components, modules and other items.",Ignis_Ore.png,rare,792,159,0,633,159
244,773,244,105,Silicates,"Silicates are refined and crafted into components, modules and other items.",Silicates.png,abundant,2722,1364,0,1358,1364
244,800,244,105,Silicates,"Silicates are refined and crafted into components, modules and other items.",Silicates.png,abundant,5502,2755,0,2747,2755
244,1667,6344,121,Hypoatomic Substances,"Hypoatomic Substances are refined and crafted into components, modules and other items.",Hypoatomic_Substances.png,uncommon,2611,0,0,2611,0
244,1690,6344,105,Silicates,"Silicates are refined and crafted into components, modules and other items.",Silicates.png,abundant,5387,539,0,4848,539
244,1733,6344,54,Hyperspecular Crystals,"Hyperspecular Crystals are refined and crafted into components, modules and other items.",Hyperspecular_Crystals.png,uncommon,1453,0,0,1453,0
244,1734,6344,123,Neolysium,"Neolysium is refined and crafted into components, modules and other items.",Neolysium.png,uncommon,1158,232,0,926,232
246,1462,246,126,Bruma Particles,"Bruma Particles are refined and crafted into components, modules and other items.",Bruma_Particle.png,rare,678,0,0,678,0
246,2690,246,123,Neolysium,"Neolysium is refined and crafted into components, modules and other items.",Neolysium.png,uncommon,2998,0,0,2998,0
246,2691,246,107,H2O,"H2O is refined and crafted into components, modules and other items.",H20.png,abundant,4890,0,0,4890,0
255,9787,255,115,Nanofluids,"Nanofluids are refined and crafted into components, modules and other items.",Nanofluids.png,common,2336,0,0,2336,0
255,9788,255,115,Nanofluids,"Nanofluids are refined and crafted into components, modules and other items.",Nanofluids.png,common,4612,0,0,4612,0
255,14630,255,123,Neolysium,"Neolysium is refined and crafted into components, modules and other items.",Neolysium.png,uncommon,1500,0,0,1500,0
255,20049,6355,115,Nanofluids,"Nanofluids are refined and crafted into components, modules and other items.",Nanofluids.png,common,1325,0,0,1325,0
255,20050,6355,42,Base Minerals,"Base Minerals are refined and crafted into components, modules and other items.",Base_Mineral.png,abundant,2647,0,0,2647,0
255,20051,6355,105,Silicates,"Silicates are refined and crafted into components, modules and other items.",Silicates.png,abundant,5329,0,0,5329,0
266,2826,266,120,Metamagnetic Ore,"Metamagnetic Ore is refined and crafted into components, modules and other items.",Metamagnetic_Ore.png,uncommon,1373,0,0,1373,0
266,2827,266,127,Microorganisms,"Microorganisms are refined and crafted into components, modules and other items.",Microorganism.png,rare,809,0,0,809,0
266,2828,266,42,Base Minerals,"Base Minerals are refined and crafted into components, modules and other items.",Base_Mineral.png,abundant,4902,0,0,4902,0
267,9064,267,107,H2O,"H2O is refined and crafted into components, modules and other items.",H20.png,abundant,5854,0,0,5854,0
267,9065,267,126,Bruma Particles,"Bruma Particles are refined and crafted into components, modules and other items.",Bruma_Particle.png,rare,727,0,0,727,0
267,9066,267,110,Plutonium,"Plutonium is refined and crafted into components, modules and other items.",Plutonium.png,common,2735,0,0,2735,0
267,9067,6367,114,Ectopolymers,"Ectopolymers are refined and crafted into components, modules and other items.",Ectopolymers.png,common,1245,0,0,1245,0
267,9068,6367,117,Yprasium,"Yprasium is refined and crafted into components, modules and other items.",Yprasium.png,uncommon,2332,0,0,2332,0
267,9069,6367,105,Silicates,"Silicates are refined and crafted into components, modules and other items.",Silicates.png,abundant,4191,0,0,4191,0
268,4534,268,113,Aerogens,"Aerogens are refined and crafted into components, modules and other items.",Aerogens.png,common,2444,0,0,2444,0
268,4699,268,117,Yprasium,"Yprasium is refined and crafted into components, modules and other items.",Yprasium.png,uncommon,1212,0,0,1212,0
268,4747,268,105,Silicates,"Silicates are refined and crafted into components, modules and other items.",Silicates.png,abundant,4200,0,0,4200,0
270,65,270,123,Neolysium,"Neolysium is refined and crafted into components, modules and other items.",Neolysium.png,uncommon,1310,0,0,1310,0
270,149,270,123,Neolysium,"Neolysium is refined and crafted into components, modules and other items.",Neolysium.png,uncommon,2353,0,0,2353,0
270,589,270,109,Titanium,"Titanium is refined and crafted into components, modules and other items.",Titanium.png,common,4614,0,0,4614,0
270,2156,6370,54,Hyperspecular Crystals,"Hyperspecular Crystals are refined and crafted into components, modules and other items.",Hyperspecular_Crystals.png,uncommon,1446,0,0,1446,0
270,3521,6370,105,Silicates,"Silicates are refined and crafted into components, modules and other items.",Silicates.png,abundant,2100,526,0,1574,526
270,4685,6370,105,Silicates,"Silicates are refined and crafted into components, modules and other items.",Silicates.png,abundant,4199,0,0,4199,0
275,51,275,107,H2O,"H2O is refined and crafted into components, modules and other items.",H20.png,abundant,4366,874,0,3492,874
275,59,275,109,Titanium,"Titanium is refined and crafted into components, modules and other items.",Titanium.png,common,2532,634,0,1898,634
275,2430,275,123,Neolysium,"Neolysium is refined and crafted into components, modules and other items.",Neolysium.png,uncommon,1249,250,0,999,250
275,13729,6375,120,Metamagnetic Ore,"Metamagnetic Ore is refined and crafted into components, modules and other items.",Metamagnetic_Ore.png,uncommon,1158,0,0,1158,0
275,13730,6375,42,Base Minerals,"Base Minerals are refined and crafted into components, modules and other items.",Base_Mineral.png,abundant,2818,0,0,2818,0
275,13731,6375,112,Amphoteric Substances,"Amphoteric Substances are refined and crafted into components, modules and other items.",Amphoteric_Substances.png,common,4106,0,0,4106,0
287,3956,287,117,Yprasium,"Yprasium is refined and crafted into components, modules and other items.",Yprasium.png,uncommon,1082,0,0,1082,0
287,3957,287,42,Base Minerals,"Base Minerals are refined and crafted into components, modules and other items.",Base_Mineral.png,abundant,2724,0,0,2724,0
287,7888,287,105,Silicates,"Silicates are refined and crafted into components, modules and other items.",Silicates.png,abundant,4506,0,0,4506,0
287,7889,6387,106,Elastomers,"Elastomers are refined and crafted into components, modules and other items.",Elastomers.png,abundant,2564,0,0,2564,0
289,780,289,120,Metamagnetic Ore,"Metamagnetic Ore is refined and crafted into components, modules and other items.",Metamagnetic_Ore.png,uncommon,2300,288,0,2012,288
289,801,289,41,Xensium,"Xensium is refined and crafted into components, modules and other items.",Xensium.png,uncommon,1497,0,0,1497,0
289,802,289,42,Base Minerals,"Base Minerals are refined and crafted into components, modules and other items.",Base_Mineral.png,abundant,5661,2835,0,2826,2835
289,2452,6389,123,Neolysium,"Neolysium is refined and crafted into components, modules and other items.",Neolysium.png,uncommon,1026,206,0,820,206
289,2725,6389,42,Base Minerals,"Base Minerals are refined and crafted into components, modules and other items.",Base_Mineral.png,abundant,4019,402,0,3617,402
289,2778,6389,109,Titanium,"Titanium is refined and crafted into components, modules and other items.",Titanium.png,common,2633,0,0,2633,0
290,1595,290,40,Polymetals,"Polymetals are refined and crafted into components, modules and other items.",Polymetals.png,common,5141,0,0,5141,0
290,1687,290,110,Plutonium,"Plutonium is refined and crafted into components, modules and other items.",Plutonium.png,common,1095,0,0,1095,0
290,1948,290,110,Plutonium,"Plutonium is refined and crafted into components, modules and other items.",Plutonium.png,common,2536,0,0,2536,0
290,1742,6390,54,Hyperspecular Crystals,"Hyperspecular Crystals are refined and crafted into components, modules and other items.",Hyperspecular_Crystals.png,uncommon,2831,0,0,2831,0
290,2372,6390,105,Silicates,"Silicates are refined and crafted into components, modules and other items.",Silicates.png,abundant,4445,0,0,4445,0
290,3921,6390,120,Metamagnetic Ore,"Metamagnetic Ore is refined and crafted into components, modules and other items.",Metamagnetic_Ore.png,uncommon,1466,0,0,1466,0
296,1923,296,52,Organic Compounds,"Organic Compounds are refined and crafted into components, modules and other items.",Organic_Compound.png,common,5467,0,0,5467,0
296,7795,296,118,Platinyx,"Platinyx is refined and crafted into components, modules and other items.",Platinyx.png,uncommon,1226,0,0,1226,0
296,7796,296,126,Bruma Particles,"Bruma Particles are refined and crafted into components, modules and other items.",Bruma_Particle.png,rare,610,0,0,610,0
296,7804,296,114,Ectopolymers,"Ectopolymers are refined and crafted into components, modules and other items.",Ectopolymers.png,common,2828,0,0,2828,0
296,7955,6396,53,Ignis Ore,"Ignis Ore is refined and crafted into components, modules and other items.",Ignis_Ore.png,rare,694,0,0,694,0
296,8020,6396,114,Ectopolymers,"Ectopolymers are refined and crafted into components, modules and other items.",Ectopolymers.png,common,2062,0,0,2062,0
296,16072,6396,52,Organic Compounds,"Organic Compounds are refined and crafted into components, modules and other items.",Organic_Compound.png,common,4411,0,0,4411,0
297,1463,297,53,Ignis Ore,"Ignis Ore is refined and crafted into components, modules and other items.",Ignis_Ore.png,rare,769,0,0,769,0
297,2692,297,113,Aerogens,"Aerogens are refined and crafted into components, modules and other items.",Aerogens.png,common,2348,0,0,2348,0
297,2693,297,105,Silicates,"Silicates are refined and crafted into components, modules and other items.",Silicates.png,abundant,5077,0,0,5077,0
303,2477,303,40,Polymetals,"Polymetals are refined and crafted into components, modules and other items.",Polymetals.png,common,1303,0,0,1303,0
303,3948,303,107,H2O,"H2O is refined and crafted into components, modules and other items.",H20.png,abundant,5861,0,0,5861,0
303,4707,303,41,Xensium,"Xensium is refined and crafted into components, modules and other items.",Xensium.png,uncommon,2835,0,0,2835,0
303,2942,6403,40,Polymetals,"Polymetals are refined and crafted into components, modules and other items.",Polymetals.png,common,2015,0,0,2015,0
303,3887,6403,127,Microorganisms,"Microorganisms are refined and crafted into components, modules and other items.",Microorganism.png,rare,715,143,0,572,143
303,3928,6403,40,Polymetals,"Polymetals are refined and crafted into components, modules and other items.",Polymetals.png,common,4042,0,0,4042,0
308,17623,308,126,Bruma Particles,"Bruma Particles are refined and crafted into components, modules and other items.",Bruma_Particle.png,rare,728,0,0,728,0
308,17689,308,110,Plutonium,"Plutonium is refined and crafted into components, modules and other items.",Plutonium.png,common,5002,0,0,5002,0
308,17798,308,115,Nanofluids,"Nanofluids are refined and crafted into components, modules and other items.",Nanofluids.png,common,2704,0,0,2704,0
312,318,312,106,Elastomers,"Elastomers are refined and crafted into components, modules and other items.",Elastomers.png,abundant,2190,0,0,2190,0
312,319,312,105,Silicates,"Silicates are refined and crafted into components, modules and other items.",Silicates.png,abundant,5483,0,0,5483,0
312,394,312,117,Yprasium,"Yprasium is refined and crafted into components, modules and other items.",Yprasium.png,uncommon,1224,0,0,1224,0
312,3982,6412,119,Novis Compounds,"Novis Compounds are refined and crafted into components, modules and other items.",Novis_Compound.png,uncommon,1479,0,0,1479,0
312,3983,6412,52,Organic Compounds,"Organic Compounds are refined and crafted into components, modules and other items.",Organic_Compound.png,common,2278,0,0,2278,0
312,3984,6412,106,Elastomers,"Elastomers are refined and crafted into components, modules and other items.",Elastomers.png,abundant,5302,0,0,5302,0
317,16536,6417,128,Tchaikovium,"Tchaikovium is refined and crafted into components, modules and other items.",Tchaikovium.png,rare,663,0,0,663,0
324,14632,324,128,Tchaikovium,"Tchaikovium is refined and crafted into components, modules and other items.",Tchaikovium.png,rare,643,0,0,643,0
324,14633,324,54,Hyperspecular Crystals,"Hyperspecular Crystals are refined and crafted into components, modules and other items.",Hyperspecular_Crystals.png,uncommon,1497,0,0,1497,0
324,14634,324,128,Tchaikovium,"Tchaikovium is refined and crafted into components, modules and other items.",Tchaikovium.png,rare,1512,0,0,1512,0
332,2943,332,53,Ignis Ore,"Ignis Ore is refined and crafted into components, modules and other items.",Ignis_Ore.png,rare,763,0,0,763,0
332,2944,332,112,Amphoteric Substances,"Amphoteric Substances are refined and crafted into components, modules and other items.",Amphoteric_Substances.png,common,4751,0,0,4751,0
333,19780,333,127,Microorganisms,"Microorganisms are refined and crafted into components, modules and other items.",Microorganism.png,rare,612,123,0,489,123
333,19781,333,112,Amphoteric Substances,"Amphoteric Substances are refined and crafted into components, modules and other items.",Amphoteric_Substances.png,common,2507,314,0,2193,314
333,19782,333,53,Ignis Ore,"Ignis Ore is refined and crafted into components, modules and other items.",Ignis_Ore.png,rare,3636,364,0,3272,364
333,19783,6433,53,Ignis Ore,"Ignis Ore is refined and crafted into components, modules and other items.",Ignis_Ore.png,rare,805,161,0,644,161
333,19784,6433,112,Amphoteric Substances,"Amphoteric Substances are refined and crafted into components, modules and other items.",Amphoteric_Substances.png,common,2007,0,0,2007,0
333,19785,6433,105,Silicates,"Silicates are refined and crafted into components, modules and other items.",Silicates.png,abundant,4440,444,0,3996,444
336,279,336,107,H2O,"H2O is refined and crafted into components, modules and other items.",H20.png,abundant,5142,0,0,5142,0
336,300,336,117,Yprasium,"Yprasium is refined and crafted into components, modules and other items.",Yprasium.png,uncommon,2382,0,0,2382,0
336,302,336,127,Microorganisms,"Microorganisms are refined and crafted into components, modules and other items.",Microorganism.png,rare,686,0,0,686,0
336,3985,6436,53,Ignis Ore,"Ignis Ore is refined and crafted into components, modules and other items.",Ignis_Ore.png,rare,618,0,0,618,0
336,3986,6436,52,Organic Compounds,"Organic Compounds are refined and crafted into components, modules and other items.",Organic_Compound.png,common,2401,0,0,2401,0
336,3987,6436,52,Organic Compounds,"Organic Compounds are refined and crafted into components, modules and other items.",Organic_Compound.png,common,4399,0,0,4399,0
342,17414,342,40,Polymetals,"Polymetals are refined and crafted into components, modules and other items.",Polymetals.png,common,1358,0,0,1358,0
342,17415,342,109,Titanium,"Titanium is refined and crafted into components, modules and other items.",Titanium.png,common,2953,0,0,2953,0
342,17416,342,113,Aerogens,"Aerogens are refined and crafted into components, modules and other items.",Aerogens.png,common,5347,0,0,5347,0
344,9789,344,107,H2O,"H2O is refined and crafted into components, modules and other items.",H20.png,abundant,2996,0,0,2996,0
344,9790,344,106,Elastomers,"Elastomers are refined and crafted into components, modules and other items.",Elastomers.png,abundant,4296,0,0,4296,0
344,14631,344,127,Microorganisms,"Microorganisms are refined and crafted into components, modules and other items.",Microorganism.png,rare,622,0,0,622,0
344,20052,6444,127,Microorganisms,"Microorganisms are refined and crafted into components, modules and other items.",Microorganism.png,rare,879,0,0,879,0
344,20053,6444,42,Base Minerals,"Base Minerals are refined and crafted into components, modules and other items.",Base_Mineral.png,abundant,2985,0,0,2985,0
344,20054,6444,107,H2O,"H2O is refined and crafted into components, modules and other items.",H20.png,abundant,4058,0,0,4058,0
346,18009,346,40,Polymetals,"Polymetals are refined and crafted into components, modules and other items.",Polymetals.png,common,4883,0,0,4883,0
346,18253,346,40,Polymetals,"Polymetals are refined and crafted into components, modules and other items.",Polymetals.png,common,1191,0,0,1191,0
346,18351,346,40,Polymetals,"Polymetals are refined and crafted into components, modules and other items.",Polymetals.png,common,2567,0,0,2567,0
346,18354,6446,107,H2O,"H2O is refined and crafted into components, modules and other items.",H20.png,abundant,5297,0,0,5297,0
346,18581,6446,42,Base Minerals,"Base Minerals are refined and crafted into components, modules and other items.",Base_Mineral.png,abundant,2530,0,0,2530,0
346,18778,6446,128,Tchaikovium,"Tchaikovium is refined and crafted into components, modules and other items.",Tchaikovium.png,rare,773,0,0,773,0
347,9791,347,110,Plutonium,"Plutonium is refined and crafted into components, modules and other items.",Plutonium.png,common,2225,0,0,2225,0
347,9792,347,110,Plutonium,"Plutonium is refined and crafted into components, modules and other items.",Plutonium.png,common,4690,0,0,4690,0
347,14719,347,109,Titanium,"Titanium is refined and crafted into components, modules and other items.",Titanium.png,common,1077,0,0,1077,0
347,20098,6447,114,Ectopolymers,"Ectopolymers are refined and crafted into components, modules and other items.",Ectopolymers.png,common,1460,0,0,1460,0
347,20099,6447,107,H2O,"H2O is refined and crafted into components, modules and other items.",H20.png,abundant,4954,0,0,4954,0
347,20329,6447,110,Plutonium,"Plutonium is refined and crafted into components, modules and other items.",Plutonium.png,common,2085,0,0,2085,0
348,6040,348,54,Hyperspecular Crystals,"Hyperspecular Crystals are refined and crafted into components, modules and other items.",Hyperspecular_Crystals.png,uncommon,2894,0,0,2894,0
348,7508,348,128,Tchaikovium,"Tchaikovium is refined and crafted into components, modules and other items.",Tchaikovium.png,rare,837,0,0,837,0
350,1562,350,112,Amphoteric Substances,"Amphoteric Substances are refined and crafted into components, modules and other items.",Amphoteric_Substances.png,common,1189,0,0,1189,0
350,1588,350,52,Organic Compounds,"Organic Compounds are refined and crafted into components, modules and other items.",Organic_Compound.png,common,5604,0,0,5604,0
350,1766,350,123,Neolysium,"Neolysium is refined and crafted into components, modules and other items.",Neolysium.png,uncommon,2340,0,0,2340,0
350,3988,6450,127,Microorganisms,"Microorganisms are refined and crafted into components, modules and other items.",Microorganism.png,rare,649,0,0,649,0
350,3989,6450,119,Novis Compounds,"Novis Compounds are refined and crafted into components, modules and other items.",Novis_Compound.png,uncommon,1002,0,0,1002,0
350,3990,6450,105,Silicates,"Silicates are refined and crafted into components, modules and other items.",Silicates.png,abundant,2619,0,0,2619,0
350,3991,6450,41,Xensium,"Xensium is refined and crafted into components, modules and other items.",Xensium.png,uncommon,4681,0,0,4681,0
350,3992,6450,106,Elastomers,"Elastomers are refined and crafted into components, modules and other items.",Elastomers.png,abundant,4347,0,0,4347,0
352,18300,352,127,Microorganisms,"Microorganisms are refined and crafted into components, modules and other items.",Microorganism.png,rare,778,0,0,778,0
352,18301,352,127,Microorganisms,"Microorganisms are refined and crafted into components, modules and other items.",Microorganism.png,rare,1826,0,0,1826,0
352,18302,352,40,Polymetals,"Polymetals are refined and crafted into components, modules and other items.",Polymetals.png,common,4917,0,0,4917,0
356,548,356,114,Ectopolymers,"Ectopolymers are refined and crafted into components, modules and other items.",Ectopolymers.png,common,1487,0,0,1487,0
356,553,356,106,Elastomers,"Elastomers are refined and crafted into components, modules and other items.",Elastomers.png,abundant,5927,0,0,5927,0
356,554,356,106,Elastomers,"Elastomers are refined and crafted into components, modules and other items.",Elastomers.png,abundant,2830,0,0,2830,0
356,17997,6456,128,Tchaikovium,"Tchaikovium is refined and crafted into components, modules and other items.",Tchaikovium.png,rare,881,0,0,881,0
356,17998,6456,54,Hyperspecular Crystals,"Hyperspecular Crystals are refined and crafted into components, modules and other items.",Hyperspecular_Crystals.png,uncommon,2500,0,0,2500,0
356,17999,6456,105,Silicates,"Silicates are refined and crafted into components, modules and other items.",Silicates.png,abundant,5128,0,0,5128,0
357,275,357,126,Bruma Particles,"Bruma Particles are refined and crafted into components, modules and other items.",Bruma_Particle.png,rare,3032,0,0,3032,0
357,284,357,42,Base Minerals,"Base Minerals are refined and crafted into components, modules and other items.",Base_Mineral.png,abundant,2725,0,0,2725,0
357,303,357,126,Bruma Particles,"Bruma Particles are refined and crafted into components, modules and other items.",Bruma_Particle.png,rare,689,0,0,689,0
357,3993,6457,53,Ignis Ore,"Ignis Ore is refined and crafted into components, modules and other items.",Ignis_Ore.png,rare,749,0,0,749,0
357,3994,6457,113,Aerogens,"Aerogens are refined and crafted into components, modules and other items.",Aerogens.png,common,2398,0,0,2398,0
357,3995,6457,40,Polymetals,"Polymetals are refined and crafted into components, modules and other items.",Polymetals.png,common,4150,0,0,4150,0
361,9793,361,54,Hyperspecular Crystals,"Hyperspecular Crystals are refined and crafted into components, modules and other items.",Hyperspecular_Crystals.png,uncommon,2119,0,0,2119,0
361,9795,361,42,Base Minerals,"Base Minerals are refined and crafted into components, modules and other items.",Base_Mineral.png,abundant,4695,0,0,4695,0
361,15117,361,41,Xensium,"Xensium is refined and crafted into components, modules and other items.",Xensium.png,uncommon,1146,0,0,1146,0
361,20100,6461,42,Base Minerals,"Base Minerals are refined and crafted into components, modules and other items.",Base_Mineral.png,abundant,5501,0,0,5501,0
361,20197,6461,113,Aerogens,"Aerogens are refined and crafted into components, modules and other items.",Aerogens.png,common,2754,0,0,2754,0
361,20440,6461,54,Hyperspecular Crystals,"Hyperspecular Crystals are refined and crafted into components, modules and other items.",Hyperspecular_Crystals.png,uncommon,1128,0,0,1128,0
362,1291,362,126,Bruma Particles,"Bruma Particles are refined and crafted into components, modules and other items.",Bruma_Particle.png,rare,882,0,0,882,0
362,1621,362,42,Base Minerals,"Base Minerals are refined and crafted into components, modules and other items.",Base_Mineral.png,abundant,5817,0,0,5817,0
362,1767,362,123,Neolysium,"Neolysium is refined and crafted into components, modules and other items.",Neolysium.png,uncommon,2696,0,0,2696,0
362,3996,6462,54,Hyperspecular Crystals,"Hyperspecular Crystals are refined and crafted into components, modules and other items.",Hyperspecular_Crystals.png,uncommon,1122,0,0,1122,0
362,3997,6462,107,H2O,"H2O is refined and crafted into components, modules and other items.",H20.png,abundant,2247,0,0,2247,0
362,3998,6462,42,Base Minerals,"Base Minerals are refined and crafted into components, modules and other items.",Base_Mineral.png,abundant,5330,0,0,5330,0
366,1211,366,110,Plutonium,"Plutonium is refined and crafted into components, modules and other items.",Plutonium.png,common,4029,403,0,3626,403
366,1448,366,126,Bruma Particles,"Bruma Particles are refined and crafted into components, modules and other items.",Bruma_Particle.png,rare,675,135,0,540,135
366,1449,366,115,Nanofluids,"Nanofluids are refined and crafted into components, modules and other items.",Nanofluids.png,common,2384,298,0,2086,298
366,1710,6466,127,Microorganisms,"Microorganisms are refined and crafted into components, modules and other items.",Microorganism.png,rare,663,133,0,530,133
366,2342,6466,115,Nanofluids,"Nanofluids are refined and crafted into components, modules and other items.",Nanofluids.png,common,5177,518,0,4659,518
366,2382,6466,117,Yprasium,"Yprasium is refined and crafted into components, modules and other items.",Yprasium.png,uncommon,2602,652,0,1950,652
369,1329,369,41,Xensium,"Xensium is refined and crafted into components, modules and other items.",Xensium.png,uncommon,1077,0,0,1077,0
369,1622,369,106,Elastomers,"Elastomers are refined and crafted into components, modules and other items.",Elastomers.png,abundant,5022,0,0,5022,0
369,1768,369,114,Ectopolymers,"Ectopolymers are refined and crafted into components, modules and other items.",Ectopolymers.png,common,2443,0,0,2443,0
369,3999,6469,119,Novis Compounds,"Novis Compounds are refined and crafted into components, modules and other items.",Novis_Compound.png,uncommon,1244,0,0,1244,0
369,4000,6469,41,Xensium,"Xensium is refined and crafted into components, modules and other items.",Xensium.png,uncommon,2955,0,0,2955,0
369,4001,6469,107,H2O,"H2O is refined and crafted into components, modules and other items.",H20.png,abundant,5347,0,0,5347,0
381,493,381,107,H2O,"H2O is refined and crafted into components, modules and other items.",H20.png,abundant,2839,0,0,2839,0
381,538,381,127,Microorganisms,"Microorganisms are refined and crafted into components, modules and other items.",Microorganism.png,rare,606,0,0,606,0
381,539,381,114,Ectopolymers,"Ectopolymers are refined and crafted into components, modules and other items.",Ectopolymers.png,common,4720,0,0,4720,0
381,540,381,106,Elastomers,"Elastomers are refined and crafted into components, modules and other items.",Elastomers.png,abundant,5604,0,0,5604,0
381,18000,6481,123,Neolysium,"Neolysium is refined and crafted into components, modules and other items.",Neolysium.png,uncommon,1090,0,0,1090,0
381,18001,6481,114,Ectopolymers,"Ectopolymers are refined and crafted into components, modules and other items.",Ectopolymers.png,common,2796,0,0,2796,0
381,18002,6481,42,Base Minerals,"Base Minerals are refined and crafted into components, modules and other items.",Base_Mineral.png,abundant,5898,0,0,5898,0
383,17763,383,42,Base Minerals,"Base Minerals are refined and crafted into components, modules and other items.",Base_Mineral.png,abundant,2893,0,0,2893,0
383,17923,383,42,Base Minerals,"Base Minerals are refined and crafted into components, modules and other items.",Base_Mineral.png,abundant,4494,0,0,4494,0
383,17929,383,120,Metamagnetic Ore,"Metamagnetic Ore is refined and crafted into components, modules and other items.",Metamagnetic_Ore.png,uncommon,1286,0,0,1286,0
383,18685,6483,42,Base Minerals,"Base Minerals are refined and crafted into components, modules and other items.",Base_Mineral.png,abundant,4672,0,0,4672,0
383,18751,6483,118,Platinyx,"Platinyx is refined and crafted into components, modules and other items.",Platinyx.png,uncommon,2723,0,0,2723,0
383,18811,6483,40,Polymetals,"Polymetals are refined and crafted into components, modules and other items.",Polymetals.png,common,1149,0,0,1149,0
384,228,384,106,Elastomers,"Elastomers are refined and crafted into components, modules and other items.",Elastomers.png,abundant,5194,0,0,5194,0
384,883,384,107,H2O,"H2O is refined and crafted into components, modules and other items.",H20.png,abundant,2902,0,0,2902,0
384,7518,384,41,Xensium,"Xensium is refined and crafted into components, modules and other items.",Xensium.png,uncommon,1368,0,0,1368,0
384,1969,6484,41,Xensium,"Xensium is refined and crafted into components, modules and other items.",Xensium.png,uncommon,1077,0,0,1077,0
384,1970,6484,120,Metamagnetic Ore,"Metamagnetic Ore is refined and crafted into components, modules and other items.",Metamagnetic_Ore.png,uncommon,1075,215,0,860,215
384,3147,6484,119,Novis Compounds,"Novis Compounds are refined and crafted into components, modules and other items.",Novis_Compound.png,uncommon,2908,0,0,2908,0
384,7592,6484,107,H2O,"H2O is refined and crafted into components, modules and other items.",H20.png,abundant,5793,0,0,5793,0
385,3321,385,107,H2O,"H2O is refined and crafted into components, modules and other items.",H20.png,abundant,5669,0,0,5669,0
385,3322,385,54,Hyperspecular Crystals,"Hyperspecular Crystals are refined and crafted into components, modules and other items.",Hyperspecular_Crystals.png,uncommon,2971,0,0,2971,0
386,492,386,114,Ectopolymers,"Ectopolymers are refined and crafted into components, modules and other items.",Ectopolymers.png,common,2164,0,0,2164,0
386,541,386,110,Plutonium,"Plutonium is refined and crafted into components, modules and other items.",Plutonium.png,common,4728,0,0,4728,0
386,542,386,114,Ectopolymers,"Ectopolymers are refined and crafted into components, modules and other items.",Ectopolymers.png,common,1286,0,0,1286,0
386,18003,6486,114,Ectopolymers,"Ectopolymers are refined and crafted into components, modules and other items.",Ectopolymers.png,common,1432,0,0,1432,0
386,18004,6486,42,Base Minerals,"Base Minerals are refined and crafted into components, modules and other items.",Base_Mineral.png,abundant,2500,0,0,2500,0
386,18005,6486,54,Hyperspecular Crystals,"Hyperspecular Crystals are refined and crafted into components, modules and other items.",Hyperspecular_Crystals.png,uncommon,2528,0,0,2528,0
386,18007,6486,114,Ectopolymers,"Ectopolymers are refined and crafted into components, modules and other items.",Ectopolymers.png,common,5879,0,0,5879,0
396,4632,396,117,Yprasium,"Yprasium is refined and crafted into components, modules and other items.",Yprasium.png,uncommon,1473,0,0,1473,0
396,4633,396,114,Ectopolymers,"Ectopolymers are refined and crafted into components, modules and other items.",Ectopolymers.png,common,2788,0,0,2788,0
396,4634,396,105,Silicates,"Silicates are refined and crafted into components, modules and other items.",Silicates.png,abundant,5944,595,0,5349,595
396,20198,6496,105,Silicates,"Silicates are refined and crafted into components, modules and other items.",Silicates.png,abundant,5456,0,0,5456,0
396,20462,6496,52,Organic Compounds,"Organic Compounds are refined and crafted into components, modules and other items.",Organic_Compound.png,common,1416,0,0,1416,0
396,20607,6496,52,Organic Compounds,"Organic Compounds are refined and crafted into components, modules and other items.",Organic_Compound.png,common,2042,0,0,2042,0
399,9796,399,117,Yprasium,"Yprasium is refined and crafted into components, modules and other items.",Yprasium.png,uncommon,2108,0,0,2108,0
399,9797,399,106,Elastomers,"Elastomers are refined and crafted into components, modules and other items.",Elastomers.png,abundant,2646,0,0,2646,0
399,9798,399,52,Organic Compounds,"Organic Compounds are refined and crafted into components, modules and other items.",Organic_Compound.png,common,5094,0,0,5094,0
399,9799,399,107,H2O,"H2O is refined and crafted into components, modules and other items.",H20.png,abundant,5487,0,0,5487,0
399,15118,399,114,Ectopolymers,"Ectopolymers are refined and crafted into components, modules and other items.",Ectopolymers.png,common,1250,0,0,1250,0
399,20230,6499,52,Organic Compounds,"Organic Compounds are refined and crafted into components, modules and other items.",Organic_Compound.png,common,5497,0,0,5497,0
399,20231,6499,52,Organic Compounds,"Organic Compounds are refined and crafted into components, modules and other items.",Organic_Compound.png,common,4411,0,0,4411,0
399,20608,6499,53,Ignis Ore,"Ignis Ore is refined and crafted into components, modules and other items.",Ignis_Ore.png,rare,728,0,0,728,0
399,20632,6499,113,Aerogens,"Aerogens are refined and crafted into components, modules and other items.",Aerogens.png,common,2494,0,0,2494,0
400,9800,400,106,Elastomers,"Elastomers are refined and crafted into components, modules and other items.",Elastomers.png,abundant,2509,0,0,2509,0
400,9801,400,120,Metamagnetic Ore,"Metamagnetic Ore is refined and crafted into components, modules and other items.",Metamagnetic_Ore.png,uncommon,2138,0,0,2138,0
400,9802,400,106,Elastomers,"Elastomers are refined and crafted into components, modules and other items.",Elastomers.png,abundant,5487,0,0,5487,0
400,15480,400,53,Ignis Ore,"Ignis Ore is refined and crafted into components, modules and other items.",Ignis_Ore.png,rare,684,0,0,684,0
400,20739,6500,127,Microorganisms,"Microorganisms are refined and crafted into components, modules and other items.",Microorganism.png,rare,823,0,0,823,0
400,20740,6500,118,Platinyx,"Platinyx is refined and crafted into components, modules and other items.",Platinyx.png,uncommon,5916,0,0,5916,0
400,20860,6500,41,Xensium,"Xensium is refined and crafted into components, modules and other items.",Xensium.png,uncommon,2620,0,0,2620,0
402,9803,402,105,Silicates,"Silicates are refined and crafted into components, modules and other items.",Silicates.png,abundant,2672,334,0,2338,334
402,9804,402,42,Base Minerals,"Base Minerals are refined and crafted into components, modules and other items.",Base_Mineral.png,abundant,4379,0,0,4379,0
402,15547,402,53,Ignis Ore,"Ignis Ore is refined and crafted into components, modules and other items.",Ignis_Ore.png,rare,725,0,0,725,0
402,20741,6502,112,Amphoteric Substances,"Amphoteric Substances are refined and crafted into components, modules and other items.",Amphoteric_Substances.png,common,1306,0,0,1306,0
402,20826,6502,109,Titanium,"Titanium is refined and crafted into components, modules and other items.",Titanium.png,common,5047,0,0,5047,0
403,1556,403,119,Novis Compounds,"Novis Compounds are refined and crafted into components, modules and other items.",Novis_Compound.png,uncommon,1165,233,0,932,233
403,1557,403,114,Ectopolymers,"Ectopolymers are refined and crafted into components, modules and other items.",Ectopolymers.png,common,2690,337,0,2353,337
403,1558,403,114,Ectopolymers,"Ectopolymers are refined and crafted into components, modules and other items.",Ectopolymers.png,common,5855,586,0,5269,586
403,1559,6503,54,Hyperspecular Crystals,"Hyperspecular Crystals are refined and crafted into components, modules and other items.",Hyperspecular_Crystals.png,uncommon,1199,480,0,719,480
403,2343,6503,42,Base Minerals,"Base Minerals are refined and crafted into components, modules and other items.",Base_Mineral.png,abundant,5583,559,0,5024,559
403,2955,6503,119,Novis Compounds,"Novis Compounds are refined and crafted into components, modules and other items.",Novis_Compound.png,uncommon,2019,506,0,1513,506
405,9805,405,115,Nanofluids,"Nanofluids are refined and crafted into components, modules and other items.",Nanofluids.png,common,2105,0,0,2105,0
405,9806,405,105,Silicates,"Silicates are refined and crafted into components, modules and other items.",Silicates.png,abundant,5962,597,0,5365,597
405,9807,405,107,H2O,"H2O is refined and crafted into components, modules and other items.",H20.png,abundant,4279,0,0,4279,0
405,15548,405,126,Bruma Particles,"Bruma Particles are refined and crafted into components, modules and other items.",Bruma_Particle.png,rare,656,0,0,656,0
405,15549,405,40,Polymetals,"Polymetals are refined and crafted into components, modules and other items.",Polymetals.png,common,1422,0,0,1422,0
405,20861,6505,106,Elastomers,"Elastomers are refined and crafted into components, modules and other items.",Elastomers.png,abundant,5413,0,0,5413,0
405,20923,6505,126,Bruma Particles,"Bruma Particles are refined and crafted into components, modules and other items.",Bruma_Particle.png,rare,702,0,0,702,0
407,272,407,40,Polymetals,"Polymetals are refined and crafted into components, modules and other items.",Polymetals.png,common,5391,0,0,5391,0
407,273,407,105,Silicates,"Silicates are refined and crafted into components, modules and other items.",Silicates.png,abundant,4079,0,0,4079,0
407,278,407,120,Metamagnetic Ore,"Metamagnetic Ore is refined and crafted into components, modules and other items.",Metamagnetic_Ore.png,uncommon,2597,0,0,2597,0
407,280,407,120,Metamagnetic Ore,"Metamagnetic Ore is refined and crafted into components, modules and other items.",Metamagnetic_Ore.png,uncommon,1201,0,0,1201,0
407,4002,6507,53,Ignis Ore,"Ignis Ore is refined and crafted into components, modules and other items.",Ignis_Ore.png,rare,670,0,0,670,0
407,4003,6507,40,Polymetals,"Polymetals are refined and crafted into components, modules and other items.",Polymetals.png,common,2309,0,0,2309,0
407,4004,6507,118,Platinyx,"Platinyx is refined and crafted into components, modules and other items.",Platinyx.png,uncommon,2215,0,0,2215,0
407,4005,6507,107,H2O,"H2O is refined and crafted into components, modules and other items.",H20.png,abundant,4361,0,0,4361,0
407,4006,6507,40,Polymetals,"Polymetals are refined and crafted into components, modules and other items.",Polymetals.png,common,5349,0,0,5349,0
408,4887,408,54,Hyperspecular Crystals,"Hyperspecular Crystals are refined and crafted into components, modules and other items.",Hyperspecular_Crystals.png,uncommon,1333,0,0,1333,0
408,12223,408,42,Base Minerals,"Base Minerals are refined and crafted into components, modules and other items.",Base_Mineral.png,abundant,5397,0,0,5397,0
408,12224,408,107,H2O,"H2O is refined and crafted into components, modules and other items.",H20.png,abundant,4630,0,0,4630,0
408,13630,408,105,Silicates,"Silicates are refined and crafted into components, modules and other items.",Silicates.png,abundant,2304,0,0,2304,0
409,9822,409,40,Polymetals,"Polymetals are refined and crafted into components, modules and other items.",Polymetals.png,common,2597,0,0,2597,0
409,13092,409,107,H2O,"H2O is refined and crafted into components, modules and other items.",H20.png,abundant,5543,0,0,5543,0
409,15550,409,109,Titanium,"Titanium is refined and crafted into components, modules and other items.",Titanium.png,common,1440,0,0,1440,0
416,2945,416,110,Plutonium,"Plutonium is refined and crafted into components, modules and other items.",Plutonium.png,common,1273,0,0,1273,0
417,356,417,107,H2O,"H2O is refined and crafted into components, modules and other items.",H20.png,abundant,4990,0,0,4990,0
417,1354,417,121,Hypoatomic Substances,"Hypoatomic Substances are refined and crafted into components, modules and other items.",Hypoatomic_Substances.png,uncommon,1200,0,0,1200,0
417,2834,417,123,Neolysium,"Neolysium is refined and crafted into components, modules and other items.",Neolysium.png,uncommon,2995,0,0,2995,0
417,2835,417,107,H2O,"H2O is refined and crafted into components, modules and other items.",H20.png,abundant,2783,0,0,2783,0
418,4888,418,127,Microorganisms,"Microorganisms are refined and crafted into components, modules and other items.",Microorganism.png,rare,694,0,0,694,0
418,4889,418,121,Hypoatomic Substances,"Hypoatomic Substances are refined and crafted into components, modules and other items.",Hypoatomic_Substances.png,uncommon,1020,0,0,1020,0
421,14720,421,42,Base Minerals,"Base Minerals are refined and crafted into components, modules and other items.",Base_Mineral.png,abundant,2494,0,0,2494,0
421,15119,421,120,Metamagnetic Ore,"Metamagnetic Ore is refined and crafted into components, modules and other items.",Metamagnetic_Ore.png,uncommon,4173,0,0,4173,0
421,15551,421,109,Titanium,"Titanium is refined and crafted into components, modules and other items.",Titanium.png,common,1056,0,0,1056,0
423,15120,423,115,Nanofluids,"Nanofluids are refined and crafted into components, modules and other items.",Nanofluids.png,common,2457,0,0,2457,0
423,15481,423,54,Hyperspecular Crystals,"Hyperspecular Crystals are refined and crafted into components, modules and other items.",Hyperspecular_Crystals.png,uncommon,4796,0,0,4796,0
423,15552,423,120,Metamagnetic Ore,"Metamagnetic Ore is refined and crafted into components, modules and other items.",Metamagnetic_Ore.png,uncommon,1226,0,0,1226,0
426,15482,426,120,Metamagnetic Ore,"Metamagnetic Ore is refined and crafted into components, modules and other items.",Metamagnetic_Ore.png,uncommon,2892,0,0,2892,0
426,15483,426,42,Base Minerals,"Base Minerals are refined and crafted into components, modules and other items.",Base_Mineral.png,abundant,4973,0,0,4973,0
426,15484,426,105,Silicates,"Silicates are refined and crafted into components, modules and other items.",Silicates.png,abundant,4820,0,0,4820,0
426,15553,426,128,Tchaikovium,"Tchaikovium is refined and crafted into components, modules and other items.",Tchaikovium.png,rare,650,0,0,650,0
426,15485,6526,54,Hyperspecular Crystals,"Hyperspecular Crystals are refined and crafted into components, modules and other items.",Hyperspecular_Crystals.png,uncommon,1129,0,0,1129,0
433,486,433,110,Plutonium,"Plutonium is refined and crafted into components, modules and other items.",Plutonium.png,common,4661,0,0,4661,0
433,700,433,114,Ectopolymers,"Ectopolymers are refined and crafted into components, modules and other items.",Ectopolymers.png,common,2256,0,0,2256,0
433,1010,433,128,Tchaikovium,"Tchaikovium is refined and crafted into components, modules and other items.",Tchaikovium.png,rare,748,0,0,748,0
433,954,6533,52,Organic Compounds,"Organic Compounds are refined and crafted into components, modules and other items.",Organic_Compound.png,common,5878,0,0,5878,0
433,1120,6533,42,Base Minerals,"Base Minerals are refined and crafted into components, modules and other items.",Base_Mineral.png,abundant,2766,0,0,2766,0
433,1179,6533,128,Tchaikovium,"Tchaikovium is refined and crafted into components, modules and other items.",Tchaikovium.png,rare,757,0,0,757,0
435,15486,435,114,Ectopolymers,"Ectopolymers are refined and crafted into components, modules and other items.",Ectopolymers.png,common,2867,0,0,2867,0
435,15487,435,117,Yprasium,"Yprasium is refined and crafted into components, modules and other items.",Yprasium.png,uncommon,2201,0,0,2201,0
435,15842,435,117,Yprasium,"Yprasium is refined and crafted into components, modules and other items.",Yprasium.png,uncommon,1272,0,0,1272,0
435,15843,435,107,H2O,"H2O is refined and crafted into components, modules and other items.",H20.png,abundant,4622,0,0,4622,0
436,15488,436,112,Amphoteric Substances,"Amphoteric Substances are refined and crafted into components, modules and other items.",Amphoteric_Substances.png,common,2521,0,0,2521,0
436,15844,436,126,Bruma Particles,"Bruma Particles are refined and crafted into components, modules and other items.",Bruma_Particle.png,rare,611,0,0,611,0
436,15845,436,42,Base Minerals,"Base Minerals are refined and crafted into components, modules and other items.",Base_Mineral.png,abundant,5506,0,0,5506,0
440,15489,440,113,Aerogens,"Aerogens are refined and crafted into components, modules and other items.",Aerogens.png,common,2378,0,0,2378,0
440,15940,440,54,Hyperspecular Crystals,"Hyperspecular Crystals are refined and crafted into components, modules and other items.",Hyperspecular_Crystals.png,uncommon,1120,0,0,1120,0
440,15941,440,109,Titanium,"Titanium is refined and crafted into components, modules and other items.",Titanium.png,common,4316,0,0,4316,0
442,15490,442,52,Organic Compounds,"Organic Compounds are refined and crafted into components, modules and other items.",Organic_Compound.png,common,2221,0,0,2221,0
442,15942,442,41,Xensium,"Xensium is refined and crafted into components, modules and other items.",Xensium.png,uncommon,1293,0,0,1293,0
442,15953,442,105,Silicates,"Silicates are refined and crafted into components, modules and other items.",Silicates.png,abundant,5675,0,0,5675,0
443,15943,443,106,Elastomers,"Elastomers are refined and crafted into components, modules and other items.",Elastomers.png,abundant,2768,0,0,2768,0
443,15954,443,127,Microorganisms,"Microorganisms are refined and crafted into components, modules and other items.",Microorganism.png,rare,671,0,0,671,0
443,15955,443,40,Polymetals,"Polymetals are refined and crafted into components, modules and other items.",Polymetals.png,common,1395,0,0,1395,0
443,15956,443,107,H2O,"H2O is refined and crafted into components, modules and other items.",H20.png,abundant,4847,0,0,4847,0
444,4781,444,120,Metamagnetic Ore,"Metamagnetic Ore is refined and crafted into components, modules and other items.",Metamagnetic_Ore.png,uncommon,1120,0,0,1120,0
444,5116,444,123,Neolysium,"Neolysium is refined and crafted into components, modules and other items.",Neolysium.png,uncommon,2902,0,0,2902,0
444,5611,444,105,Silicates,"Silicates are refined and crafted into components, modules and other items.",Silicates.png,abundant,5318,1064,0,4254,1064
444,5612,444,52,Organic Compounds,"Organic Compounds are refined and crafted into components, modules and other items.",Organic_Compound.png,common,4650,0,0,4650,0
444,4782,6544,120,Metamagnetic Ore,"Metamagnetic Ore is refined and crafted into components, modules and other items.",Metamagnetic_Ore.png,uncommon,1107,0,0,1107,0
444,4783,6544,123,Neolysium,"Neolysium is refined and crafted into components, modules and other items.",Neolysium.png,uncommon,1407,0,0,1407,0
444,7509,6544,105,Silicates,"Silicates are refined and crafted into components, modules and other items.",Silicates.png,abundant,2889,1086,0,1803,1086
444,7512,6544,52,Organic Compounds,"Organic Compounds are refined and crafted into components, modules and other items.",Organic_Compound.png,common,5606,0,0,5606,0
444,7513,6544,112,Amphoteric Substances,"Amphoteric Substances are refined and crafted into components, modules and other items.",Amphoteric_Substances.png,common,5905,0,0,5905,0
445,4651,445,106,Elastomers,"Elastomers are refined and crafted into components, modules and other items.",Elastomers.png,abundant,5881,0,0,5881,0
445,4788,445,113,Aerogens,"Aerogens are refined and crafted into components, modules and other items.",Aerogens.png,common,1364,273,0,1091,273
445,4789,445,126,Bruma Particles,"Bruma Particles are refined and crafted into components, modules and other items.",Bruma_Particle.png,rare,797,0,0,797,0
445,16537,445,115,Nanofluids,"Nanofluids are refined and crafted into components, modules and other items.",Nanofluids.png,common,2185,274,0,1911,274
445,4304,6545,126,Bruma Particles,"Bruma Particles are refined and crafted into components, modules and other items.",Bruma_Particle.png,rare,621,125,0,496,125
445,4305,6545,126,Bruma Particles,"Bruma Particles are refined and crafted into components, modules and other items.",Bruma_Particle.png,rare,898,0,0,898,0
445,4410,6545,105,Silicates,"Silicates are refined and crafted into components, modules and other items.",Silicates.png,abundant,5514,0,0,5514,0
445,4411,6545,106,Elastomers,"Elastomers are refined and crafted into components, modules and other items.",Elastomers.png,abundant,2255,0,0,2255,0
452,904,452,126,Bruma Particles,"Bruma Particles are refined and crafted into components, modules and other items.",Bruma_Particle.png,rare,802,0,0,802,0
452,948,452,112,Amphoteric Substances,"Amphoteric Substances are refined and crafted into components, modules and other items.",Amphoteric_Substances.png,common,2514,0,0,2514,0
452,1216,452,107,H2O,"H2O is refined and crafted into components, modules and other items.",H20.png,abundant,4462,0,0,4462,0
452,1217,6552,126,Bruma Particles,"Bruma Particles are refined and crafted into components, modules and other items.",Bruma_Particle.png,rare,839,0,0,839,0
452,1218,6552,54,Hyperspecular Crystals,"Hyperspecular Crystals are refined and crafted into components, modules and other items.",Hyperspecular_Crystals.png,uncommon,1043,0,0,1043,0
452,1249,6552,107,H2O,"H2O is refined and crafted into components, modules and other items.",H20.png,abundant,2729,0,0,2729,0
452,2266,6552,54,Hyperspecular Crystals,"Hyperspecular Crystals are refined and crafted into components, modules and other items.",Hyperspecular_Crystals.png,uncommon,5011,0,0,5011,0
453,1682,453,42,Base Minerals,"Base Minerals are refined and crafted into components, modules and other items.",Base_Mineral.png,abundant,5569,0,0,5569,0
453,1705,453,119,Novis Compounds,"Novis Compounds are refined and crafted into components, modules and other items.",Novis_Compound.png,uncommon,1149,0,0,1149,0
453,1706,453,110,Plutonium,"Plutonium is refined and crafted into components, modules and other items.",Plutonium.png,common,1276,0,0,1276,0
453,1874,453,113,Aerogens,"Aerogens are refined and crafted into components, modules and other items.",Aerogens.png,common,2080,0,0,2080,0
453,4007,6553,128,Tchaikovium,"Tchaikovium is refined and crafted into components, modules and other items.",Tchaikovium.png,rare,778,0,0,778,0
453,4008,6553,114,Ectopolymers,"Ectopolymers are refined and crafted into components, modules and other items.",Ectopolymers.png,common,2297,0,0,2297,0
453,4009,6553,42,Base Minerals,"Base Minerals are refined and crafted into components, modules and other items.",Base_Mineral.png,abundant,5234,0,0,5234,0
453,4010,6553,106,Elastomers,"Elastomers are refined and crafted into components, modules and other items.",Elastomers.png,abundant,4679,0,0,4679,0
459,14436,459,109,Titanium,"Titanium is refined and crafted into components, modules and other items.",Titanium.png,common,5861,0,0,5861,0
459,14437,459,109,Titanium,"Titanium is refined and crafted into components, modules and other items.",Titanium.png,common,2490,0,0,2490,0
459,14438,459,54,Hyperspecular Crystals,"Hyperspecular Crystals are refined and crafted into components, modules and other items.",Hyperspecular_Crystals.png,uncommon,1309,0,0,1309,0
459,14439,6559,113,Aerogens,"Aerogens are refined and crafted into components, modules and other items.",Aerogens.png,common,4157,0,0,4157,0
459,14440,6559,107,H2O,"H2O is refined and crafted into components, modules and other items.",H20.png,abundant,2810,0,0,2810,0
459,14441,6559,127,Microorganisms,"Microorganisms are refined and crafted into components, modules and other items.",Microorganism.png,rare,863,0,0,863,0
461,3744,461,53,Ignis Ore,"Ignis Ore is refined and crafted into components, modules and other items.",Ignis_Ore.png,rare,882,0,0,882,0
461,3781,461,120,Metamagnetic Ore,"Metamagnetic Ore is refined and crafted into components, modules and other items.",Metamagnetic_Ore.png,uncommon,2216,0,0,2216,0
461,9175,461,42,Base Minerals,"Base Minerals are refined and crafted into components, modules and other items.",Base_Mineral.png,abundant,4899,0,0,4899,0
461,9176,6561,53,Ignis Ore,"Ignis Ore is refined and crafted into components, modules and other items.",Ignis_Ore.png,rare,713,0,0,713,0
461,9177,6561,112,Amphoteric Substances,"Amphoteric Substances are refined and crafted into components, modules and other items.",Amphoteric_Substances.png,common,1325,0,0,1325,0
461,9282,6561,123,Neolysium,"Neolysium is refined and crafted into components, modules and other items.",Neolysium.png,uncommon,2677,0,0,2677,0
461,9373,6561,112,Amphoteric Substances,"Amphoteric Substances are refined and crafted into components, modules and other items.",Amphoteric_Substances.png,common,4288,0,0,4288,0
464,1828,464,128,Tchaikovium,"Tchaikovium is refined and crafted into components, modules and other items.",Tchaikovium.png,rare,774,0,0,774,0
464,1829,464,40,Polymetals,"Polymetals are refined and crafted into components, modules and other items.",Polymetals.png,common,2347,0,0,2347,0
464,1830,464,110,Plutonium,"Plutonium is refined and crafted into components, modules and other items.",Plutonium.png,common,5233,0,0,5233,0
464,1831,464,42,Base Minerals,"Base Minerals are refined and crafted into components, modules and other items.",Base_Mineral.png,abundant,4748,0,0,4748,0
464,5514,6564,106,Elastomers,"Elastomers are refined and crafted into components, modules and other items.",Elastomers.png,abundant,4405,0,0,4405,0
464,14588,6564,126,Bruma Particles,"Bruma Particles are refined and crafted into components, modules and other items.",Bruma_Particle.png,rare,703,0,0,703,0
464,14589,6564,54,Hyperspecular Crystals,"Hyperspecular Crystals are refined and crafted into components, modules and other items.",Hyperspecular_Crystals.png,uncommon,2401,0,0,2401,0
465,2792,465,42,Base Minerals,"Base Minerals are refined and crafted into components, modules and other items.",Base_Mineral.png,abundant,4234,848,0,3386,848
465,2793,465,42,Base Minerals,"Base Minerals are refined and crafted into components, modules and other items.",Base_Mineral.png,abundant,5857,0,0,5857,0
469,15957,469,41,Xensium,"Xensium is refined and crafted into components, modules and other items.",Xensium.png,uncommon,1365,0,0,1365,0
469,16205,469,105,Silicates,"Silicates are refined and crafted into components, modules and other items.",Silicates.png,abundant,2658,0,0,2658,0
469,16206,469,42,Base Minerals,"Base Minerals are refined and crafted into components, modules and other items.",Base_Mineral.png,abundant,4226,0,0,4226,0
479,16207,479,118,Platinyx,"Platinyx is refined and crafted into components, modules and other items.",Platinyx.png,uncommon,1386,0,0,1386,0
479,16208,479,54,Hyperspecular Crystals,"Hyperspecular Crystals are refined and crafted into components, modules and other items.",Hyperspecular_Crystals.png,uncommon,2488,0,0,2488,0
479,16209,479,42,Base Minerals,"Base Minerals are refined and crafted into components, modules and other items.",Base_Mineral.png,abundant,5531,0,0,5531,0
481,16210,481,53,Ignis Ore,"Ignis Ore is refined and crafted into components, modules and other items.",Ignis_Ore.png,rare,748,0,0,748,0
481,16211,481,53,Ignis Ore,"Ignis Ore is refined and crafted into components, modules and other items.",Ignis_Ore.png,rare,650,0,0,650,0
481,16337,481,40,Polymetals,"Polymetals are refined and crafted into components, modules and other items.",Polymetals.png,common,2286,0,0,2286,0
481,16338,481,105,Silicates,"Silicates are refined and crafted into components, modules and other items.",Silicates.png,abundant,4069,0,0,4069,0
485,8814,485,105,Silicates,"Silicates are refined and crafted into components, modules and other items.",Silicates.png,abundant,4262,0,0,4262,0
485,8815,485,107,H2O,"H2O is refined and crafted into components, modules and other items.",H20.png,abundant,4350,0,0,4350,0
485,8818,485,53,Ignis Ore,"Ignis Ore is refined and crafted into components, modules and other items.",Ignis_Ore.png,rare,702,0,0,702,0
485,8881,485,109,Titanium,"Titanium is refined and crafted into components, modules and other items.",Titanium.png,common,2054,0,0,2054,0
485,8812,6585,109,Titanium,"Titanium is refined and crafted into components, modules and other items.",Titanium.png,common,2129,0,0,2129,0
485,8813,6585,112,Amphoteric Substances,"Amphoteric Substances are refined and crafted into components, modules and other items.",Amphoteric_Substances.png,common,2954,0,0,2954,0
485,9010,6585,53,Ignis Ore,"Ignis Ore is refined and crafted into components, modules and other items.",Ignis_Ore.png,rare,896,0,0,896,0
485,9142,6585,120,Metamagnetic Ore,"Metamagnetic Ore is refined and crafted into components, modules and other items.",Metamagnetic_Ore.png,uncommon,4831,484,0,4347,484
486,1711,486,115,Nanofluids,"Nanofluids are refined and crafted into components, modules and other items.",Nanofluids.png,common,1345,0,0,1345,0
486,1712,486,42,Base Minerals,"Base Minerals are refined and crafted into components, modules and other items.",Base_Mineral.png,abundant,5587,559,0,5028,559
486,2957,486,42,Base Minerals,"Base Minerals are refined and crafted into components, modules and other items.",Base_Mineral.png,abundant,2305,0,0,2305,0
486,1713,6586,117,Yprasium,"Yprasium is refined and crafted into components, modules and other items.",Yprasium.png,uncommon,1212,243,0,969,243
486,2958,6586,115,Nanofluids,"Nanofluids are refined and crafted into components, modules and other items.",Nanofluids.png,common,2699,0,0,2699,0
486,2959,6586,106,Elastomers,"Elastomers are refined and crafted into components, modules and other items.",Elastomers.png,abundant,5298,1060,0,4238,1060
495,14442,495,42,Base Minerals,"Base Minerals are refined and crafted into components, modules and other items.",Base_Mineral.png,abundant,4301,0,0,4301,0
495,14443,495,109,Titanium,"Titanium is refined and crafted into components, modules and other items.",Titanium.png,common,2903,0,0,2903,0
495,14444,495,105,Silicates,"Silicates are refined and crafted into components, modules and other items.",Silicates.png,abundant,2633,0,0,2633,0
495,14445,495,128,Tchaikovium,"Tchaikovium is refined and crafted into components, modules and other items.",Tchaikovium.png,rare,617,0,0,617,0
495,14446,6595,105,Silicates,"Silicates are refined and crafted into components, modules and other items.",Silicates.png,abundant,4782,0,0,4782,0
495,14447,6595,128,Tchaikovium,"Tchaikovium is refined and crafted into components, modules and other items.",Tchaikovium.png,rare,1296,0,0,1296,0
495,14448,6595,115,Nanofluids,"Nanofluids are refined and crafted into components, modules and other items.",Nanofluids.png,common,1065,0,0,1065,0
497,16339,497,126,Bruma Particles,"Bruma Particles are refined and crafted into components, modules and other items.",Bruma_Particle.png,rare,821,0,0,821,0
497,16340,497,110,Plutonium,"Plutonium is refined and crafted into components, modules and other items.",Plutonium.png,common,2655,0,0,2655,0
497,16341,497,42,Base Minerals,"Base Minerals are refined and crafted into components, modules and other items.",Base_Mineral.png,abundant,4547,0,0,4547,0
500,14449,500,107,H2O,"H2O is refined and crafted into components, modules and other items.",H20.png,abundant,5706,0,0,5706,0
500,14450,500,106,Elastomers,"Elastomers are refined and crafted into components, modules and other items.",Elastomers.png,abundant,5302,0,0,5302,0
500,14451,500,52,Organic Compounds,"Organic Compounds are refined and crafted into components, modules and other items.",Organic_Compound.png,common,2250,0,0,2250,0
500,14452,500,107,H2O,"H2O is refined and crafted into components, modules and other items.",H20.png,abundant,2573,0,0,2573,0
500,14453,500,118,Platinyx,"Platinyx is refined and crafted into components, modules and other items.",Platinyx.png,uncommon,1348,0,0,1348,0
500,14454,6600,42,Base Minerals,"Base Minerals are refined and crafted into components, modules and other items.",Base_Mineral.png,abundant,4093,0,0,4093,0
500,14455,6600,118,Platinyx,"Platinyx is refined and crafted into components, modules and other items.",Platinyx.png,uncommon,2218,0,0,2218,0
500,14456,6600,114,Ectopolymers,"Ectopolymers are refined and crafted into components, modules and other items.",Ectopolymers.png,common,1032,0,0,1032,0
508,142,508,107,H2O,"H2O is refined and crafted into components, modules and other items.",H20.png,abundant,5350,0,0,5350,0
508,168,508,126,Bruma Particles,"Bruma Particles are refined and crafted into components, modules and other items.",Bruma_Particle.png,rare,742,0,0,742,0
508,169,508,40,Polymetals,"Polymetals are refined and crafted into components, modules and other items.",Polymetals.png,common,2325,0,0,2325,0
508,246,6608,109,Titanium,"Titanium is refined and crafted into components, modules and other items.",Titanium.png,common,5347,0,0,5347,0
508,1469,6608,106,Elastomers,"Elastomers are refined and crafted into components, modules and other items.",Elastomers.png,abundant,2847,0,0,2847,0
508,1534,6608,126,Bruma Particles,"Bruma Particles are refined and crafted into components, modules and other items.",Bruma_Particle.png,rare,727,0,0,727,0
509,16470,509,126,Bruma Particles,"Bruma Particles are refined and crafted into components, modules and other items.",Bruma_Particle.png,rare,774,0,0,774,0
509,16471,509,54,Hyperspecular Crystals,"Hyperspecular Crystals are refined and crafted into components, modules and other items.",Hyperspecular_Crystals.png,uncommon,2141,0,0,2141,0
509,16472,509,113,Aerogens,"Aerogens are refined and crafted into components, modules and other items.",Aerogens.png,common,2341,0,0,2341,0
509,16473,509,42,Base Minerals,"Base Minerals are refined and crafted into components, modules and other items.",Base_Mineral.png,abundant,4540,0,0,4540,0
520,1683,520,107,H2O,"H2O is refined and crafted into components, modules and other items.",H20.png,abundant,4007,0,0,4007,0
520,1752,520,112,Amphoteric Substances,"Amphoteric Substances are refined and crafted into components, modules and other items.",Amphoteric_Substances.png,common,1402,0,0,1402,0
520,1875,520,40,Polymetals,"Polymetals are refined and crafted into components, modules and other items.",Polymetals.png,common,2914,0,0,2914,0
520,4011,6620,119,Novis Compounds,"Novis Compounds are refined and crafted into components, modules and other items.",Novis_Compound.png,uncommon,1043,0,0,1043,0
520,4012,6620,120,Metamagnetic Ore,"Metamagnetic Ore is refined and crafted into components, modules and other items.",Metamagnetic_Ore.png,uncommon,2140,0,0,2140,0
520,4013,6620,112,Amphoteric Substances,"Amphoteric Substances are refined and crafted into components, modules and other items.",Amphoteric_Substances.png,common,5006,0,0,5006,0
522,16474,522,127,Microorganisms,"Microorganisms are refined and crafted into components, modules and other items.",Microorganism.png,rare,615,0,0,615,0
522,16475,522,112,Amphoteric Substances,"Amphoteric Substances are refined and crafted into components, modules and other items.",Amphoteric_Substances.png,common,2372,0,0,2372,0
522,16601,522,115,Nanofluids,"Nanofluids are refined and crafted into components, modules and other items.",Nanofluids.png,common,4613,0,0,4613,0
523,16602,523,119,Novis Compounds,"Novis Compounds are refined and crafted into components, modules and other items.",Novis_Compound.png,uncommon,1249,0,0,1249,0
523,16603,523,119,Novis Compounds,"Novis Compounds are refined and crafted into components, modules and other items.",Novis_Compound.png,uncommon,2233,0,0,2233,0
523,16604,523,106,Elastomers,"Elastomers are refined and crafted into components, modules and other items.",Elastomers.png,abundant,5173,0,0,5173,0
524,16605,524,126,Bruma Particles,"Bruma Particles are refined and crafted into components, modules and other items.",Bruma_Particle.png,rare,800,0,0,800,0
524,16832,524,126,Bruma Particles,"Bruma Particles are refined and crafted into components, modules and other items.",Bruma_Particle.png,rare,1750,0,0,1750,0
524,16833,524,123,Neolysium,"Neolysium is refined and crafted into components, modules and other items.",Neolysium.png,uncommon,4591,0,0,4591,0
525,4710,525,127,Microorganisms,"Microorganisms are refined and crafted into components, modules and other items.",Microorganism.png,rare,779,0,0,779,0
525,4711,525,121,Hypoatomic Substances,"Hypoatomic Substances are refined and crafted into components, modules and other items.",Hypoatomic_Substances.png,uncommon,1414,0,0,1414,0
525,4712,525,106,Elastomers,"Elastomers are refined and crafted into components, modules and other items.",Elastomers.png,abundant,2550,0,0,2550,0
525,4713,525,106,Elastomers,"Elastomers are refined and crafted into components, modules and other items.",Elastomers.png,abundant,5346,0,0,5346,0
530,20758,530,105,Silicates,"Silicates are refined and crafted into components, modules and other items.",Silicates.png,abundant,2632,0,0,2632,0
530,20759,530,123,Neolysium,"Neolysium is refined and crafted into components, modules and other items.",Neolysium.png,uncommon,2163,0,0,2163,0
535,16834,535,126,Bruma Particles,"Bruma Particles are refined and crafted into components, modules and other items.",Bruma_Particle.png,rare,822,0,0,822,0
535,16835,535,42,Base Minerals,"Base Minerals are refined and crafted into components, modules and other items.",Base_Mineral.png,abundant,2291,0,0,2291,0
535,16836,535,42,Base Minerals,"Base Minerals are refined and crafted into components, modules and other items.",Base_Mineral.png,abundant,4603,0,0,4603,0
536,17296,536,119,Novis Compounds,"Novis Compounds are refined and crafted into components, modules and other items.",Novis_Compound.png,uncommon,1251,0,0,1251,0
536,17297,536,54,Hyperspecular Crystals,"Hyperspecular Crystals are refined and crafted into components, modules and other items.",Hyperspecular_Crystals.png,uncommon,2749,0,0,2749,0
536,17298,536,106,Elastomers,"Elastomers are refined and crafted into components, modules and other items.",Elastomers.png,abundant,4069,0,0,4069,0
537,17299,537,117,Yprasium,"Yprasium is refined and crafted into components, modules and other items.",Yprasium.png,uncommon,1315,0,0,1315,0
537,17300,537,114,Ectopolymers,"Ectopolymers are refined and crafted into components, modules and other items.",Ectopolymers.png,common,2965,0,0,2965,0
537,17301,537,114,Ectopolymers,"Ectopolymers are refined and crafted into components, modules and other items.",Ectopolymers.png,common,5377,0,0,5377,0
541,5515,541,113,Aerogens,"Aerogens are refined and crafted into components, modules and other items.",Aerogens.png,common,2896,0,0,2896,0
541,5516,541,42,Base Minerals,"Base Minerals are refined and crafted into components, modules and other items.",Base_Mineral.png,abundant,4283,0,0,4283,0
541,14590,541,117,Yprasium,"Yprasium is refined and crafted into components, modules and other items.",Yprasium.png,uncommon,1158,0,0,1158,0
541,14591,6641,42,Base Minerals,"Base Minerals are refined and crafted into components, modules and other items.",Base_Mineral.png,abundant,4427,0,0,4427,0
541,14592,6641,115,Nanofluids,"Nanofluids are refined and crafted into components, modules and other items.",Nanofluids.png,common,4655,0,0,4655,0
541,20436,6641,121,Hypoatomic Substances,"Hypoatomic Substances are refined and crafted into components, modules and other items.",Hypoatomic_Substances.png,uncommon,1108,0,0,1108,0
548,16568,548,110,Plutonium,"Plutonium is refined and crafted into components, modules and other items.",Plutonium.png,common,5638,0,0,5638,0
548,16569,548,128,Tchaikovium,"Tchaikovium is refined and crafted into components, modules and other items.",Tchaikovium.png,rare,1747,219,0,1528,219
548,16570,548,110,Plutonium,"Plutonium is refined and crafted into components, modules and other items.",Plutonium.png,common,1345,0,0,1345,0
548,16571,6648,40,Polymetals,"Polymetals are refined and crafted into components, modules and other items.",Polymetals.png,common,4479,0,0,4479,0
548,16572,6648,41,Xensium,"Xensium is refined and crafted into components, modules and other items.",Xensium.png,uncommon,2054,0,0,2054,0
548,16573,6648,109,Titanium,"Titanium is refined and crafted into components, modules and other items.",Titanium.png,common,1287,0,0,1287,0
548,16574,6648,128,Tchaikovium,"Tchaikovium is refined and crafted into components, modules and other items.",Tchaikovium.png,rare,815,0,0,815,0
549,17302,549,110,Plutonium,"Plutonium is refined and crafted into components, modules and other items.",Plutonium.png,common,1349,0,0,1349,0
549,17303,549,128,Tchaikovium,"Tchaikovium is refined and crafted into components, modules and other items.",Tchaikovium.png,rare,897,0,0,897,0
549,17304,549,114,Ectopolymers,"Ectopolymers are refined and crafted into components, modules and other items.",Ectopolymers.png,common,2575,0,0,2575,0
549,17305,549,105,Silicates,"Silicates are refined and crafted into components, modules and other items.",Silicates.png,abundant,4937,0,0,4937,0
551,17411,551,119,Novis Compounds,"Novis Compounds are refined and crafted into components, modules and other items.",Novis_Compound.png,uncommon,1265,0,0,1265,0
551,17412,551,40,Polymetals,"Polymetals are refined and crafted into components, modules and other items.",Polymetals.png,common,2762,0,0,2762,0
551,17413,551,107,H2O,"H2O is refined and crafted into components, modules and other items.",H20.png,abundant,5837,0,0,5837,0
552,17306,552,114,Ectopolymers,"Ectopolymers are refined and crafted into components, modules and other items.",Ectopolymers.png,common,2745,0,0,2745,0
552,17376,552,105,Silicates,"Silicates are refined and crafted into components, modules and other items.",Silicates.png,abundant,5752,0,0,5752,0
552,19769,552,53,Ignis Ore,"Ignis Ore is refined and crafted into components, modules and other items.",Ignis_Ore.png,rare,663,0,0,663,0
562,17377,562,121,Hypoatomic Substances,"Hypoatomic Substances are refined and crafted into components, modules and other items.",Hypoatomic_Substances.png,uncommon,2084,0,0,2084,0
562,17378,562,52,Organic Compounds,"Organic Compounds are refined and crafted into components, modules and other items.",Organic_Compound.png,common,2651,0,0,2651,0
562,19638,562,106,Elastomers,"Elastomers are refined and crafted into components, modules and other items.",Elastomers.png,abundant,4046,0,0,4046,0
562,19770,562,41,Xensium,"Xensium is refined and crafted into components, modules and other items.",Xensium.png,uncommon,1337,0,0,1337,0
563,17380,563,41,Xensium,"Xensium is refined and crafted into components, modules and other items.",Xensium.png,uncommon,2595,0,0,2595,0
563,19771,563,106,Elastomers,"Elastomers are refined and crafted into components, modules and other items.",Elastomers.png,abundant,4981,0,0,4981,0
563,19773,563,127,Microorganisms,"Microorganisms are refined and crafted into components, modules and other items.",Microorganism.png,rare,834,0,0,834,0
564,20441,564,119,Novis Compounds,"Novis Compounds are refined and crafted into components, modules and other items.",Novis_Compound.png,uncommon,1310,0,0,1310,0
564,20442,564,128,Tchaikovium,"Tchaikovium is refined and crafted into components, modules and other items.",Tchaikovium.png,rare,843,0,0,843,0
564,20443,564,119,Novis Compounds,"Novis Compounds are refined and crafted into components, modules and other items.",Novis_Compound.png,uncommon,2334,0,0,2334,0
564,20444,564,106,Elastomers,"Elastomers are refined and crafted into components, modules and other items.",Elastomers.png,abundant,4513,0,0,4513,0
566,20445,566,112,Amphoteric Substances,"Amphoteric Substances are refined and crafted into components, modules and other items.",Amphoteric_Substances.png,common,1110,0,0,1110,0
566,20446,566,112,Amphoteric Substances,"Amphoteric Substances are refined and crafted into components, modules and other items.",Amphoteric_Substances.png,common,2347,0,0,2347,0
566,20447,566,112,Amphoteric Substances,"Amphoteric Substances are refined and crafted into components, modules and other items.",Amphoteric_Substances.png,common,5911,0,0,5911,0
568,20596,568,128,Tchaikovium,"Tchaikovium is refined and crafted into components, modules and other items.",Tchaikovium.png,rare,811,0,0,811,0
568,20597,568,114,Ectopolymers,"Ectopolymers are refined and crafted into components, modules and other items.",Ectopolymers.png,common,2221,0,0,2221,0
568,20598,568,54,Hyperspecular Crystals,"Hyperspecular Crystals are refined and crafted into components, modules and other items.",Hyperspecular_Crystals.png,uncommon,2606,0,0,2606,0
568,20599,568,107,H2O,"H2O is refined and crafted into components, modules and other items.",H20.png,abundant,4591,0,0,4591,0
568,20600,568,106,Elastomers,"Elastomers are refined and crafted into components, modules and other items.",Elastomers.png,abundant,5881,0,0,5881,0
569,20604,569,41,Xensium,"Xensium is refined and crafted into components, modules and other items.",Xensium.png,uncommon,1168,0,0,1168,0
569,20605,569,127,Microorganisms,"Microorganisms are refined and crafted into components, modules and other items.",Microorganism.png,rare,1429,0,0,1429,0
569,20606,569,42,Base Minerals,"Base Minerals are refined and crafted into components, modules and other items.",Base_Mineral.png,abundant,5563,0,0,5563,0
576,1464,576,53,Ignis Ore,"Ignis Ore is refined and crafted into components, modules and other items.",Ignis_Ore.png,rare,893,0,0,893,0
576,2300,576,117,Yprasium,"Yprasium is refined and crafted into components, modules and other items.",Yprasium.png,uncommon,2240,0,0,2240,0
576,2301,576,114,Ectopolymers,"Ectopolymers are refined and crafted into components, modules and other items.",Ectopolymers.png,common,5698,0,0,5698,0
577,9823,577,42,Base Minerals,"Base Minerals are refined and crafted into components, modules and other items.",Base_Mineral.png,abundant,5631,0,0,5631,0
577,10165,577,105,Silicates,"Silicates are refined and crafted into components, modules and other items.",Silicates.png,abundant,2683,0,0,2683,0
577,13102,577,53,Ignis Ore,"Ignis Ore is refined and crafted into components, modules and other items.",Ignis_Ore.png,rare,882,0,0,882,0
577,9934,6677,112,Amphoteric Substances,"Amphoteric Substances are refined and crafted into components, modules and other items.",Amphoteric_Substances.png,common,2649,0,0,2649,0
577,10631,6677,109,Titanium,"Titanium is refined and crafted into components, modules and other items.",Titanium.png,common,1119,0,0,1119,0
577,13135,6677,42,Base Minerals,"Base Minerals are refined and crafted into components, modules and other items.",Base_Mineral.png,abundant,4814,0,0,4814,0
577,13136,6677,112,Amphoteric Substances,"Amphoteric Substances are refined and crafted into components, modules and other items.",Amphoteric_Substances.png,common,4221,0,0,4221,0
581,1465,581,109,Titanium,"Titanium is refined and crafted into components, modules and other items.",Titanium.png,common,1030,0,0,1030,0
581,1466,581,126,Bruma Particles,"Bruma Particles are refined and crafted into components, modules and other items.",Bruma_Particle.png,rare,802,0,0,802,0
581,2302,581,126,Bruma Particles,"Bruma Particles are refined and crafted into components, modules and other items.",Bruma_Particle.png,rare,1819,0,0,1819,0
581,2303,581,113,Aerogens,"Aerogens are refined and crafted into components, modules and other items.",Aerogens.png,common,5319,0,0,5319,0
582,2304,582,54,Hyperspecular Crystals,"Hyperspecular Crystals are refined and crafted into components, modules and other items.",Hyperspecular_Crystals.png,uncommon,2687,0,0,2687,0
582,2305,582,42,Base Minerals,"Base Minerals are refined and crafted into components, modules and other items.",Base_Mineral.png,abundant,5054,0,0,5054,0
582,2672,582,54,Hyperspecular Crystals,"Hyperspecular Crystals are refined and crafted into components, modules and other items.",Hyperspecular_Crystals.png,uncommon,1002,0,0,1002,0
595,5413,595,117,Yprasium,"Yprasium is refined and crafted into components, modules and other items.",Yprasium.png,uncommon,1025,0,0,1025,0
595,11750,595,105,Silicates,"Silicates are refined and crafted into components, modules and other items.",Silicates.png,abundant,4760,476,0,4284,476
595,14687,595,126,Bruma Particles,"Bruma Particles are refined and crafted into components, modules and other items.",Bruma_Particle.png,rare,1764,221,0,1543,221
595,14689,6695,126,Bruma Particles,"Bruma Particles are refined and crafted into components, modules and other items.",Bruma_Particle.png,rare,802,0,0,802,0
595,14692,6695,113,Aerogens,"Aerogens are refined and crafted into components, modules and other items.",Aerogens.png,common,2070,0,0,2070,0
595,15946,6695,115,Nanofluids,"Nanofluids are refined and crafted into components, modules and other items.",Nanofluids.png,common,5121,0,0,5121,0
595,15947,6695,105,Silicates,"Silicates are refined and crafted into components, modules and other items.",Silicates.png,abundant,5844,0,0,5844,0
598,6370,598,107,H2O,"H2O is refined and crafted into components, modules and other items.",H20.png,abundant,2130,0,0,2130,0
599,1689,599,105,Silicates,"Silicates are refined and crafted into components, modules and other items.",Silicates.png,abundant,4473,0,0,4473,0
599,1760,599,114,Ectopolymers,"Ectopolymers are refined and crafted into components, modules and other items.",Ectopolymers.png,common,1354,0,0,1354,0
599,1878,599,117,Yprasium,"Yprasium is refined and crafted into components, modules and other items.",Yprasium.png,uncommon,2765,0,0,2765,0
599,4014,6699,118,Platinyx,"Platinyx is refined and crafted into components, modules and other items.",Platinyx.png,uncommon,1260,0,0,1260,0
599,4015,6699,105,Silicates,"Silicates are refined and crafted into components, modules and other items.",Silicates.png,abundant,2135,0,0,2135,0
599,4016,6699,42,Base Minerals,"Base Minerals are refined and crafted into components, modules and other items.",Base_Mineral.png,abundant,4690,0,0,4690,0
602,2946,602,127,Microorganisms,"Microorganisms are refined and crafted into components, modules and other items.",Microorganism.png,rare,644,0,0,644,0
603,781,603,107,H2O,"H2O is refined and crafted into components, modules and other items.",H20.png,abundant,2540,318,0,2222,318
603,782,603,53,Ignis Ore,"Ignis Ore is refined and crafted into components, modules and other items.",Ignis_Ore.png,rare,1430,0,0,1430,0
603,783,603,105,Silicates,"Silicates are refined and crafted into components, modules and other items.",Silicates.png,abundant,5642,565,0,5077,565
603,810,603,117,Yprasium,"Yprasium is refined and crafted into components, modules and other items.",Yprasium.png,uncommon,1397,280,0,1117,280
603,817,6703,109,Titanium,"Titanium is refined and crafted into components, modules and other items.",Titanium.png,common,1383,0,0,1383,0
603,2731,6703,42,Base Minerals,"Base Minerals are refined and crafted into components, modules and other items.",Base_Mineral.png,abundant,4449,445,0,4004,445
603,2815,6703,117,Yprasium,"Yprasium is refined and crafted into components, modules and other items.",Yprasium.png,uncommon,2786,349,0,2437,349
607,871,607,42,Base Minerals,"Base Minerals are refined and crafted into components, modules and other items.",Base_Mineral.png,abundant,2691,0,0,2691,0
607,872,607,42,Base Minerals,"Base Minerals are refined and crafted into components, modules and other items.",Base_Mineral.png,abundant,2113,0,0,2113,0
610,6766,610,52,Organic Compounds,"Organic Compounds are refined and crafted into components, modules and other items.",Organic_Compound.png,common,2074,0,0,2074,0
613,1761,613,53,Ignis Ore,"Ignis Ore is refined and crafted into components, modules and other items.",Ignis_Ore.png,rare,803,0,0,803,0
613,1762,613,52,Organic Compounds,"Organic Compounds are refined and crafted into components, modules and other items.",Organic_Compound.png,common,5831,0,0,5831,0
613,1884,613,52,Organic Compounds,"Organic Compounds are refined and crafted into components, modules and other items.",Organic_Compound.png,common,2253,0,0,2253,0
613,4017,6713,54,Hyperspecular Crystals,"Hyperspecular Crystals are refined and crafted into components, modules and other items.",Hyperspecular_Crystals.png,uncommon,1458,0,0,1458,0
613,4018,6713,109,Titanium,"Titanium is refined and crafted into components, modules and other items.",Titanium.png,common,2804,0,0,2804,0
613,4019,6713,107,H2O,"H2O is refined and crafted into components, modules and other items.",H20.png,abundant,4071,0,0,4071,0
618,1763,618,106,Elastomers,"Elastomers are refined and crafted into components, modules and other items.",Elastomers.png,abundant,4031,0,0,4031,0
618,1788,618,115,Nanofluids,"Nanofluids are refined and crafted into components, modules and other items.",Nanofluids.png,common,1006,0,0,1006,0
618,1789,618,117,Yprasium,"Yprasium is refined and crafted into components, modules and other items.",Yprasium.png,uncommon,2148,0,0,2148,0
618,4020,6718,121,Hypoatomic Substances,"Hypoatomic Substances are refined and crafted into components, modules and other items.",Hypoatomic_Substances.png,uncommon,1415,0,0,1415,0
618,4021,6718,120,Metamagnetic Ore,"Metamagnetic Ore is refined and crafted into components, modules and other items.",Metamagnetic_Ore.png,uncommon,2958,0,0,2958,0
618,4022,6718,106,Elastomers,"Elastomers are refined and crafted into components, modules and other items.",Elastomers.png,abundant,5088,0,0,5088,0
619,598,619,114,Ectopolymers,"Ectopolymers are refined and crafted into components, modules and other items.",Ectopolymers.png,common,4744,0,0,4744,0
619,599,619,128,Tchaikovium,"Tchaikovium is refined and crafted into components, modules and other items.",Tchaikovium.png,rare,872,0,0,872,0
619,602,619,114,Ectopolymers,"Ectopolymers are refined and crafted into components, modules and other items.",Ectopolymers.png,common,2765,0,0,2765,0
619,603,619,128,Tchaikovium,"Tchaikovium is refined and crafted into components, modules and other items.",Tchaikovium.png,rare,1495,0,0,1495,0
619,18008,6719,119,Novis Compounds,"Novis Compounds are refined and crafted into components, modules and other items.",Novis_Compound.png,uncommon,1204,0,0,1204,0
619,18010,6719,128,Tchaikovium,"Tchaikovium is refined and crafted into components, modules and other items.",Tchaikovium.png,rare,1468,0,0,1468,0
619,18011,6719,42,Base Minerals,"Base Minerals are refined and crafted into components, modules and other items.",Base_Mineral.png,abundant,4010,0,0,4010,0
621,1790,621,107,H2O,"H2O is refined and crafted into components, modules and other items.",H20.png,abundant,5522,0,0,5522,0
621,1839,621,114,Ectopolymers,"Ectopolymers are refined and crafted into components, modules and other items.",Ectopolymers.png,common,1327,0,0,1327,0
621,1887,621,107,H2O,"H2O is refined and crafted into components, modules and other items.",H20.png,abundant,2636,0,0,2636,0
621,4023,6721,126,Bruma Particles,"Bruma Particles are refined and crafted into components, modules and other items.",Bruma_Particle.png,rare,884,0,0,884,0
621,4024,6721,53,Ignis Ore,"Ignis Ore is refined and crafted into components, modules and other items.",Ignis_Ore.png,rare,1424,0,0,1424,0
621,4025,6721,107,H2O,"H2O is refined and crafted into components, modules and other items.",H20.png,abundant,5708,0,0,5708,0
631,4714,631,119,Novis Compounds,"Novis Compounds are refined and crafted into components, modules and other items.",Novis_Compound.png,uncommon,1488,0,0,1488,0
631,4715,631,41,Xensium,"Xensium is refined and crafted into components, modules and other items.",Xensium.png,uncommon,1390,278,0,1112,278
631,4716,631,120,Metamagnetic Ore,"Metamagnetic Ore is refined and crafted into components, modules and other items.",Metamagnetic_Ore.png,uncommon,2386,0,0,2386,0
631,19174,631,42,Base Minerals,"Base Minerals are refined and crafted into components, modules and other items.",Base_Mineral.png,abundant,5571,0,0,5571,0
634,20961,634,106,Elastomers,"Elastomers are refined and crafted into components, modules and other items.",Elastomers.png,abundant,4253,0,0,4253,0
636,8882,636,107,H2O,"H2O is refined and crafted into components, modules and other items.",H20.png,abundant,5037,0,0,5037,0
636,8981,636,109,Titanium,"Titanium is refined and crafted into components, modules and other items.",Titanium.png,common,1331,0,0,1331,0
636,8982,636,126,Bruma Particles,"Bruma Particles are refined and crafted into components, modules and other items.",Bruma_Particle.png,rare,871,350,0,521,350
636,8983,636,123,Neolysium,"Neolysium is refined and crafted into components, modules and other items.",Neolysium.png,uncommon,2785,0,0,2785,0
636,8845,6736,113,Aerogens,"Aerogens are refined and crafted into components, modules and other items.",Aerogens.png,common,2546,0,0,2546,0
636,9011,6736,123,Neolysium,"Neolysium is refined and crafted into components, modules and other items.",Neolysium.png,uncommon,1450,0,0,1450,0
636,9278,6736,113,Aerogens,"Aerogens are refined and crafted into components, modules and other items.",Aerogens.png,common,5774,0,0,5774,0
648,19903,648,119,Novis Compounds,"Novis Compounds are refined and crafted into components, modules and other items.",Novis_Compound.png,uncommon,1380,0,0,1380,0
648,19904,648,52,Organic Compounds,"Organic Compounds are refined and crafted into components, modules and other items.",Organic_Compound.png,common,2675,0,0,2675,0
648,19905,648,54,Hyperspecular Crystals,"Hyperspecular Crystals are refined and crafted into components, modules and other items.",Hyperspecular_Crystals.png,uncommon,2492,0,0,2492,0
648,19906,648,40,Polymetals,"Polymetals are refined and crafted into components, modules and other items.",Polymetals.png,common,4475,0,0,4475,0
650,19907,650,127,Microorganisms,"Microorganisms are refined and crafted into components, modules and other items.",Microorganism.png,rare,851,0,0,851,0
650,19908,650,52,Organic Compounds,"Organic Compounds are refined and crafted into components, modules and other items.",Organic_Compound.png,common,2216,0,0,2216,0
650,19909,650,107,H2O,"H2O is refined and crafted into components, modules and other items.",H20.png,abundant,4166,0,0,4166,0
650,19910,650,107,H2O,"H2O is refined and crafted into components, modules and other items.",H20.png,abundant,5908,0,0,5908,0
653,20102,653,54,Hyperspecular Crystals,"Hyperspecular Crystals are refined and crafted into components, modules and other items.",Hyperspecular_Crystals.png,uncommon,1158,0,0,1158,0
653,20103,653,119,Novis Compounds,"Novis Compounds are refined and crafted into components, modules and other items.",Novis_Compound.png,uncommon,2932,0,0,2932,0
653,20104,653,106,Elastomers,"Elastomers are refined and crafted into components, modules and other items.",Elastomers.png,abundant,4799,0,0,4799,0
655,20105,655,123,Neolysium,"Neolysium is refined and crafted into components, modules and other items.",Neolysium.png,uncommon,1272,0,0,1272,0
655,20106,655,126,Bruma Particles,"Bruma Particles are refined and crafted into components, modules and other items.",Bruma_Particle.png,rare,1286,0,0,1286,0
655,20107,655,42,Base Minerals,"Base Minerals are refined and crafted into components, modules and other items.",Base_Mineral.png,abundant,5252,0,0,5252,0
655,20108,655,109,Titanium,"Titanium is refined and crafted into components, modules and other items.",Titanium.png,common,5908,0,0,5908,0
658,20109,658,127,Microorganisms,"Microorganisms are refined and crafted into components, modules and other items.",Microorganism.png,rare,738,0,0,738,0
658,20110,658,41,Xensium,"Xensium is refined and crafted into components, modules and other items.",Xensium.png,uncommon,1136,0,0,1136,0
658,20111,658,115,Nanofluids,"Nanofluids are refined and crafted into components, modules and other items.",Nanofluids.png,common,2877,0,0,2877,0
658,20112,658,107,H2O,"H2O is refined and crafted into components, modules and other items.",H20.png,abundant,5579,0,0,5579,0
660,20113,660,114,Ectopolymers,"Ectopolymers are refined and crafted into components, modules and other items.",Ectopolymers.png,common,1091,0,0,1091,0
660,20114,660,110,Plutonium,"Plutonium is refined and crafted into components, modules and other items.",Plutonium.png,common,2698,0,0,2698,0
660,20115,660,114,Ectopolymers,"Ectopolymers are refined and crafted into components, modules and other items.",Ectopolymers.png,common,2877,0,0,2877,0
660,20116,660,106,Elastomers,"Elastomers are refined and crafted into components, modules and other items.",Elastomers.png,abundant,4293,0,0,4293,0
668,20117,668,126,Bruma Particles,"Bruma Particles are refined and crafted into components, modules and other items.",Bruma_Particle.png,rare,733,0,0,733,0
668,20118,668,105,Silicates,"Silicates are refined and crafted into components, modules and other items.",Silicates.png,abundant,2526,0,0,2526,0
668,20119,668,105,Silicates,"Silicates are refined and crafted into components, modules and other items.",Silicates.png,abundant,2602,0,0,2602,0
668,20120,668,107,H2O,"H2O is refined and crafted into components, modules and other items.",H20.png,abundant,4415,0,0,4415,0
669,20121,669,128,Tchaikovium,"Tchaikovium is refined and crafted into components, modules and other items.",Tchaikovium.png,rare,669,0,0,669,0
669,20122,669,119,Novis Compounds,"Novis Compounds are refined and crafted into components, modules and other items.",Novis_Compound.png,uncommon,2902,0,0,2902,0
669,20123,669,42,Base Minerals,"Base Minerals are refined and crafted into components, modules and other items.",Base_Mineral.png,abundant,5687,0,0,5687,0
670,20124,670,41,Xensium,"Xensium is refined and crafted into components, modules and other items.",Xensium.png,uncommon,1204,0,0,1204,0
670,20125,670,112,Amphoteric Substances,"Amphoteric Substances are refined and crafted into components, modules and other items.",Amphoteric_Substances.png,common,5000,0,0,5000,0
670,20126,670,42,Base Minerals,"Base Minerals are refined and crafted into components, modules and other items.",Base_Mineral.png,abundant,4317,0,0,4317,0
670,20199,670,112,Amphoteric Substances,"Amphoteric Substances are refined and crafted into components, modules and other items.",Amphoteric_Substances.png,common,2904,0,0,2904,0
672,20127,672,123,Neolysium,"Neolysium is refined and crafted into components, modules and other items.",Neolysium.png,uncommon,1114,0,0,1114,0
672,20362,672,120,Metamagnetic Ore,"Metamagnetic Ore is refined and crafted into components, modules and other items.",Metamagnetic_Ore.png,uncommon,2742,0,0,2742,0
672,20363,672,105,Silicates,"Silicates are refined and crafted into components, modules and other items.",Silicates.png,abundant,5563,0,0,5563,0
673,10462,673,107,H2O,"H2O is refined and crafted into components, modules and other items.",H20.png,abundant,5090,0,0,5090,0
673,10463,673,41,Xensium,"Xensium is refined and crafted into components, modules and other items.",Xensium.png,uncommon,2291,0,0,2291,0
673,10464,673,40,Polymetals,"Polymetals are refined and crafted into components, modules and other items.",Polymetals.png,common,1302,0,0,1302,0
679,20200,679,127,Microorganisms,"Microorganisms are refined and crafted into components, modules and other items.",Microorganism.png,rare,682,0,0,682,0
679,20201,679,40,Polymetals,"Polymetals are refined and crafted into components, modules and other items.",Polymetals.png,common,2662,0,0,2662,0
679,20202,679,107,H2O,"H2O is refined and crafted into components, modules and other items.",H20.png,abundant,5577,0,0,5577,0
684,2306,684,105,Silicates,"Silicates are refined and crafted into components, modules and other items.",Silicates.png,abundant,2216,0,0,2216,0
684,2684,684,53,Ignis Ore,"Ignis Ore is refined and crafted into components, modules and other items.",Ignis_Ore.png,rare,893,0,0,893,0
684,2685,684,114,Ectopolymers,"Ectopolymers are refined and crafted into components, modules and other items.",Ectopolymers.png,common,4310,0,0,4310,0
685,20203,685,114,Ectopolymers,"Ectopolymers are refined and crafted into components, modules and other items.",Ectopolymers.png,common,1188,0,0,1188,0
685,20204,685,106,Elastomers,"Elastomers are refined and crafted into components, modules and other items.",Elastomers.png,abundant,2616,0,0,2616,0
685,20205,685,107,H2O,"H2O is refined and crafted into components, modules and other items.",H20.png,abundant,5250,0,0,5250,0
687,1840,687,126,Bruma Particles,"Bruma Particles are refined and crafted into components, modules and other items.",Bruma_Particle.png,rare,704,0,0,704,0
687,1841,687,117,Yprasium,"Yprasium is refined and crafted into components, modules and other items.",Yprasium.png,uncommon,1473,0,0,1473,0
687,1876,687,113,Aerogens,"Aerogens are refined and crafted into components, modules and other items.",Aerogens.png,common,5156,0,0,5156,0
687,1877,687,115,Nanofluids,"Nanofluids are refined and crafted into components, modules and other items.",Nanofluids.png,common,2110,0,0,2110,0
687,4026,6787,127,Microorganisms,"Microorganisms are refined and crafted into components, modules and other items.",Microorganism.png,rare,633,0,0,633,0
687,4027,6787,107,H2O,"H2O is refined and crafted into components, modules and other items.",H20.png,abundant,2165,0,0,2165,0
687,4028,6787,106,Elastomers,"Elastomers are refined and crafted into components, modules and other items.",Elastomers.png,abundant,4473,0,0,4473,0
691,20396,691,120,Metamagnetic Ore,"Metamagnetic Ore is refined and crafted into components, modules and other items.",Metamagnetic_Ore.png,uncommon,1286,0,0,1286,0
691,20397,691,42,Base Minerals,"Base Minerals are refined and crafted into components, modules and other items.",Base_Mineral.png,abundant,2701,0,0,2701,0
691,20398,691,105,Silicates,"Silicates are refined and crafted into components, modules and other items.",Silicates.png,abundant,4314,0,0,4314,0
693,3959,693,127,Microorganisms,"Microorganisms are refined and crafted into components, modules and other items.",Microorganism.png,rare,658,0,0,658,0
693,3960,693,119,Novis Compounds,"Novis Compounds are refined and crafted into components, modules and other items.",Novis_Compound.png,uncommon,1395,0,0,1395,0
693,3961,693,106,Elastomers,"Elastomers are refined and crafted into components, modules and other items.",Elastomers.png,abundant,2755,0,0,2755,0
693,3962,693,106,Elastomers,"Elastomers are refined and crafted into components, modules and other items.",Elastomers.png,abundant,4475,0,0,4475,0
693,3963,693,42,Base Minerals,"Base Minerals are refined and crafted into components, modules and other items.",Base_Mineral.png,abundant,5862,0,0,5862,0
696,505,696,105,Silicates,"Silicates are refined and crafted into components, modules and other items.",Silicates.png,abundant,5339,0,0,5339,0
696,999,696,105,Silicates,"Silicates are refined and crafted into components, modules and other items.",Silicates.png,abundant,2936,0,0,2936,0
696,1067,696,113,Aerogens,"Aerogens are refined and crafted into components, modules and other items.",Aerogens.png,common,1098,0,0,1098,0
696,1000,6796,105,Silicates,"Silicates are refined and crafted into components, modules and other items.",Silicates.png,abundant,5449,0,0,5449,0
696,1208,6796,109,Titanium,"Titanium is refined and crafted into components, modules and other items.",Titanium.png,common,1258,0,0,1258,0
696,2933,6796,112,Amphoteric Substances,"Amphoteric Substances are refined and crafted into components, modules and other items.",Amphoteric_Substances.png,common,2265,0,0,2265,0
703,2951,703,54,Hyperspecular Crystals,"Hyperspecular Crystals are refined and crafted into components, modules and other items.",Hyperspecular_Crystals.png,uncommon,2260,0,0,2260,0
703,20700,703,128,Tchaikovium,"Tchaikovium is refined and crafted into components, modules and other items.",Tchaikovium.png,rare,610,0,0,610,0
705,600,705,118,Platinyx,"Platinyx is refined and crafted into components, modules and other items.",Platinyx.png,uncommon,1399,0,0,1399,0
705,601,705,106,Elastomers,"Elastomers are refined and crafted into components, modules and other items.",Elastomers.png,abundant,5786,0,0,5786,0
705,604,705,114,Ectopolymers,"Ectopolymers are refined and crafted into components, modules and other items.",Ectopolymers.png,common,2179,0,0,2179,0
705,18012,6805,119,Novis Compounds,"Novis Compounds are refined and crafted into components, modules and other items.",Novis_Compound.png,uncommon,1247,0,0,1247,0
705,18013,6805,120,Metamagnetic Ore,"Metamagnetic Ore is refined and crafted into components, modules and other items.",Metamagnetic_Ore.png,uncommon,2860,0,0,2860,0
705,18014,6805,107,H2O,"H2O is refined and crafted into components, modules and other items.",H20.png,abundant,5073,0,0,5073,0
708,576,708,115,Nanofluids,"Nanofluids are refined and crafted into components, modules and other items.",Nanofluids.png,common,1367,0,0,1367,0
708,688,708,127,Microorganisms,"Microorganisms are refined and crafted into components, modules and other items.",Microorganism.png,rare,1632,0,0,1632,0
708,1001,708,107,H2O,"H2O is refined and crafted into components, modules and other items.",H20.png,abundant,4663,0,0,4663,0
708,2265,6808,115,Nanofluids,"Nanofluids are refined and crafted into components, modules and other items.",Nanofluids.png,common,2103,0,0,2103,0
708,9808,6808,41,Xensium,"Xensium is refined and crafted into components, modules and other items.",Xensium.png,uncommon,1365,0,0,1365,0
708,9809,6808,115,Nanofluids,"Nanofluids are refined and crafted into components, modules and other items.",Nanofluids.png,common,5253,0,0,5253,0
709,577,709,107,H2O,"H2O is refined and crafted into components, modules and other items.",H20.png,abundant,4424,0,0,4424,0
709,607,709,110,Plutonium,"Plutonium is refined and crafted into components, modules and other items.",Plutonium.png,common,2216,0,0,2216,0
709,868,709,40,Polymetals,"Polymetals are refined and crafted into components, modules and other items.",Polymetals.png,common,1021,0,0,1021,0
709,881,6809,109,Titanium,"Titanium is refined and crafted into components, modules and other items.",Titanium.png,common,2058,0,0,2058,0
709,1331,6809,128,Tchaikovium,"Tchaikovium is refined and crafted into components, modules and other items.",Tchaikovium.png,rare,799,0,0,799,0
709,1748,6809,40,Polymetals,"Polymetals are refined and crafted into components, modules and other items.",Polymetals.png,common,5447,0,0,5447,0
709,1749,6809,106,Elastomers,"Elastomers are refined and crafted into components, modules and other items.",Elastomers.png,abundant,4370,0,0,4370,0
712,1847,712,53,Ignis Ore,"Ignis Ore is refined and crafted into components, modules and other items.",Ignis_Ore.png,rare,662,0,0,662,0
712,1889,712,117,Yprasium,"Yprasium is refined and crafted into components, modules and other items.",Yprasium.png,uncommon,2514,0,0,2514,0
712,1912,712,123,Neolysium,"Neolysium is refined and crafted into components, modules and other items.",Neolysium.png,uncommon,5861,0,0,5861,0
712,4029,6812,118,Platinyx,"Platinyx is refined and crafted into components, modules and other items.",Platinyx.png,uncommon,1123,0,0,1123,0
712,4030,6812,52,Organic Compounds,"Organic Compounds are refined and crafted into components, modules and other items.",Organic_Compound.png,common,2266,0,0,2266,0
712,4031,6812,107,H2O,"H2O is refined and crafted into components, modules and other items.",H20.png,abundant,4491,0,0,4491,0
722,274,722,113,Aerogens,"Aerogens are refined and crafted into components, modules and other items.",Aerogens.png,common,4148,0,0,4148,0
722,282,722,109,Titanium,"Titanium is refined and crafted into components, modules and other items.",Titanium.png,common,2276,0,0,2276,0
722,283,722,106,Elastomers,"Elastomers are refined and crafted into components, modules and other items.",Elastomers.png,abundant,2519,0,0,2519,0
722,298,722,54,Hyperspecular Crystals,"Hyperspecular Crystals are refined and crafted into components, modules and other items.",Hyperspecular_Crystals.png,uncommon,1265,0,0,1265,0
722,4032,6822,114,Ectopolymers,"Ectopolymers are refined and crafted into components, modules and other items.",Ectopolymers.png,common,1233,0,0,1233,0
722,4033,6822,109,Titanium,"Titanium is refined and crafted into components, modules and other items.",Titanium.png,common,2978,0,0,2978,0
722,4034,6822,107,H2O,"H2O is refined and crafted into components, modules and other items.",H20.png,abundant,5076,0,0,5076,0
723,3022,723,106,Elastomers,"Elastomers are refined and crafted into components, modules and other items.",Elastomers.png,abundant,5491,0,0,5491,0
727,2694,727,112,Amphoteric Substances,"Amphoteric Substances are refined and crafted into components, modules and other items.",Amphoteric_Substances.png,common,1471,0,0,1471,0
727,2695,727,112,Amphoteric Substances,"Amphoteric Substances are refined and crafted into components, modules and other items.",Amphoteric_Substances.png,common,2216,0,0,2216,0
727,2696,727,107,H2O,"H2O is refined and crafted into components, modules and other items.",H20.png,abundant,5992,0,0,5992,0
732,247,732,126,Bruma Particles,"Bruma Particles are refined and crafted into components, modules and other items.",Bruma_Particle.png,rare,860,0,0,860,0
732,257,732,105,Silicates,"Silicates are refined and crafted into components, modules and other items.",Silicates.png,abundant,2107,0,0,2107,0
732,281,732,113,Aerogens,"Aerogens are refined and crafted into components, modules and other items.",Aerogens.png,common,5235,0,0,5235,0
732,4035,6832,113,Aerogens,"Aerogens are refined and crafted into components, modules and other items.",Aerogens.png,common,1330,0,0,1330,0
732,4036,6832,106,Elastomers,"Elastomers are refined and crafted into components, modules and other items.",Elastomers.png,abundant,2635,0,0,2635,0
732,4037,6832,105,Silicates,"Silicates are refined and crafted into components, modules and other items.",Silicates.png,abundant,5799,0,0,5799,0
733,80,733,120,Metamagnetic Ore,"Metamagnetic Ore is refined and crafted into components, modules and other items.",Metamagnetic_Ore.png,uncommon,1232,0,0,1232,0
733,261,733,110,Plutonium,"Plutonium is refined and crafted into components, modules and other items.",Plutonium.png,common,2610,0,0,2610,0
733,784,733,105,Silicates,"Silicates are refined and crafted into components, modules and other items.",Silicates.png,abundant,4386,2195,0,2191,2195
741,1848,741,117,Yprasium,"Yprasium is refined and crafted into components, modules and other items.",Yprasium.png,uncommon,1422,0,0,1422,0
741,1890,741,109,Titanium,"Titanium is refined and crafted into components, modules and other items.",Titanium.png,common,2538,0,0,2538,0
741,1913,741,42,Base Minerals,"Base Minerals are refined and crafted into components, modules and other items.",Base_Mineral.png,abundant,4140,0,0,4140,0
741,4038,6841,112,Amphoteric Substances,"Amphoteric Substances are refined and crafted into components, modules and other items.",Amphoteric_Substances.png,common,1015,0,0,1015,0
741,4039,6841,109,Titanium,"Titanium is refined and crafted into components, modules and other items.",Titanium.png,common,2620,0,0,2620,0
741,4040,6841,105,Silicates,"Silicates are refined and crafted into components, modules and other items.",Silicates.png,abundant,4788,0,0,4788,0
744,4717,744,114,Ectopolymers,"Ectopolymers are refined and crafted into components, modules and other items.",Ectopolymers.png,common,1450,0,0,1450,0
744,4718,744,54,Hyperspecular Crystals,"Hyperspecular Crystals are refined and crafted into components, modules and other items.",Hyperspecular_Crystals.png,uncommon,1213,0,0,1213,0
744,9703,744,105,Silicates,"Silicates are refined and crafted into components, modules and other items.",Silicates.png,abundant,2407,0,0,2407,0
744,9704,744,106,Elastomers,"Elastomers are refined and crafted into components, modules and other items.",Elastomers.png,abundant,5693,0,0,5693,0
746,20399,746,127,Microorganisms,"Microorganisms are refined and crafted into components, modules and other items.",Microorganism.png,rare,601,0,0,601,0
746,20400,746,127,Microorganisms,"Microorganisms are refined and crafted into components, modules and other items.",Microorganism.png,rare,629,0,0,629,0
746,20401,746,41,Xensium,"Xensium is refined and crafted into components, modules and other items.",Xensium.png,uncommon,2801,0,0,2801,0
746,20402,746,107,H2O,"H2O is refined and crafted into components, modules and other items.",H20.png,abundant,4394,0,0,4394,0
750,2960,750,123,Neolysium,"Neolysium is refined and crafted into components, modules and other items.",Neolysium.png,uncommon,1077,216,0,861,216
750,2961,750,126,Bruma Particles,"Bruma Particles are refined and crafted into components, modules and other items.",Bruma_Particle.png,rare,671,135,0,536,135
750,2962,750,113,Aerogens,"Aerogens are refined and crafted into components, modules and other items.",Aerogens.png,common,2509,314,0,2195,314
750,2963,750,42,Base Minerals,"Base Minerals are refined and crafted into components, modules and other items.",Base_Mineral.png,abundant,4838,484,0,4354,484
750,2964,6850,109,Titanium,"Titanium is refined and crafted into components, modules and other items.",Titanium.png,common,1328,266,0,1062,266
750,2965,6850,126,Bruma Particles,"Bruma Particles are refined and crafted into components, modules and other items.",Bruma_Particle.png,rare,772,155,0,617,155
750,2966,6850,42,Base Minerals,"Base Minerals are refined and crafted into components, modules and other items.",Base_Mineral.png,abundant,2701,338,0,2363,338
750,2967,6850,113,Aerogens,"Aerogens are refined and crafted into components, modules and other items.",Aerogens.png,common,5673,568,0,5105,568
751,2466,751,127,Microorganisms,"Microorganisms are refined and crafted into components, modules and other items.",Microorganism.png,rare,698,0,0,698,0
751,2467,751,114,Ectopolymers,"Ectopolymers are refined and crafted into components, modules and other items.",Ectopolymers.png,common,2879,0,0,2879,0
751,2468,751,40,Polymetals,"Polymetals are refined and crafted into components, modules and other items.",Polymetals.png,common,2499,0,0,2499,0
751,2470,751,112,Amphoteric Substances,"Amphoteric Substances are refined and crafted into components, modules and other items.",Amphoteric_Substances.png,common,4563,0,0,4563,0
753,4708,753,42,Base Minerals,"Base Minerals are refined and crafted into components, modules and other items.",Base_Mineral.png,abundant,4793,0,0,4793,0
753,4709,753,40,Polymetals,"Polymetals are refined and crafted into components, modules and other items.",Polymetals.png,common,4866,0,0,4866,0
753,16505,753,128,Tchaikovium,"Tchaikovium is refined and crafted into components, modules and other items.",Tchaikovium.png,rare,670,0,0,670,0
753,4552,6853,118,Platinyx,"Platinyx is refined and crafted into components, modules and other items.",Platinyx.png,uncommon,2205,0,0,2205,0
753,4553,6853,128,Tchaikovium,"Tchaikovium is refined and crafted into components, modules and other items.",Tchaikovium.png,rare,713,429,0,284,429
753,4790,6853,106,Elastomers,"Elastomers are refined and crafted into components, modules and other items.",Elastomers.png,abundant,5209,0,0,5209,0
763,18264,763,127,Microorganisms,"Microorganisms are refined and crafted into components, modules and other items.",Microorganism.png,rare,871,0,0,871,0
763,18265,763,127,Microorganisms,"Microorganisms are refined and crafted into components, modules and other items.",Microorganism.png,rare,1341,0,0,1341,0
763,18266,763,107,H2O,"H2O is refined and crafted into components, modules and other items.",H20.png,abundant,4323,0,0,4323,0
763,18267,763,106,Elastomers,"Elastomers are refined and crafted into components, modules and other items.",Elastomers.png,abundant,4925,0,0,4925,0
774,3019,774,114,Ectopolymers,"Ectopolymers are refined and crafted into components, modules and other items.",Ectopolymers.png,common,1136,0,0,1136,0
774,3020,774,52,Organic Compounds,"Organic Compounds are refined and crafted into components, modules and other items.",Organic_Compound.png,common,1117,0,0,1117,0
774,3033,774,118,Platinyx,"Platinyx is refined and crafted into components, modules and other items.",Platinyx.png,uncommon,2135,0,0,2135,0
774,3045,774,105,Silicates,"Silicates are refined and crafted into components, modules and other items.",Silicates.png,abundant,4368,0,0,4368,0
774,9571,6874,105,Silicates,"Silicates are refined and crafted into components, modules and other items.",Silicates.png,abundant,4314,0,0,4314,0
774,9671,6874,126,Bruma Particles,"Bruma Particles are refined and crafted into components, modules and other items.",Bruma_Particle.png,rare,682,0,0,682,0
774,9825,6874,126,Bruma Particles,"Bruma Particles are refined and crafted into components, modules and other items.",Bruma_Particle.png,rare,1761,0,0,1761,0
786,122,786,42,Base Minerals,"Base Minerals are refined and crafted into components, modules and other items.",Base_Mineral.png,abundant,5379,0,0,5379,0
786,123,786,120,Metamagnetic Ore,"Metamagnetic Ore is refined and crafted into components, modules and other items.",Metamagnetic_Ore.png,uncommon,5791,0,0,5791,0
786,130,786,53,Ignis Ore,"Ignis Ore is refined and crafted into components, modules and other items.",Ignis_Ore.png,rare,753,0,0,753,0
786,131,786,40,Polymetals,"Polymetals are refined and crafted into components, modules and other items.",Polymetals.png,common,2818,0,0,2818,0
786,205,6886,106,Elastomers,"Elastomers are refined and crafted into components, modules and other items.",Elastomers.png,abundant,5835,0,0,5835,0
787,20403,787,126,Bruma Particles,"Bruma Particles are refined and crafted into components, modules and other items.",Bruma_Particle.png,rare,680,0,0,680,0
787,20463,787,54,Hyperspecular Crystals,"Hyperspecular Crystals are refined and crafted into components, modules and other items.",Hyperspecular_Crystals.png,uncommon,2834,0,0,2834,0
787,20464,787,113,Aerogens,"Aerogens are refined and crafted into components, modules and other items.",Aerogens.png,common,5704,0,0,5704,0
793,20465,793,112,Amphoteric Substances,"Amphoteric Substances are refined and crafted into components, modules and other items.",Amphoteric_Substances.png,common,1108,0,0,1108,0
793,20466,793,53,Ignis Ore,"Ignis Ore is refined and crafted into components, modules and other items.",Ignis_Ore.png,rare,796,0,0,796,0
793,20467,793,42,Base Minerals,"Base Minerals are refined and crafted into components, modules and other items.",Base_Mineral.png,abundant,2128,0,0,2128,0
793,20468,793,42,Base Minerals,"Base Minerals are refined and crafted into components, modules and other items.",Base_Mineral.png,abundant,5481,0,0,5481,0
795,2968,795,121,Hypoatomic Substances,"Hypoatomic Substances are refined and crafted into components, modules and other items.",Hypoatomic_Substances.png,uncommon,1105,221,0,884,221
795,2969,795,120,Metamagnetic Ore,"Metamagnetic Ore is refined and crafted into components, modules and other items.",Metamagnetic_Ore.png,uncommon,2981,373,0,2608,373
795,2970,795,106,Elastomers,"Elastomers are refined and crafted into components, modules and other items.",Elastomers.png,abundant,5040,504,0,4536,504
795,2971,6895,127,Microorganisms,"Microorganisms are refined and crafted into components, modules and other items.",Microorganism.png,rare,706,142,0,564,142
795,2972,6895,107,H2O,"H2O is refined and crafted into components, modules and other items.",H20.png,abundant,4550,455,0,4095,455
795,3964,6895,52,Organic Compounds,"Organic Compounds are refined and crafted into components, modules and other items.",Organic_Compound.png,common,2947,369,0,2578,369
796,20601,796,52,Organic Compounds,"Organic Compounds are refined and crafted into components, modules and other items.",Organic_Compound.png,common,1189,0,0,1189,0
796,20602,796,117,Yprasium,"Yprasium is refined and crafted into components, modules and other items.",Yprasium.png,uncommon,2596,0,0,2596,0
796,20603,796,107,H2O,"H2O is refined and crafted into components, modules and other items.",H20.png,abundant,4699,0,0,4699,0
808,20838,808,119,Novis Compounds,"Novis Compounds are refined and crafted into components, modules and other items.",Novis_Compound.png,uncommon,1499,0,0,1499,0
808,20890,808,106,Elastomers,"Elastomers are refined and crafted into components, modules and other items.",Elastomers.png,abundant,2162,0,0,2162,0
808,20958,808,54,Hyperspecular Crystals,"Hyperspecular Crystals are refined and crafted into components, modules and other items.",Hyperspecular_Crystals.png,uncommon,4303,0,0,4303,0
809,20609,809,123,Neolysium,"Neolysium is refined and crafted into components, modules and other items.",Neolysium.png,uncommon,1112,0,0,1112,0
809,20633,809,42,Base Minerals,"Base Minerals are refined and crafted into components, modules and other items.",Base_Mineral.png,abundant,2109,0,0,2109,0
809,20634,809,105,Silicates,"Silicates are refined and crafted into components, modules and other items.",Silicates.png,abundant,4851,0,0,4851,0
815,949,815,121,Hypoatomic Substances,"Hypoatomic Substances are refined and crafted into components, modules and other items.",Hypoatomic_Substances.png,uncommon,1480,0,0,1480,0
815,950,815,119,Novis Compounds,"Novis Compounds are refined and crafted into components, modules and other items.",Novis_Compound.png,uncommon,1143,0,0,1143,0
815,956,815,114,Ectopolymers,"Ectopolymers are refined and crafted into components, modules and other items.",Ectopolymers.png,common,2385,0,0,2385,0
815,1235,815,106,Elastomers,"Elastomers are refined and crafted into components, modules and other items.",Elastomers.png,abundant,4364,0,0,4364,0
815,1236,6915,114,Ectopolymers,"Ectopolymers are refined and crafted into components, modules and other items.",Ectopolymers.png,common,1021,0,0,1021,0
815,1298,6915,114,Ectopolymers,"Ectopolymers are refined and crafted into components, modules and other items.",Ectopolymers.png,common,2344,0,0,2344,0
815,2285,6915,105,Silicates,"Silicates are refined and crafted into components, modules and other items.",Silicates.png,abundant,4733,0,0,4733,0
820,206,820,106,Elastomers,"Elastomers are refined and crafted into components, modules and other items.",Elastomers.png,abundant,5825,0,0,5825,0
820,207,820,107,H2O,"H2O is refined and crafted into components, modules and other items.",H20.png,abundant,5111,0,0,5111,0
820,208,820,117,Yprasium,"Yprasium is refined and crafted into components, modules and other items.",Yprasium.png,uncommon,1493,0,0,1493,0
820,209,820,106,Elastomers,"Elastomers are refined and crafted into components, modules and other items.",Elastomers.png,abundant,2452,0,0,2452,0
821,4423,821,126,Bruma Particles,"Bruma Particles are refined and crafted into components, modules and other items.",Bruma_Particle.png,rare,653,0,0,653,0
821,4429,821,105,Silicates,"Silicates are refined and crafted into components, modules and other items.",Silicates.png,abundant,2511,0,0,2511,0
821,4430,821,107,H2O,"H2O is refined and crafted into components, modules and other items.",H20.png,abundant,4068,0,0,4068,0
821,4431,821,113,Aerogens,"Aerogens are refined and crafted into components, modules and other items.",Aerogens.png,common,5383,0,0,5383,0
821,4432,6921,113,Aerogens,"Aerogens are refined and crafted into components, modules and other items.",Aerogens.png,common,1114,0,0,1114,0
821,4433,6921,107,H2O,"H2O is refined and crafted into components, modules and other items.",H20.png,abundant,2774,0,0,2774,0
821,4461,6921,107,H2O,"H2O is refined and crafted into components, modules and other items.",H20.png,abundant,4114,0,0,4114,0
824,20635,824,128,Tchaikovium,"Tchaikovium is refined and crafted into components, modules and other items.",Tchaikovium.png,rare,889,0,0,889,0
824,20636,824,127,Microorganisms,"Microorganisms are refined and crafted into components, modules and other items.",Microorganism.png,rare,1302,0,0,1302,0
824,20637,824,105,Silicates,"Silicates are refined and crafted into components, modules and other items.",Silicates.png,abundant,4467,0,0,4467,0
828,2983,828,123,Neolysium,"Neolysium is refined and crafted into components, modules and other items.",Neolysium.png,uncommon,1171,0,0,1171,0
828,2984,828,54,Hyperspecular Crystals,"Hyperspecular Crystals are refined and crafted into components, modules and other items.",Hyperspecular_Crystals.png,uncommon,1068,0,0,1068,0
829,210,829,110,Plutonium,"Plutonium is refined and crafted into components, modules and other items.",Plutonium.png,common,5544,555,0,4989,555
829,211,829,42,Base Minerals,"Base Minerals are refined and crafted into components, modules and other items.",Base_Mineral.png,abundant,5011,0,0,5011,0
829,212,829,110,Plutonium,"Plutonium is refined and crafted into components, modules and other items.",Plutonium.png,common,1139,0,0,1139,0
829,213,829,114,Ectopolymers,"Ectopolymers are refined and crafted into components, modules and other items.",Ectopolymers.png,common,2569,0,0,2569,0
834,2463,834,53,Ignis Ore,"Ignis Ore is refined and crafted into components, modules and other items.",Ignis_Ore.png,rare,659,0,0,659,0
834,2464,834,118,Platinyx,"Platinyx is refined and crafted into components, modules and other items.",Platinyx.png,uncommon,2872,0,0,2872,0
834,2465,834,107,H2O,"H2O is refined and crafted into components, modules and other items.",H20.png,abundant,4851,0,0,4851,0
836,10860,836,107,H2O,"H2O is refined and crafted into components, modules and other items.",H20.png,abundant,4534,0,0,4534,0
836,10861,836,42,Base Minerals,"Base Minerals are refined and crafted into components, modules and other items.",Base_Mineral.png,abundant,5952,0,0,5952,0
836,12178,836,113,Aerogens,"Aerogens are refined and crafted into components, modules and other items.",Aerogens.png,common,2146,0,0,2146,0
836,20736,836,54,Hyperspecular Crystals,"Hyperspecular Crystals are refined and crafted into components, modules and other items.",Hyperspecular_Crystals.png,uncommon,1232,0,0,1232,0
836,20737,836,54,Hyperspecular Crystals,"Hyperspecular Crystals are refined and crafted into components, modules and other items.",Hyperspecular_Crystals.png,uncommon,1335,0,0,1335,0
836,15643,6936,42,Base Minerals,"Base Minerals are refined and crafted into components, modules and other items.",Base_Mineral.png,abundant,2938,0,0,2938,0
836,15944,6936,113,Aerogens,"Aerogens are refined and crafted into components, modules and other items.",Aerogens.png,common,1069,0,0,1069,0
836,15945,6936,54,Hyperspecular Crystals,"Hyperspecular Crystals are refined and crafted into components, modules and other items.",Hyperspecular_Crystals.png,uncommon,1278,0,0,1278,0
837,10561,837,113,Aerogens,"Aerogens are refined and crafted into components, modules and other items.",Aerogens.png,common,1326,0,0,1326,0
837,10596,837,115,Nanofluids,"Nanofluids are refined and crafted into components, modules and other items.",Nanofluids.png,common,2308,0,0,2308,0
837,12442,837,106,Elastomers,"Elastomers are refined and crafted into components, modules and other items.",Elastomers.png,abundant,4524,0,0,4524,0
837,11157,6937,107,H2O,"H2O is refined and crafted into components, modules and other items.",H20.png,abundant,5676,0,0,5676,0
837,13168,6937,117,Yprasium,"Yprasium is refined and crafted into components, modules and other items.",Yprasium.png,uncommon,1441,0,0,1441,0
837,17750,6937,115,Nanofluids,"Nanofluids are refined and crafted into components, modules and other items.",Nanofluids.png,common,2195,0,0,2195,0
838,18268,838,121,Hypoatomic Substances,"Hypoatomic Substances are refined and crafted into components, modules and other items.",Hypoatomic_Substances.png,uncommon,1440,0,0,1440,0
838,18269,838,42,Base Minerals,"Base Minerals are refined and crafted into components, modules and other items.",Base_Mineral.png,abundant,5320,0,0,5320,0
838,18270,838,127,Microorganisms,"Microorganisms are refined and crafted into components, modules and other items.",Microorganism.png,rare,1518,190,0,1328,190
838,18271,838,106,Elastomers,"Elastomers are refined and crafted into components, modules and other items.",Elastomers.png,abundant,2538,0,0,2538,0
841,5517,841,105,Silicates,"Silicates are refined and crafted into components, modules and other items.",Silicates.png,abundant,2314,0,0,2314,0
841,5518,841,42,Base Minerals,"Base Minerals are refined and crafted into components, modules and other items.",Base_Mineral.png,abundant,5883,0,0,5883,0
841,14593,841,120,Metamagnetic Ore,"Metamagnetic Ore is refined and crafted into components, modules and other items.",Metamagnetic_Ore.png,uncommon,1448,0,0,1448,0
841,14594,841,109,Titanium,"Titanium is refined and crafted into components, modules and other items.",Titanium.png,common,1171,0,0,1171,0
841,14620,6941,42,Base Minerals,"Base Minerals are refined and crafted into components, modules and other items.",Base_Mineral.png,abundant,5820,0,0,5820,0
842,1162,842,110,Plutonium,"Plutonium is refined and crafted into components, modules and other items.",Plutonium.png,common,2119,0,0,2119,0
842,1163,842,118,Platinyx,"Platinyx is refined and crafted into components, modules and other items.",Platinyx.png,uncommon,2204,0,0,2204,0
842,1178,842,118,Platinyx,"Platinyx is refined and crafted into components, modules and other items.",Platinyx.png,uncommon,1338,0,0,1338,0
842,1330,842,42,Base Minerals,"Base Minerals are refined and crafted into components, modules and other items.",Base_Mineral.png,abundant,4437,0,0,4437,0
842,4875,6942,128,Tchaikovium,"Tchaikovium is refined and crafted into components, modules and other items.",Tchaikovium.png,rare,711,0,0,711,0
842,4951,6942,105,Silicates,"Silicates are refined and crafted into components, modules and other items.",Silicates.png,abundant,2348,0,0,2348,0
842,5215,6942,118,Platinyx,"Platinyx is refined and crafted into components, modules and other items.",Platinyx.png,uncommon,5941,0,0,5941,0
844,16706,844,126,Bruma Particles,"Bruma Particles are refined and crafted into components, modules and other items.",Bruma_Particle.png,rare,620,0,0,620,0
844,16707,844,126,Bruma Particles,"Bruma Particles are refined and crafted into components, modules and other items.",Bruma_Particle.png,rare,716,0,0,716,0
844,16732,844,54,Hyperspecular Crystals,"Hyperspecular Crystals are refined and crafted into components, modules and other items.",Hyperspecular_Crystals.png,uncommon,2929,0,0,2929,0
844,16733,844,113,Aerogens,"Aerogens are refined and crafted into components, modules and other items.",Aerogens.png,common,2699,0,0,2699,0
844,16736,844,107,H2O,"H2O is refined and crafted into components, modules and other items.",H20.png,abundant,5598,0,0,5598,0
844,18521,6944,126,Bruma Particles,"Bruma Particles are refined and crafted into components, modules and other items.",Bruma_Particle.png,rare,829,0,0,829,0
844,18522,6944,126,Bruma Particles,"Bruma Particles are refined and crafted into components, modules and other items.",Bruma_Particle.png,rare,789,0,0,789,0
844,18523,6944,52,Organic Compounds,"Organic Compounds are refined and crafted into components, modules and other items.",Organic_Compound.png,common,2273,0,0,2273,0
844,18524,6944,107,H2O,"H2O is refined and crafted into components, modules and other items.",H20.png,abundant,4754,0,0,4754,0
847,811,847,40,Polymetals,"Polymetals are refined and crafted into components, modules and other items.",Polymetals.png,common,2529,0,0,2529,0
847,812,847,42,Base Minerals,"Base Minerals are refined and crafted into components, modules and other items.",Base_Mineral.png,abundant,5295,530,0,4765,530
847,818,847,53,Ignis Ore,"Ignis Ore is refined and crafted into components, modules and other items.",Ignis_Ore.png,rare,755,0,0,755,0
847,2730,6947,40,Polymetals,"Polymetals are refined and crafted into components, modules and other items.",Polymetals.png,common,1188,0,0,1188,0
847,2809,6947,42,Base Minerals,"Base Minerals are refined and crafted into components, modules and other items.",Base_Mineral.png,abundant,4586,459,0,4127,459
847,3080,6947,105,Silicates,"Silicates are refined and crafted into components, modules and other items.",Silicates.png,abundant,2586,0,0,2586,0
848,7890,848,109,Titanium,"Titanium is refined and crafted into components, modules and other items.",Titanium.png,common,2892,0,0,2892,0
848,7891,848,119,Novis Compounds,"Novis Compounds are refined and crafted into components, modules and other items.",Novis_Compound.png,uncommon,2561,0,0,2561,0
850,20638,850,128,Tchaikovium,"Tchaikovium is refined and crafted into components, modules and other items.",Tchaikovium.png,rare,875,0,0,875,0
850,20639,850,110,Plutonium,"Plutonium is refined and crafted into components, modules and other items.",Plutonium.png,common,2801,0,0,2801,0
850,20640,850,42,Base Minerals,"Base Minerals are refined and crafted into components, modules and other items.",Base_Mineral.png,abundant,5866,0,0,5866,0
854,1860,854,119,Novis Compounds,"Novis Compounds are refined and crafted into components, modules and other items.",Novis_Compound.png,uncommon,1053,0,0,1053,0
854,1893,854,40,Polymetals,"Polymetals are refined and crafted into components, modules and other items.",Polymetals.png,common,2816,0,0,2816,0
854,1937,854,107,H2O,"H2O is refined and crafted into components, modules and other items.",H20.png,abundant,4397,0,0,4397,0
854,4041,6954,127,Microorganisms,"Microorganisms are refined and crafted into components, modules and other items.",Microorganism.png,rare,617,0,0,617,0
854,4042,6954,106,Elastomers,"Elastomers are refined and crafted into components, modules and other items.",Elastomers.png,abundant,2669,0,0,2669,0
854,4043,6954,105,Silicates,"Silicates are refined and crafted into components, modules and other items.",Silicates.png,abundant,4885,0,0,4885,0
855,2973,855,121,Hypoatomic Substances,"Hypoatomic Substances are refined and crafted into components, modules and other items.",Hypoatomic_Substances.png,uncommon,1103,221,0,882,221
855,2974,855,106,Elastomers,"Elastomers are refined and crafted into components, modules and other items.",Elastomers.png,abundant,2889,362,0,2527,362
855,2975,855,106,Elastomers,"Elastomers are refined and crafted into components, modules and other items.",Elastomers.png,abundant,2255,282,0,1973,282
855,2976,855,105,Silicates,"Silicates are refined and crafted into components, modules and other items.",Silicates.png,abundant,4124,413,0,3711,413
855,2977,6955,126,Bruma Particles,"Bruma Particles are refined and crafted into components, modules and other items.",Bruma_Particle.png,rare,812,163,0,649,163
855,2978,6955,106,Elastomers,"Elastomers are refined and crafted into components, modules and other items.",Elastomers.png,abundant,4080,408,0,3672,408
855,3965,6955,113,Aerogens,"Aerogens are refined and crafted into components, modules and other items.",Aerogens.png,common,2759,0,0,2759,0
857,2697,857,41,Xensium,"Xensium is refined and crafted into components, modules and other items.",Xensium.png,uncommon,1259,0,0,1259,0
857,2698,857,110,Plutonium,"Plutonium is refined and crafted into components, modules and other items.",Plutonium.png,common,2893,0,0,2893,0
857,2699,857,120,Metamagnetic Ore,"Metamagnetic Ore is refined and crafted into components, modules and other items.",Metamagnetic_Ore.png,uncommon,5920,0,0,5920,0
871,16504,871,41,Xensium,"Xensium is refined and crafted into components, modules and other items.",Xensium.png,uncommon,1032,0,0,1032,0
871,16930,871,40,Polymetals,"Polymetals are refined and crafted into components, modules and other items.",Polymetals.png,common,2935,0,0,2935,0
871,17491,871,112,Amphoteric Substances,"Amphoteric Substances are refined and crafted into components, modules and other items.",Amphoteric_Substances.png,common,4315,0,0,4315,0
875,320,875,115,Nanofluids,"Nanofluids are refined and crafted into components, modules and other items.",Nanofluids.png,common,2765,0,0,2765,0
875,328,875,126,Bruma Particles,"Bruma Particles are refined and crafted into components, modules and other items.",Bruma_Particle.png,rare,851,0,0,851,0
875,374,875,42,Base Minerals,"Base Minerals are refined and crafted into components, modules and other items.",Base_Mineral.png,abundant,4877,0,0,4877,0
875,18015,6975,127,Microorganisms,"Microorganisms are refined and crafted into components, modules and other items.",Microorganism.png,rare,639,0,0,639,0
875,18016,6975,110,Plutonium,"Plutonium is refined and crafted into components, modules and other items.",Plutonium.png,common,2114,0,0,2114,0
875,18017,6975,119,Novis Compounds,"Novis Compounds are refined and crafted into components, modules and other items.",Novis_Compound.png,uncommon,2289,0,0,2289,0
875,18018,6975,106,Elastomers,"Elastomers are refined and crafted into components, modules and other items.",Elastomers.png,abundant,4429,0,0,4429,0
877,575,877,41,Xensium,"Xensium is refined and crafted into components, modules and other items.",Xensium.png,uncommon,1386,0,0,1386,0
877,656,877,115,Nanofluids,"Nanofluids are refined and crafted into components, modules and other items.",Nanofluids.png,common,5856,5856,0,0,5856
877,691,877,107,H2O,"H2O is refined and crafted into components, modules and other items.",H20.png,abundant,2695,2695,0,0,2695
877,1250,6977,127,Microorganisms,"Microorganisms are refined and crafted into components, modules and other items.",Microorganism.png,rare,849,680,0,169,680
877,1251,6977,121,Hypoatomic Substances,"Hypoatomic Substances are refined and crafted into components, modules and other items.",Hypoatomic_Substances.png,uncommon,1374,0,0,1374,0
877,1988,6977,52,Organic Compounds,"Organic Compounds are refined and crafted into components, modules and other items.",Organic_Compound.png,common,2662,0,0,2662,0
877,1989,6977,106,Elastomers,"Elastomers are refined and crafted into components, modules and other items.",Elastomers.png,abundant,5088,1018,0,4070,1018
879,3023,879,106,Elastomers,"Elastomers are refined and crafted into components, modules and other items.",Elastomers.png,abundant,4297,0,0,4297,0
880,1171,880,113,Aerogens,"Aerogens are refined and crafted into components, modules and other items.",Aerogens.png,common,2158,0,0,2158,0
880,1172,880,106,Elastomers,"Elastomers are refined and crafted into components, modules and other items.",Elastomers.png,abundant,4647,930,0,3717,930
880,4489,880,128,Tchaikovium,"Tchaikovium is refined and crafted into components, modules and other items.",Tchaikovium.png,rare,853,0,0,853,0
880,4502,6980,42,Base Minerals,"Base Minerals are refined and crafted into components, modules and other items.",Base_Mineral.png,abundant,2744,0,0,2744,0
880,4529,6980,123,Neolysium,"Neolysium is refined and crafted into components, modules and other items.",Neolysium.png,uncommon,1073,215,0,858,215
880,4543,6980,42,Base Minerals,"Base Minerals are refined and crafted into components, modules and other items.",Base_Mineral.png,abundant,4560,0,0,4560,0
885,1894,885,115,Nanofluids,"Nanofluids are refined and crafted into components, modules and other items.",Nanofluids.png,common,2716,0,0,2716,0
885,1905,885,126,Bruma Particles,"Bruma Particles are refined and crafted into components, modules and other items.",Bruma_Particle.png,rare,686,0,0,686,0
885,1938,885,52,Organic Compounds,"Organic Compounds are refined and crafted into components, modules and other items.",Organic_Compound.png,common,5407,0,0,5407,0
885,4044,6985,113,Aerogens,"Aerogens are refined and crafted into components, modules and other items.",Aerogens.png,common,1063,0,0,1063,0
885,4045,6985,121,Hypoatomic Substances,"Hypoatomic Substances are refined and crafted into components, modules and other items.",Hypoatomic_Substances.png,uncommon,2488,0,0,2488,0
885,4046,6985,105,Silicates,"Silicates are refined and crafted into components, modules and other items.",Silicates.png,abundant,5681,0,0,5681,0
886,619,886,127,Microorganisms,"Microorganisms are refined and crafted into components, modules and other items.",Microorganism.png,rare,817,0,0,817,0
886,1478,886,106,Elastomers,"Elastomers are refined and crafted into components, modules and other items.",Elastomers.png,abundant,2715,0,0,2715,0
886,1479,886,107,H2O,"H2O is refined and crafted into components, modules and other items.",H20.png,abundant,5799,0,0,5799,0
886,1488,6986,128,Tchaikovium,"Tchaikovium is refined and crafted into components, modules and other items.",Tchaikovium.png,rare,664,0,0,664,0
886,1489,6986,127,Microorganisms,"Microorganisms are refined and crafted into components, modules and other items.",Microorganism.png,rare,656,0,0,656,0
886,3089,6986,112,Amphoteric Substances,"Amphoteric Substances are refined and crafted into components, modules and other items.",Amphoteric_Substances.png,common,2488,0,0,2488,0
886,7657,6986,107,H2O,"H2O is refined and crafted into components, modules and other items.",H20.png,abundant,4412,0,0,4412,0
887,524,887,114,Ectopolymers,"Ectopolymers are refined and crafted into components, modules and other items.",Ectopolymers.png,common,4934,0,0,4934,0
887,1121,887,126,Bruma Particles,"Bruma Particles are refined and crafted into components, modules and other items.",Bruma_Particle.png,rare,792,0,0,792,0
887,1165,887,123,Neolysium,"Neolysium is refined and crafted into components, modules and other items.",Neolysium.png,uncommon,2348,0,0,2348,0
887,1011,6987,42,Base Minerals,"Base Minerals are refined and crafted into components, modules and other items.",Base_Mineral.png,abundant,5277,0,0,5277,0
887,3077,6987,105,Silicates,"Silicates are refined and crafted into components, modules and other items.",Silicates.png,abundant,2900,0,0,2900,0
887,3118,6987,53,Ignis Ore,"Ignis Ore is refined and crafted into components, modules and other items.",Ignis_Ore.png,rare,671,0,0,671,0
887,3119,6987,120,Metamagnetic Ore,"Metamagnetic Ore is refined and crafted into components, modules and other items.",Metamagnetic_Ore.png,uncommon,1409,0,0,1409,0
890,1222,890,127,Microorganisms,"Microorganisms are refined and crafted into components, modules and other items.",Microorganism.png,rare,748,0,0,748,0
890,1234,890,106,Elastomers,"Elastomers are refined and crafted into components, modules and other items.",Elastomers.png,abundant,2325,0,0,2325,0
890,1454,890,107,H2O,"H2O is refined and crafted into components, modules and other items.",H20.png,abundant,4577,0,0,4577,0
890,5314,6990,123,Neolysium,"Neolysium is refined and crafted into components, modules and other items.",Neolysium.png,uncommon,1217,0,0,1217,0
890,5446,6990,127,Microorganisms,"Microorganisms are refined and crafted into components, modules and other items.",Microorganism.png,rare,1858,0,0,1858,0
890,5588,6990,107,H2O,"H2O is refined and crafted into components, modules and other items.",H20.png,abundant,5773,0,0,5773,0
895,2947,895,120,Metamagnetic Ore,"Metamagnetic Ore is refined and crafted into components, modules and other items.",Metamagnetic_Ore.png,uncommon,1151,0,0,1151,0
898,557,898,127,Microorganisms,"Microorganisms are refined and crafted into components, modules and other items.",Microorganism.png,rare,725,0,0,725,0
898,696,898,106,Elastomers,"Elastomers are refined and crafted into components, modules and other items.",Elastomers.png,abundant,2257,0,0,2257,0
898,3955,898,107,H2O,"H2O is refined and crafted into components, modules and other items.",H20.png,abundant,4791,0,0,4791,0
898,2291,6998,112,Amphoteric Substances,"Amphoteric Substances are refined and crafted into components, modules and other items.",Amphoteric_Substances.png,common,2661,0,0,2661,0
898,9078,6998,106,Elastomers,"Elastomers are refined and crafted into components, modules and other items.",Elastomers.png,abundant,5415,0,0,5415,0
898,9810,6998,41,Xensium,"Xensium is refined and crafted into components, modules and other items.",Xensium.png,uncommon,1128,0,0,1128,0
901,2700,901,107,H2O,"H2O is refined and crafted into components, modules and other items.",H20.png,abundant,2714,0,0,2714,0
901,2701,901,107,H2O,"H2O is refined and crafted into components, modules and other items.",H20.png,abundant,5644,0,0,5644,0
904,20641,904,127,Microorganisms,"Microorganisms are refined and crafted into components, modules and other items.",Microorganism.png,rare,616,0,0,616,0
904,20642,904,54,Hyperspecular Crystals,"Hyperspecular Crystals are refined and crafted into components, modules and other items.",Hyperspecular_Crystals.png,uncommon,2941,0,0,2941,0
904,20643,904,42,Base Minerals,"Base Minerals are refined and crafted into components, modules and other items.",Base_Mineral.png,abundant,4179,0,0,4179,0
914,20133,914,105,Silicates,"Silicates are refined and crafted into components, modules and other items.",Silicates.png,abundant,4386,0,0,4386,0
914,20693,914,127,Microorganisms,"Microorganisms are refined and crafted into components, modules and other items.",Microorganism.png,rare,804,0,0,804,0
914,20694,914,117,Yprasium,"Yprasium is refined and crafted into components, modules and other items.",Yprasium.png,uncommon,2554,0,0,2554,0
916,2979,916,123,Neolysium,"Neolysium is refined and crafted into components, modules and other items.",Neolysium.png,uncommon,1438,288,0,1150,288
916,2980,916,112,Amphoteric Substances,"Amphoteric Substances are refined and crafted into components, modules and other items.",Amphoteric_Substances.png,common,2348,294,0,2054,294
916,4596,916,105,Silicates,"Silicates are refined and crafted into components, modules and other items.",Silicates.png,abundant,5103,511,0,4592,511
916,4597,7016,120,Metamagnetic Ore,"Metamagnetic Ore is refined and crafted into components, modules and other items.",Metamagnetic_Ore.png,uncommon,1131,227,0,904,227
916,4683,7016,42,Base Minerals,"Base Minerals are refined and crafted into components, modules and other items.",Base_Mineral.png,abundant,2413,0,0,2413,0
916,7698,7016,109,Titanium,"Titanium is refined and crafted into components, modules and other items.",Titanium.png,common,4356,436,0,3920,436
918,20644,918,126,Bruma Particles,"Bruma Particles are refined and crafted into components, modules and other items.",Bruma_Particle.png,rare,784,0,0,784,0
918,20645,918,106,Elastomers,"Elastomers are refined and crafted into components, modules and other items.",Elastomers.png,abundant,2396,0,0,2396,0
931,1895,931,115,Nanofluids,"Nanofluids are refined and crafted into components, modules and other items.",Nanofluids.png,common,2795,0,0,2795,0
931,1906,931,126,Bruma Particles,"Bruma Particles are refined and crafted into components, modules and other items.",Bruma_Particle.png,rare,894,0,0,894,0
931,1939,931,115,Nanofluids,"Nanofluids are refined and crafted into components, modules and other items.",Nanofluids.png,common,4985,0,0,4985,0
931,4047,7031,117,Yprasium,"Yprasium is refined and crafted into components, modules and other items.",Yprasium.png,uncommon,1369,0,0,1369,0
931,4048,7031,121,Hypoatomic Substances,"Hypoatomic Substances are refined and crafted into components, modules and other items.",Hypoatomic_Substances.png,uncommon,2269,0,0,2269,0
931,4049,7031,115,Nanofluids,"Nanofluids are refined and crafted into components, modules and other items.",Nanofluids.png,common,4313,0,0,4313,0
934,12046,934,107,H2O,"H2O is refined and crafted into components, modules and other items.",H20.png,abundant,5417,0,0,5417,0
934,12047,934,107,H2O,"H2O is refined and crafted into components, modules and other items.",H20.png,abundant,5775,0,0,5775,0
936,15315,936,42,Base Minerals,"Base Minerals are refined and crafted into components, modules and other items.",Base_Mineral.png,abundant,5317,0,0,5317,0
936,15359,936,120,Metamagnetic Ore,"Metamagnetic Ore is refined and crafted into components, modules and other items.",Metamagnetic_Ore.png,uncommon,2773,0,0,2773,0
936,15544,936,120,Metamagnetic Ore,"Metamagnetic Ore is refined and crafted into components, modules and other items.",Metamagnetic_Ore.png,uncommon,1110,0,0,1110,0
936,15545,936,53,Ignis Ore,"Ignis Ore is refined and crafted into components, modules and other items.",Ignis_Ore.png,rare,614,0,0,614,0
936,16217,7036,53,Ignis Ore,"Ignis Ore is refined and crafted into components, modules and other items.",Ignis_Ore.png,rare,1302,0,0,1302,0
936,16435,7036,109,Titanium,"Titanium is refined and crafted into components, modules and other items.",Titanium.png,common,1392,0,0,1392,0
936,16501,7036,109,Titanium,"Titanium is refined and crafted into components, modules and other items.",Titanium.png,common,4850,0,0,4850,0
942,20646,942,115,Nanofluids,"Nanofluids are refined and crafted into components, modules and other items.",Nanofluids.png,common,1253,0,0,1253,0
943,20858,943,114,Ectopolymers,"Ectopolymers are refined and crafted into components, modules and other items.",Ectopolymers.png,common,1365,0,0,1365,0
943,20859,943,121,Hypoatomic Substances,"Hypoatomic Substances are refined and crafted into components, modules and other items.",Hypoatomic_Substances.png,uncommon,1458,0,0,1458,0
945,2469,945,52,Organic Compounds,"Organic Compounds are refined and crafted into components, modules and other items.",Organic_Compound.png,common,2827,0,0,2827,0
945,2471,945,115,Nanofluids,"Nanofluids are refined and crafted into components, modules and other items.",Nanofluids.png,common,1280,0,0,1280,0
945,2472,945,106,Elastomers,"Elastomers are refined and crafted into components, modules and other items.",Elastomers.png,abundant,5783,0,0,5783,0
946,2239,946,113,Aerogens,"Aerogens are refined and crafted into components, modules and other items.",Aerogens.png,common,1009,0,0,1009,0
946,2240,946,105,Silicates,"Silicates are refined and crafted into components, modules and other items.",Silicates.png,abundant,5881,0,0,5881,0
953,2473,953,128,Tchaikovium,"Tchaikovium is refined and crafted into components, modules and other items.",Tchaikovium.png,rare,738,0,0,738,0
953,2474,953,42,Base Minerals,"Base Minerals are refined and crafted into components, modules and other items.",Base_Mineral.png,abundant,2365,0,0,2365,0
953,2686,953,107,H2O,"H2O is refined and crafted into components, modules and other items.",H20.png,abundant,4461,0,0,4461,0
955,764,955,42,Base Minerals,"Base Minerals are refined and crafted into components, modules and other items.",Base_Mineral.png,abundant,4842,0,0,4842,0
955,765,955,112,Amphoteric Substances,"Amphoteric Substances are refined and crafted into components, modules and other items.",Amphoteric_Substances.png,common,5392,0,0,5392,0
955,1180,955,109,Titanium,"Titanium is refined and crafted into components, modules and other items.",Titanium.png,common,1107,0,0,1107,0
955,1209,955,112,Amphoteric Substances,"Amphoteric Substances are refined and crafted into components, modules and other items.",Amphoteric_Substances.png,common,2639,0,0,2639,0
955,1166,7055,105,Silicates,"Silicates are refined and crafted into components, modules and other items.",Silicates.png,abundant,5060,0,0,5060,0
955,3375,7055,105,Silicates,"Silicates are refined and crafted into components, modules and other items.",Silicates.png,abundant,2591,0,0,2591,0
955,3891,7055,53,Ignis Ore,"Ignis Ore is refined and crafted into components, modules and other items.",Ignis_Ore.png,rare,836,0,0,836,0
957,262,957,123,Neolysium,"Neolysium is refined and crafted into components, modules and other items.",Neolysium.png,uncommon,1493,0,0,1493,0
957,263,957,105,Silicates,"Silicates are refined and crafted into components, modules and other items.",Silicates.png,abundant,2213,0,0,2213,0
957,264,957,40,Polymetals,"Polymetals are refined and crafted into components, modules and other items.",Polymetals.png,common,4602,0,0,4602,0
976,20734,976,42,Base Minerals,"Base Minerals are refined and crafted into components, modules and other items.",Base_Mineral.png,abundant,5234,0,0,5234,0
976,20738,976,42,Base Minerals,"Base Minerals are refined and crafted into components, modules and other items.",Base_Mineral.png,abundant,2118,0,0,2118,0
976,20804,976,52,Organic Compounds,"Organic Compounds are refined and crafted into components, modules and other items.",Organic_Compound.png,common,1332,0,0,1332,0
977,3374,977,106,Elastomers,"Elastomers are refined and crafted into components, modules and other items.",Elastomers.png,abundant,5923,0,0,5923,0
977,18746,977,40,Polymetals,"Polymetals are refined and crafted into components, modules and other items.",Polymetals.png,common,2535,0,0,2535,0
977,18747,977,113,Aerogens,"Aerogens are refined and crafted into components, modules and other items.",Aerogens.png,common,2116,0,0,2116,0
977,19571,977,112,Amphoteric Substances,"Amphoteric Substances are refined and crafted into components, modules and other items.",Amphoteric_Substances.png,common,1304,0,0,1304,0
980,18748,980,52,Organic Compounds,"Organic Compounds are refined and crafted into components, modules and other items.",Organic_Compound.png,common,1146,0,0,1146,0
996,2241,996,119,Novis Compounds,"Novis Compounds are refined and crafted into components, modules and other items.",Novis_Compound.png,uncommon,1388,0,0,1388,0
996,2242,996,107,H2O,"H2O is refined and crafted into components, modules and other items.",H20.png,abundant,5225,0,0,5225,0
1005,96,1005,40,Polymetals,"Polymetals are refined and crafted into components, modules and other items.",Polymetals.png,common,2049,0,0,2049,0
1005,242,1005,40,Polymetals,"Polymetals are refined and crafted into components, modules and other items.",Polymetals.png,common,4818,0,0,4818,0
1005,324,1005,127,Microorganisms,"Microorganisms are refined and crafted into components, modules and other items.",Microorganism.png,rare,887,0,0,887,0
1005,4581,7105,107,H2O,"H2O is refined and crafted into components, modules and other items.",H20.png,abundant,5669,0,0,5669,0
1015,73,1015,53,Ignis Ore,"Ignis Ore is refined and crafted into components, modules and other items.",Ignis_Ore.png,rare,693,693,0,0,693
1015,121,1015,52,Organic Compounds,"Organic Compounds are refined and crafted into components, modules and other items.",Organic_Compound.png,common,2538,0,0,2538,0
1015,346,1015,105,Silicates,"Silicates are refined and crafted into components, modules and other items.",Silicates.png,abundant,4603,4603,0,0,4603
1015,1915,7115,120,Metamagnetic Ore,"Metamagnetic Ore is refined and crafted into components, modules and other items.",Metamagnetic_Ore.png,uncommon,1357,0,0,1357,0
1015,2154,7115,123,Neolysium,"Neolysium is refined and crafted into components, modules and other items.",Neolysium.png,uncommon,2079,0,0,2079,0
1015,2416,7115,106,Elastomers,"Elastomers are refined and crafted into components, modules and other items.",Elastomers.png,abundant,5121,5121,0,0,5121
1025,2243,1025,119,Novis Compounds,"Novis Compounds are refined and crafted into components, modules and other items.",Novis_Compound.png,uncommon,1007,0,0,1007,0
1025,2244,1025,106,Elastomers,"Elastomers are refined and crafted into components, modules and other items.",Elastomers.png,abundant,5881,0,0,5881,0
1036,7699,1036,126,Bruma Particles,"Bruma Particles are refined and crafted into components, modules and other items.",Bruma_Particle.png,rare,645,0,0,645,0
1036,7700,1036,54,Hyperspecular Crystals,"Hyperspecular Crystals are refined and crafted into components, modules and other items.",Hyperspecular_Crystals.png,uncommon,2375,297,0,2078,297
1036,7701,1036,107,H2O,"H2O is refined and crafted into components, modules and other items.",H20.png,abundant,4128,413,0,3715,413
1036,7702,7136,54,Hyperspecular Crystals,"Hyperspecular Crystals are refined and crafted into components, modules and other items.",Hyperspecular_Crystals.png,uncommon,1319,264,0,1055,264
1036,7703,7136,107,H2O,"H2O is refined and crafted into components, modules and other items.",H20.png,abundant,2845,356,0,2489,356
1036,7704,7136,42,Base Minerals,"Base Minerals are refined and crafted into components, modules and other items.",Base_Mineral.png,abundant,5023,0,0,5023,0
1036,7705,7136,107,H2O,"H2O is refined and crafted into components, modules and other items.",H20.png,abundant,4137,414,0,3723,414
1052,10528,1052,110,Plutonium,"Plutonium is refined and crafted into components, modules and other items.",Plutonium.png,common,2792,0,0,2792,0
1052,10529,1052,113,Aerogens,"Aerogens are refined and crafted into components, modules and other items.",Aerogens.png,common,2789,0,0,2789,0
1052,10530,1052,106,Elastomers,"Elastomers are refined and crafted into components, modules and other items.",Elastomers.png,abundant,5700,0,0,5700,0
1052,14026,1052,128,Tchaikovium,"Tchaikovium is refined and crafted into components, modules and other items.",Tchaikovium.png,rare,611,0,0,611,0
1058,997,1058,40,Polymetals,"Polymetals are refined and crafted into components, modules and other items.",Polymetals.png,common,1232,741,0,491,741
1058,998,1058,127,Microorganisms,"Microorganisms are refined and crafted into components, modules and other items.",Microorganism.png,rare,770,154,0,616,154
1058,1046,1058,40,Polymetals,"Polymetals are refined and crafted into components, modules and other items.",Polymetals.png,common,2294,0,0,2294,0
1058,1070,1058,106,Elastomers,"Elastomers are refined and crafted into components, modules and other items.",Elastomers.png,abundant,5001,0,0,5001,0
1058,4481,7158,112,Amphoteric Substances,"Amphoteric Substances are refined and crafted into components, modules and other items.",Amphoteric_Substances.png,common,1049,0,0,1049,0
1058,4497,7158,106,Elastomers,"Elastomers are refined and crafted into components, modules and other items.",Elastomers.png,abundant,2845,0,0,2845,0
1058,4506,7158,40,Polymetals,"Polymetals are refined and crafted into components, modules and other items.",Polymetals.png,common,5824,0,0,5824,0
1063,2245,1063,115,Nanofluids,"Nanofluids are refined and crafted into components, modules and other items.",Nanofluids.png,common,1263,0,0,1263,0
1063,2246,1063,118,Platinyx,"Platinyx is refined and crafted into components, modules and other items.",Platinyx.png,uncommon,1493,0,0,1493,0
1063,2247,1063,105,Silicates,"Silicates are refined and crafted into components, modules and other items.",Silicates.png,abundant,5655,0,0,5655,0
1095,1832,1095,107,H2O,"H2O is refined and crafted into components, modules and other items.",H20.png,abundant,2858,0,0,2858,0
1095,1833,1095,52,Organic Compounds,"Organic Compounds are refined and crafted into components, modules and other items.",Organic_Compound.png,common,4422,0,0,4422,0
1095,14621,1095,127,Microorganisms,"Microorganisms are refined and crafted into components, modules and other items.",Microorganism.png,rare,607,0,0,607,0
1100,4620,1100,40,Polymetals,"Polymetals are refined and crafted into components, modules and other items.",Polymetals.png,common,1199,0,0,1199,0
1100,4621,1100,110,Plutonium,"Plutonium is refined and crafted into components, modules and other items.",Plutonium.png,common,1171,235,0,936,235
1100,4622,1100,40,Polymetals,"Polymetals are refined and crafted into components, modules and other items.",Polymetals.png,common,2811,0,0,2811,0
1100,4623,1100,106,Elastomers,"Elastomers are refined and crafted into components, modules and other items.",Elastomers.png,abundant,2888,0,0,2888,0
1100,4624,1100,115,Nanofluids,"Nanofluids are refined and crafted into components, modules and other items.",Nanofluids.png,common,4273,856,0,3417,856
1100,4625,1100,106,Elastomers,"Elastomers are refined and crafted into components, modules and other items.",Elastomers.png,abundant,5333,0,0,5333,0
1100,4626,7200,127,Microorganisms,"Microorganisms are refined and crafted into components, modules and other items.",Microorganism.png,rare,693,693,0,0,693
1100,4627,7200,127,Microorganisms,"Microorganisms are refined and crafted into components, modules and other items.",Microorganism.png,rare,663,133,0,530,133
1100,4628,7200,112,Amphoteric Substances,"Amphoteric Substances are refined and crafted into components, modules and other items.",Amphoteric_Substances.png,common,2993,375,0,2618,375
1100,4629,7200,117,Yprasium,"Yprasium is refined and crafted into components, modules and other items.",Yprasium.png,uncommon,2753,345,0,2408,345
1100,4630,7200,106,Elastomers,"Elastomers are refined and crafted into components, modules and other items.",Elastomers.png,abundant,4476,448,0,4028,448
1100,4631,7200,106,Elastomers,"Elastomers are refined and crafted into components, modules and other items.",Elastomers.png,abundant,4431,0,0,4431,0
1101,1401,1101,53,Ignis Ore,"Ignis Ore is refined and crafted into components, modules and other items.",Ignis_Ore.png,rare,827,0,0,827,0
1101,1402,1101,118,Platinyx,"Platinyx is refined and crafted into components, modules and other items.",Platinyx.png,uncommon,2672,0,0,2672,0
1101,1403,1101,42,Base Minerals,"Base Minerals are refined and crafted into components, modules and other items.",Base_Mineral.png,abundant,5107,0,0,5107,0
1101,1404,7201,54,Hyperspecular Crystals,"Hyperspecular Crystals are refined and crafted into components, modules and other items.",Hyperspecular_Crystals.png,uncommon,1445,0,0,1445,0
1101,1405,7201,52,Organic Compounds,"Organic Compounds are refined and crafted into components, modules and other items.",Organic_Compound.png,common,2516,0,0,2516,0
1101,1406,7201,42,Base Minerals,"Base Minerals are refined and crafted into components, modules and other items.",Base_Mineral.png,abundant,4574,0,0,4574,0
1108,9043,1108,114,Ectopolymers,"Ectopolymers are refined and crafted into components, modules and other items.",Ectopolymers.png,common,1422,0,0,1422,0
1108,9044,1108,119,Novis Compounds,"Novis Compounds are refined and crafted into components, modules and other items.",Novis_Compound.png,uncommon,2695,0,0,2695,0
1108,9045,1108,110,Plutonium,"Plutonium is refined and crafted into components, modules and other items.",Plutonium.png,common,5752,0,0,5752,0
1109,2363,1109,106,Elastomers,"Elastomers are refined and crafted into components, modules and other items.",Elastomers.png,abundant,2279,0,0,2279,0
1109,4757,1109,127,Microorganisms,"Microorganisms are refined and crafted into components, modules and other items.",Microorganism.png,rare,796,0,0,796,0
1109,20699,7209,127,Microorganisms,"Microorganisms are refined and crafted into components, modules and other items.",Microorganism.png,rare,697,0,0,697,0
1118,1914,1118,119,Novis Compounds,"Novis Compounds are refined and crafted into components, modules and other items.",Novis_Compound.png,uncommon,1429,0,0,1429,0
1118,1940,1118,112,Amphoteric Substances,"Amphoteric Substances are refined and crafted into components, modules and other items.",Amphoteric_Substances.png,common,5503,0,0,5503,0
1118,1941,1118,107,H2O,"H2O is refined and crafted into components, modules and other items.",H20.png,abundant,4133,0,0,4133,0
1118,2033,1118,42,Base Minerals,"Base Minerals are refined and crafted into components, modules and other items.",Base_Mineral.png,abundant,2329,0,0,2329,0
1118,4050,7218,115,Nanofluids,"Nanofluids are refined and crafted into components, modules and other items.",Nanofluids.png,common,1396,0,0,1396,0
1118,4051,7218,106,Elastomers,"Elastomers are refined and crafted into components, modules and other items.",Elastomers.png,abundant,2950,0,0,2950,0
1118,4052,7218,107,H2O,"H2O is refined and crafted into components, modules and other items.",H20.png,abundant,4494,0,0,4494,0
1122,7031,1122,40,Polymetals,"Polymetals are refined and crafted into components, modules and other items.",Polymetals.png,common,1066,0,0,1066,0
1122,7032,1122,128,Tchaikovium,"Tchaikovium is refined and crafted into components, modules and other items.",Tchaikovium.png,rare,828,0,0,828,0
1122,7162,1122,112,Amphoteric Substances,"Amphoteric Substances are refined and crafted into components, modules and other items.",Amphoteric_Substances.png,common,2915,0,0,2915,0
1122,8053,1122,106,Elastomers,"Elastomers are refined and crafted into components, modules and other items.",Elastomers.png,abundant,5544,0,0,5544,0
1122,8263,7222,113,Aerogens,"Aerogens are refined and crafted into components, modules and other items.",Aerogens.png,common,1169,0,0,1169,0
1145,325,1145,42,Base Minerals,"Base Minerals are refined and crafted into components, modules and other items.",Base_Mineral.png,abundant,2632,0,0,2632,0
1145,9046,1145,109,Titanium,"Titanium is refined and crafted into components, modules and other items.",Titanium.png,common,1057,0,0,1057,0
1145,9047,1145,106,Elastomers,"Elastomers are refined and crafted into components, modules and other items.",Elastomers.png,abundant,4767,0,0,4767,0
1145,9048,1145,42,Base Minerals,"Base Minerals are refined and crafted into components, modules and other items.",Base_Mineral.png,abundant,5100,0,0,5100,0
1165,1567,1165,119,Novis Compounds,"Novis Compounds are refined and crafted into components, modules and other items.",Novis_Compound.png,uncommon,1370,0,0,1370,0
1165,1568,1165,106,Elastomers,"Elastomers are refined and crafted into components, modules and other items.",Elastomers.png,abundant,2767,0,0,2767,0
1165,1569,1165,106,Elastomers,"Elastomers are refined and crafted into components, modules and other items.",Elastomers.png,abundant,4489,0,0,4489,0
1165,1570,7265,127,Microorganisms,"Microorganisms are refined and crafted into components, modules and other items.",Microorganism.png,rare,766,0,0,766,0
1165,1571,7265,106,Elastomers,"Elastomers are refined and crafted into components, modules and other items.",Elastomers.png,abundant,4877,0,0,4877,0
1165,1572,7265,107,H2O,"H2O is refined and crafted into components, modules and other items.",H20.png,abundant,5148,0,0,5148,0
1165,1614,7265,40,Polymetals,"Polymetals are refined and crafted into components, modules and other items.",Polymetals.png,common,2424,0,0,2424,0
1166,10369,1166,121,Hypoatomic Substances,"Hypoatomic Substances are refined and crafted into components, modules and other items.",Hypoatomic_Substances.png,uncommon,1457,0,0,1457,0
1172,10,1172,127,Microorganisms,"Microorganisms are refined and crafted into components, modules and other items.",Microorganism.png,rare,681,0,0,681,0
1172,14,1172,119,Novis Compounds,"Novis Compounds are refined and crafted into components, modules and other items.",Novis_Compound.png,uncommon,2191,0,0,2191,0
1172,28,1172,106,Elastomers,"Elastomers are refined and crafted into components, modules and other items.",Elastomers.png,abundant,4782,0,0,4782,0
1172,697,7272,110,Plutonium,"Plutonium is refined and crafted into components, modules and other items.",Plutonium.png,common,2837,1420,0,1417,1420
1172,1244,7272,127,Microorganisms,"Microorganisms are refined and crafted into components, modules and other items.",Microorganism.png,rare,621,0,0,621,0
1172,1245,7272,127,Microorganisms,"Microorganisms are refined and crafted into components, modules and other items.",Microorganism.png,rare,671,0,0,671,0
1172,4275,7272,42,Base Minerals,"Base Minerals are refined and crafted into components, modules and other items.",Base_Mineral.png,abundant,5162,0,0,5162,0
1183,145,1183,105,Silicates,"Silicates are refined and crafted into components, modules and other items.",Silicates.png,abundant,5186,0,0,5186,0
1183,146,1183,118,Platinyx,"Platinyx is refined and crafted into components, modules and other items.",Platinyx.png,uncommon,5370,0,0,5370,0
1183,150,1183,123,Neolysium,"Neolysium is refined and crafted into components, modules and other items.",Neolysium.png,uncommon,2478,0,0,2478,0
1183,268,1183,123,Neolysium,"Neolysium is refined and crafted into components, modules and other items.",Neolysium.png,uncommon,1111,0,0,1111,0
1183,4636,7283,123,Neolysium,"Neolysium is refined and crafted into components, modules and other items.",Neolysium.png,uncommon,2222,0,0,2222,0
1183,4890,7283,53,Ignis Ore,"Ignis Ore is refined and crafted into components, modules and other items.",Ignis_Ore.png,rare,730,0,0,730,0
1183,4891,7283,105,Silicates,"Silicates are refined and crafted into components, modules and other items.",Silicates.png,abundant,5510,0,0,5510,0
1187,1441,1187,114,Ectopolymers,"Ectopolymers are refined and crafted into components, modules and other items.",Ectopolymers.png,common,1422,0,0,1422,0
1187,1442,1187,42,Base Minerals,"Base Minerals are refined and crafted into components, modules and other items.",Base_Mineral.png,abundant,2854,0,0,2854,0
1187,1443,1187,114,Ectopolymers,"Ectopolymers are refined and crafted into components, modules and other items.",Ectopolymers.png,common,5228,0,0,5228,0
1187,1444,7287,107,H2O,"H2O is refined and crafted into components, modules and other items.",H20.png,abundant,5574,0,0,5574,0
1198,809,1198,105,Silicates,"Silicates are refined and crafted into components, modules and other items.",Silicates.png,abundant,4294,0,0,4294,0
1198,1284,1198,40,Polymetals,"Polymetals are refined and crafted into components, modules and other items.",Polymetals.png,common,2925,0,0,2925,0
1198,3078,1198,128,Tchaikovium,"Tchaikovium is refined and crafted into components, modules and other items.",Tchaikovium.png,rare,680,0,0,680,0
1198,1285,7298,42,Base Minerals,"Base Minerals are refined and crafted into components, modules and other items.",Base_Mineral.png,abundant,4682,0,0,4682,0
1198,4786,7298,128,Tchaikovium,"Tchaikovium is refined and crafted into components, modules and other items.",Tchaikovium.png,rare,693,0,0,693,0
1198,4803,7298,40,Polymetals,"Polymetals are refined and crafted into components, modules and other items.",Polymetals.png,common,2734,0,0,2734,0
1210,822,1210,109,Titanium,"Titanium is refined and crafted into components, modules and other items.",Titanium.png,common,4112,0,0,4112,0
1210,3120,1210,53,Ignis Ore,"Ignis Ore is refined and crafted into components, modules and other items.",Ignis_Ore.png,rare,1344,0,0,1344,0
1210,3154,1210,112,Amphoteric Substances,"Amphoteric Substances are refined and crafted into components, modules and other items.",Amphoteric_Substances.png,common,1393,0,0,1393,0
1210,3155,7310,42,Base Minerals,"Base Minerals are refined and crafted into components, modules and other items.",Base_Mineral.png,abundant,5172,0,0,5172,0
1210,4818,7310,109,Titanium,"Titanium is refined and crafted into components, modules and other items.",Titanium.png,common,2596,0,0,2596,0
1210,9818,7310,123,Neolysium,"Neolysium is refined and crafted into components, modules and other items.",Neolysium.png,uncommon,1046,0,0,1046,0
1216,460,1216,52,Organic Compounds,"Organic Compounds are refined and crafted into components, modules and other items.",Organic_Compound.png,common,1472,0,0,1472,0
1216,461,1216,118,Platinyx,"Platinyx is refined and crafted into components, modules and other items.",Platinyx.png,uncommon,2393,0,0,2393,0
1216,462,1216,107,H2O,"H2O is refined and crafted into components, modules and other items.",H20.png,abundant,5215,0,0,5215,0
1219,457,1219,128,Tchaikovium,"Tchaikovium is refined and crafted into components, modules and other items.",Tchaikovium.png,rare,732,0,0,732,0
1219,458,1219,118,Platinyx,"Platinyx is refined and crafted into components, modules and other items.",Platinyx.png,uncommon,2530,0,0,2530,0
1219,459,1219,40,Polymetals,"Polymetals are refined and crafted into components, modules and other items.",Polymetals.png,common,4909,2946,0,1963,2946
1220,2152,1220,126,Bruma Particles,"Bruma Particles are refined and crafted into components, modules and other items.",Bruma_Particle.png,rare,728,0,0,728,0
1220,2566,1220,42,Base Minerals,"Base Minerals are refined and crafted into components, modules and other items.",Base_Mineral.png,abundant,2284,0,0,2284,0
1220,2567,1220,105,Silicates,"Silicates are refined and crafted into components, modules and other items.",Silicates.png,abundant,4686,0,0,4686,0
1232,17941,1232,126,Bruma Particles,"Bruma Particles are refined and crafted into components, modules and other items.",Bruma_Particle.png,rare,821,0,0,821,0
1232,17942,1232,113,Aerogens,"Aerogens are refined and crafted into components, modules and other items.",Aerogens.png,common,2502,0,0,2502,0
1232,17943,1232,113,Aerogens,"Aerogens are refined and crafted into components, modules and other items.",Aerogens.png,common,5463,0,0,5463,0
1232,17944,7332,126,Bruma Particles,"Bruma Particles are refined and crafted into components, modules and other items.",Bruma_Particle.png,rare,694,0,0,694,0
1232,17945,7332,126,Bruma Particles,"Bruma Particles are refined and crafted into components, modules and other items.",Bruma_Particle.png,rare,667,0,0,667,0
1232,17946,7332,53,Ignis Ore,"Ignis Ore is refined and crafted into components, modules and other items.",Ignis_Ore.png,rare,1867,0,0,1867,0
1232,17947,7332,105,Silicates,"Silicates are refined and crafted into components, modules and other items.",Silicates.png,abundant,4475,0,0,4475,0
1254,3368,1254,126,Bruma Particles,"Bruma Particles are refined and crafted into components, modules and other items.",Bruma_Particle.png,rare,864,0,0,864,0
1254,3369,1254,123,Neolysium,"Neolysium is refined and crafted into components, modules and other items.",Neolysium.png,uncommon,1421,0,0,1421,0
1254,3370,1254,109,Titanium,"Titanium is refined and crafted into components, modules and other items.",Titanium.png,common,2788,0,0,2788,0
1254,3371,1254,42,Base Minerals,"Base Minerals are refined and crafted into components, modules and other items.",Base_Mineral.png,abundant,5136,0,0,5136,0
1258,67,1258,112,Amphoteric Substances,"Amphoteric Substances are refined and crafted into components, modules and other items.",Amphoteric_Substances.png,common,2697,0,0,2697,0
1258,248,1258,110,Plutonium,"Plutonium is refined and crafted into components, modules and other items.",Plutonium.png,common,5377,0,0,5377,0
1258,4516,1258,113,Aerogens,"Aerogens are refined and crafted into components, modules and other items.",Aerogens.png,common,1262,0,0,1262,0
1262,2263,1262,117,Yprasium,"Yprasium is refined and crafted into components, modules and other items.",Yprasium.png,uncommon,2320,0,0,2320,0
1262,2536,1262,113,Aerogens,"Aerogens are refined and crafted into components, modules and other items.",Aerogens.png,common,4754,0,0,4754,0
1262,4306,1262,113,Aerogens,"Aerogens are refined and crafted into components, modules and other items.",Aerogens.png,common,1433,0,0,1433,0
1262,7494,7362,105,Silicates,"Silicates are refined and crafted into components, modules and other items.",Silicates.png,abundant,2645,0,0,2645,0
1262,18613,7362,106,Elastomers,"Elastomers are refined and crafted into components, modules and other items.",Elastomers.png,abundant,5115,0,0,5115,0
1274,736,1274,114,Ectopolymers,"Ectopolymers are refined and crafted into components, modules and other items.",Ectopolymers.png,common,5184,0,0,5184,0
1274,1530,1274,106,Elastomers,"Elastomers are refined and crafted into components, modules and other items.",Elastomers.png,abundant,2671,0,0,2671,0
1274,7691,1274,119,Novis Compounds,"Novis Compounds are refined and crafted into components, modules and other items.",Novis_Compound.png,uncommon,1326,0,0,1326,0
1274,7692,1274,121,Hypoatomic Substances,"Hypoatomic Substances are refined and crafted into components, modules and other items.",Hypoatomic_Substances.png,uncommon,1399,0,0,1399,0
1274,6898,7374,42,Base Minerals,"Base Minerals are refined and crafted into components, modules and other items.",Base_Mineral.png,abundant,2129,0,0,2129,0
1274,6899,7374,105,Silicates,"Silicates are refined and crafted into components, modules and other items.",Silicates.png,abundant,2376,0,0,2376,0
1274,7693,7374,114,Ectopolymers,"Ectopolymers are refined and crafted into components, modules and other items.",Ectopolymers.png,common,1458,0,0,1458,0
1274,7801,7374,106,Elastomers,"Elastomers are refined and crafted into components, modules and other items.",Elastomers.png,abundant,4092,0,0,4092,0
1278,1,1278,40,Polymetals,"Polymetals are refined and crafted into components, modules and other items.",Polymetals.png,common,1158,232,0,926,232
1278,2,1278,53,Ignis Ore,"Ignis Ore is refined and crafted into components, modules and other items.",Ignis_Ore.png,rare,676,0,0,676,0
1281,60,1281,105,Silicates,"Silicates are refined and crafted into components, modules and other items.",Silicates.png,abundant,4884,0,0,4884,0
1285,1049,1285,112,Amphoteric Substances,"Amphoteric Substances are refined and crafted into components, modules and other items.",Amphoteric_Substances.png,common,2562,963,0,1599,963
1285,1050,1285,106,Elastomers,"Elastomers are refined and crafted into components, modules and other items.",Elastomers.png,abundant,2001,0,0,2001,0
1285,3442,1285,105,Silicates,"Silicates are refined and crafted into components, modules and other items.",Silicates.png,abundant,5880,1176,0,4704,1176
1285,3520,1285,127,Microorganisms,"Microorganisms are refined and crafted into components, modules and other items.",Microorganism.png,rare,749,0,0,749,0
1294,3,1294,118,Platinyx,"Platinyx is refined and crafted into components, modules and other items.",Platinyx.png,uncommon,2768,346,0,2422,346
1294,4,1294,53,Ignis Ore,"Ignis Ore is refined and crafted into components, modules and other items.",Ignis_Ore.png,rare,878,0,0,878,0
1309,11089,1305,128,Tchaikovium,"Tchaikovium is refined and crafted into components, modules and other items.",Tchaikovium.png,rare,650,0,0,650,0
1309,11122,1305,107,H2O,"H2O is refined and crafted into components, modules and other items.",H20.png,abundant,2475,0,0,2475,0
1309,11255,1305,107,H2O,"H2O is refined and crafted into components, modules and other items.",H20.png,abundant,5707,0,0,5707,0
1313,10330,1309,41,Xensium,"Xensium is refined and crafted into components, modules and other items.",Xensium.png,uncommon,1317,0,0,1317,0
1313,19570,1309,109,Titanium,"Titanium is refined and crafted into components, modules and other items.",Titanium.png,common,4678,0,0,4678,0
1314,72,1310,110,Plutonium,"Plutonium is refined and crafted into components, modules and other items.",Plutonium.png,common,2321,0,0,2321,0
1314,127,1310,42,Base Minerals,"Base Minerals are refined and crafted into components, modules and other items.",Base_Mineral.png,abundant,4950,0,0,4950,0
1314,3482,1310,128,Tchaikovium,"Tchaikovium is refined and crafted into components, modules and other items.",Tchaikovium.png,rare,806,0,0,806,0
1314,3483,1310,110,Plutonium,"Plutonium is refined and crafted into components, modules and other items.",Plutonium.png,common,1087,0,0,1087,0
1314,3484,7410,126,Bruma Particles,"Bruma Particles are refined and crafted into components, modules and other items.",Bruma_Particle.png,rare,1753,0,0,1753,0
1314,3485,7410,42,Base Minerals,"Base Minerals are refined and crafted into components, modules and other items.",Base_Mineral.png,abundant,2406,0,0,2406,0
1314,3486,7410,106,Elastomers,"Elastomers are refined and crafted into components, modules and other items.",Elastomers.png,abundant,4067,0,0,4067,0
1314,3487,7410,105,Silicates,"Silicates are refined and crafted into components, modules and other items.",Silicates.png,abundant,5438,0,0,5438,0
1314,6271,7410,120,Metamagnetic Ore,"Metamagnetic Ore is refined and crafted into components, modules and other items.",Metamagnetic_Ore.png,uncommon,1026,0,0,1026,0
1318,1321,1313,118,Platinyx,"Platinyx is refined and crafted into components, modules and other items.",Platinyx.png,uncommon,1407,0,0,1407,0
1318,1400,1313,118,Platinyx,"Platinyx is refined and crafted into components, modules and other items.",Platinyx.png,uncommon,2591,0,0,2591,0
1318,1505,1313,42,Base Minerals,"Base Minerals are refined and crafted into components, modules and other items.",Base_Mineral.png,abundant,4129,0,0,4129,0
1318,5776,7413,128,Tchaikovium,"Tchaikovium is refined and crafted into components, modules and other items.",Tchaikovium.png,rare,742,0,0,742,0
1318,5875,7413,106,Elastomers,"Elastomers are refined and crafted into components, modules and other items.",Elastomers.png,abundant,2020,0,0,2020,0
1318,6073,7413,105,Silicates,"Silicates are refined and crafted into components, modules and other items.",Silicates.png,abundant,4576,0,0,4576,0
1323,953,1316,109,Titanium,"Titanium is refined and crafted into components, modules and other items.",Titanium.png,common,2312,0,0,2312,0
1323,971,1316,119,Novis Compounds,"Novis Compounds are refined and crafted into components, modules and other items.",Novis_Compound.png,uncommon,4532,0,0,4532,0
1323,1134,1316,118,Platinyx,"Platinyx is refined and crafted into components, modules and other items.",Platinyx.png,uncommon,1189,0,0,1189,0
1323,18019,7416,110,Plutonium,"Plutonium is refined and crafted into components, modules and other items.",Plutonium.png,common,1181,0,0,1181,0
1323,18020,7416,54,Hyperspecular Crystals,"Hyperspecular Crystals are refined and crafted into components, modules and other items.",Hyperspecular_Crystals.png,uncommon,2126,0,0,2126,0
1323,18021,7416,106,Elastomers,"Elastomers are refined and crafted into components, modules and other items.",Elastomers.png,abundant,5686,0,0,5686,0
1326,13762,1319,105,Silicates,"Silicates are refined and crafted into components, modules and other items.",Silicates.png,abundant,5606,0,0,5606,0
1326,13763,1319,42,Base Minerals,"Base Minerals are refined and crafted into components, modules and other items.",Base_Mineral.png,abundant,5951,5951,0,0,5951
1326,13764,1319,53,Ignis Ore,"Ignis Ore is refined and crafted into components, modules and other items.",Ignis_Ore.png,rare,820,492,0,328,492
1326,13765,1319,107,H2O,"H2O is refined and crafted into components, modules and other items.",H20.png,abundant,2323,2323,0,0,2323
1326,13766,7419,106,Elastomers,"Elastomers are refined and crafted into components, modules and other items.",Elastomers.png,abundant,4333,0,0,4333,0
1326,13767,7419,105,Silicates,"Silicates are refined and crafted into components, modules and other items.",Silicates.png,abundant,2389,0,0,2389,0
1326,13768,7419,121,Hypoatomic Substances,"Hypoatomic Substances are refined and crafted into components, modules and other items.",Hypoatomic_Substances.png,uncommon,1460,0,0,1460,0
1326,13769,7419,118,Platinyx,"Platinyx is refined and crafted into components, modules and other items.",Platinyx.png,uncommon,1032,0,0,1032,0
1336,214,1324,107,H2O,"H2O is refined and crafted into components, modules and other items.",H20.png,abundant,5770,4039,0,1731,4039
1336,610,1324,127,Microorganisms,"Microorganisms are refined and crafted into components, modules and other items.",Microorganism.png,rare,876,704,0,172,704
1336,5050,1324,112,Amphoteric Substances,"Amphoteric Substances are refined and crafted into components, modules and other items.",Amphoteric_Substances.png,common,2662,0,0,2662,0
1336,288,7424,42,Base Minerals,"Base Minerals are refined and crafted into components, modules and other items.",Base_Mineral.png,abundant,4353,0,0,4353,0
1336,725,7424,127,Microorganisms,"Microorganisms are refined and crafted into components, modules and other items.",Microorganism.png,rare,724,0,0,724,0
1336,888,7424,119,Novis Compounds,"Novis Compounds are refined and crafted into components, modules and other items.",Novis_Compound.png,uncommon,2000,0,0,2000,0
1351,866,1333,107,H2O,"H2O is refined and crafted into components, modules and other items.",H20.png,abundant,5003,0,0,5003,0
1351,3376,1333,52,Organic Compounds,"Organic Compounds are refined and crafted into components, modules and other items.",Organic_Compound.png,common,1265,0,0,1265,0
1351,3377,1333,117,Yprasium,"Yprasium is refined and crafted into components, modules and other items.",Yprasium.png,uncommon,1255,0,0,1255,0
1351,3890,1333,106,Elastomers,"Elastomers are refined and crafted into components, modules and other items.",Elastomers.png,abundant,2766,0,0,2766,0
1351,3319,7433,106,Elastomers,"Elastomers are refined and crafted into components, modules and other items.",Elastomers.png,abundant,5652,0,0,5652,0
1351,9274,7433,121,Hypoatomic Substances,"Hypoatomic Substances are refined and crafted into components, modules and other items.",Hypoatomic_Substances.png,uncommon,2915,0,0,2915,0
1351,10000,7433,117,Yprasium,"Yprasium is refined and crafted into components, modules and other items.",Yprasium.png,uncommon,1307,0,0,1307,0
1352,611,1334,114,Ectopolymers,"Ectopolymers are refined and crafted into components, modules and other items.",Ectopolymers.png,common,1266,0,0,1266,0
1352,625,1334,119,Novis Compounds,"Novis Compounds are refined and crafted into components, modules and other items.",Novis_Compound.png,uncommon,2331,0,0,2331,0
1352,889,1334,42,Base Minerals,"Base Minerals are refined and crafted into components, modules and other items.",Base_Mineral.png,abundant,4152,0,0,4152,0
1352,18022,7434,114,Ectopolymers,"Ectopolymers are refined and crafted into components, modules and other items.",Ectopolymers.png,common,1424,0,0,1424,0
1352,18023,7434,119,Novis Compounds,"Novis Compounds are refined and crafted into components, modules and other items.",Novis_Compound.png,uncommon,2149,0,0,2149,0
1352,18024,7434,106,Elastomers,"Elastomers are refined and crafted into components, modules and other items.",Elastomers.png,abundant,5346,0,0,5346,0
1356,3430,1338,128,Tchaikovium,"Tchaikovium is refined and crafted into components, modules and other items.",Tchaikovium.png,rare,892,0,0,892,0
1356,3432,1338,40,Polymetals,"Polymetals are refined and crafted into components, modules and other items.",Polymetals.png,common,2360,0,0,2360,0
1356,3433,1338,110,Plutonium,"Plutonium is refined and crafted into components, modules and other items.",Plutonium.png,common,2825,0,0,2825,0
1356,4498,1338,107,H2O,"H2O is refined and crafted into components, modules and other items.",H20.png,abundant,5281,0,0,5281,0
1357,513,1339,128,Tchaikovium,"Tchaikovium is refined and crafted into components, modules and other items.",Tchaikovium.png,rare,785,0,0,785,0
1357,528,1339,120,Metamagnetic Ore,"Metamagnetic Ore is refined and crafted into components, modules and other items.",Metamagnetic_Ore.png,uncommon,2147,0,0,2147,0
1357,993,1339,110,Plutonium,"Plutonium is refined and crafted into components, modules and other items.",Plutonium.png,common,5272,0,0,5272,0
1357,2031,7439,110,Plutonium,"Plutonium is refined and crafted into components, modules and other items.",Plutonium.png,common,2693,0,0,2693,0
1357,8817,7439,128,Tchaikovium,"Tchaikovium is refined and crafted into components, modules and other items.",Tchaikovium.png,rare,646,0,0,646,0
1357,9076,7439,42,Base Minerals,"Base Minerals are refined and crafted into components, modules and other items.",Base_Mineral.png,abundant,4967,2485,0,2482,2485
1357,9077,7439,52,Organic Compounds,"Organic Compounds are refined and crafted into components, modules and other items.",Organic_Compound.png,common,4683,0,0,4683,0
1358,635,1340,42,Base Minerals,"Base Minerals are refined and crafted into components, modules and other items.",Base_Mineral.png,abundant,2595,0,0,2595,0
1360,995,1342,110,Plutonium,"Plutonium is refined and crafted into components, modules and other items.",Plutonium.png,common,2993,0,0,2993,0
1360,1140,1342,53,Ignis Ore,"Ignis Ore is refined and crafted into components, modules and other items.",Ignis_Ore.png,rare,862,0,0,862,0
1360,1141,1342,105,Silicates,"Silicates are refined and crafted into components, modules and other items.",Silicates.png,abundant,5794,0,0,5794,0
1360,996,7442,109,Titanium,"Titanium is refined and crafted into components, modules and other items.",Titanium.png,common,1109,0,0,1109,0
1360,1237,7442,112,Amphoteric Substances,"Amphoteric Substances are refined and crafted into components, modules and other items.",Amphoteric_Substances.png,common,2361,0,0,2361,0
1360,2056,7442,105,Silicates,"Silicates are refined and crafted into components, modules and other items.",Silicates.png,abundant,5698,0,0,5698,0
1361,1445,1343,53,Ignis Ore,"Ignis Ore is refined and crafted into components, modules and other items.",Ignis_Ore.png,rare,623,0,0,623,0
1361,1472,1343,112,Amphoteric Substances,"Amphoteric Substances are refined and crafted into components, modules and other items.",Amphoteric_Substances.png,common,2235,0,0,2235,0
1361,1473,1343,42,Base Minerals,"Base Minerals are refined and crafted into components, modules and other items.",Base_Mineral.png,abundant,5901,0,0,5901,0
1361,1446,7443,42,Base Minerals,"Base Minerals are refined and crafted into components, modules and other items.",Base_Mineral.png,abundant,4482,0,0,4482,0
1363,349,1345,119,Novis Compounds,"Novis Compounds are refined and crafted into components, modules and other items.",Novis_Compound.png,uncommon,1238,0,0,1238,0
1363,350,1345,112,Amphoteric Substances,"Amphoteric Substances are refined and crafted into components, modules and other items.",Amphoteric_Substances.png,common,5045,0,0,5045,0
1363,368,1345,41,Xensium,"Xensium is refined and crafted into components, modules and other items.",Xensium.png,uncommon,2293,0,0,2293,0
1363,376,7445,127,Microorganisms,"Microorganisms are refined and crafted into components, modules and other items.",Microorganism.png,rare,643,0,0,643,0
1378,523,1355,128,Tchaikovium,"Tchaikovium is refined and crafted into components, modules and other items.",Tchaikovium.png,rare,825,0,0,825,0
1378,668,1355,106,Elastomers,"Elastomers are refined and crafted into components, modules and other items.",Elastomers.png,abundant,4932,3952,0,980,3952
1378,3131,1355,41,Xensium,"Xensium is refined and crafted into components, modules and other items.",Xensium.png,uncommon,2588,0,0,2588,0
1378,18272,7455,113,Aerogens,"Aerogens are refined and crafted into components, modules and other items.",Aerogens.png,common,1442,0,0,1442,0
1378,18273,7455,54,Hyperspecular Crystals,"Hyperspecular Crystals are refined and crafted into components, modules and other items.",Hyperspecular_Crystals.png,uncommon,2622,0,0,2622,0
1378,18274,7455,107,H2O,"H2O is refined and crafted into components, modules and other items.",H20.png,abundant,4267,3843,0,424,3843
1379,1447,1356,120,Metamagnetic Ore,"Metamagnetic Ore is refined and crafted into components, modules and other items.",Metamagnetic_Ore.png,uncommon,1380,0,0,1380,0
1379,1474,1356,117,Yprasium,"Yprasium is refined and crafted into components, modules and other items.",Yprasium.png,uncommon,4885,0,0,4885,0
1379,1531,1356,128,Tchaikovium,"Tchaikovium is refined and crafted into components, modules and other items.",Tchaikovium.png,rare,1569,0,0,1569,0
1379,1471,7456,112,Amphoteric Substances,"Amphoteric Substances are refined and crafted into components, modules and other items.",Amphoteric_Substances.png,common,5853,0,0,5853,0
1379,1532,7456,41,Xensium,"Xensium is refined and crafted into components, modules and other items.",Xensium.png,uncommon,1341,0,0,1341,0
1379,1533,7456,112,Amphoteric Substances,"Amphoteric Substances are refined and crafted into components, modules and other items.",Amphoteric_Substances.png,common,2039,0,0,2039,0
1380,741,1357,114,Ectopolymers,"Ectopolymers are refined and crafted into components, modules and other items.",Ectopolymers.png,common,1058,0,0,1058,0
1380,742,1357,54,Hyperspecular Crystals,"Hyperspecular Crystals are refined and crafted into components, modules and other items.",Hyperspecular_Crystals.png,uncommon,1326,0,0,1326,0
1380,743,1357,110,Plutonium,"Plutonium is refined and crafted into components, modules and other items.",Plutonium.png,common,2515,0,0,2515,0
1380,744,1357,110,Plutonium,"Plutonium is refined and crafted into components, modules and other items.",Plutonium.png,common,2102,0,0,2102,0
1380,745,1357,42,Base Minerals,"Base Minerals are refined and crafted into components, modules and other items.",Base_Mineral.png,abundant,4611,0,0,4611,0
1380,746,1357,106,Elastomers,"Elastomers are refined and crafted into components, modules and other items.",Elastomers.png,abundant,4989,0,0,4989,0
1380,747,7457,119,Novis Compounds,"Novis Compounds are refined and crafted into components, modules and other items.",Novis_Compound.png,uncommon,1387,0,0,1387,0
1380,748,7457,128,Tchaikovium,"Tchaikovium is refined and crafted into components, modules and other items.",Tchaikovium.png,rare,739,0,0,739,0
1380,749,7457,119,Novis Compounds,"Novis Compounds are refined and crafted into components, modules and other items.",Novis_Compound.png,uncommon,2770,0,0,2770,0
1380,750,7457,42,Base Minerals,"Base Minerals are refined and crafted into components, modules and other items.",Base_Mineral.png,abundant,2786,0,0,2786,0
1380,751,7457,106,Elastomers,"Elastomers are refined and crafted into components, modules and other items.",Elastomers.png,abundant,4873,0,0,4873,0
1380,752,7457,113,Aerogens,"Aerogens are refined and crafted into components, modules and other items.",Aerogens.png,common,5175,0,0,5175,0
1382,896,1359,105,Silicates,"Silicates are refined and crafted into components, modules and other items.",Silicates.png,abundant,5575,0,0,5575,0
1382,3444,1359,41,Xensium,"Xensium is refined and crafted into components, modules and other items.",Xensium.png,uncommon,1495,0,0,1495,0
1382,3911,1359,109,Titanium,"Titanium is refined and crafted into components, modules and other items.",Titanium.png,common,2324,0,0,2324,0
1382,3445,7459,42,Base Minerals,"Base Minerals are refined and crafted into components, modules and other items.",Base_Mineral.png,abundant,5884,0,0,5884,0
1382,9281,7459,105,Silicates,"Silicates are refined and crafted into components, modules and other items.",Silicates.png,abundant,2030,0,0,2030,0
1382,10066,7459,53,Ignis Ore,"Ignis Ore is refined and crafted into components, modules and other items.",Ignis_Ore.png,rare,855,0,0,855,0
1383,774,1360,123,Neolysium,"Neolysium is refined and crafted into components, modules and other items.",Neolysium.png,uncommon,1021,205,0,816,205
1383,775,1360,42,Base Minerals,"Base Minerals are refined and crafted into components, modules and other items.",Base_Mineral.png,abundant,2172,1632,0,540,1632
1383,2478,1360,107,H2O,"H2O is refined and crafted into components, modules and other items.",H20.png,abundant,5832,0,0,5832,0
1385,3010,1361,107,H2O,"H2O is refined and crafted into components, modules and other items.",H20.png,abundant,5196,0,0,5196,0
1385,3132,1361,113,Aerogens,"Aerogens are refined and crafted into components, modules and other items.",Aerogens.png,common,2163,813,0,1350,813
1385,3309,1361,109,Titanium,"Titanium is refined and crafted into components, modules and other items.",Titanium.png,common,1278,1278,0,0,1278
1385,12805,7461,113,Aerogens,"Aerogens are refined and crafted into components, modules and other items.",Aerogens.png,common,2713,0,0,2713,0
1385,15121,7461,109,Titanium,"Titanium is refined and crafted into components, modules and other items.",Titanium.png,common,1246,1246,0,0,1246
1391,819,1365,52,Organic Compounds,"Organic Compounds are refined and crafted into components, modules and other items.",Organic_Compound.png,common,2754,345,0,2409,345
1391,820,1365,106,Elastomers,"Elastomers are refined and crafted into components, modules and other items.",Elastomers.png,abundant,4978,498,0,4480,498
1391,824,1365,121,Hypoatomic Substances,"Hypoatomic Substances are refined and crafted into components, modules and other items.",Hypoatomic_Substances.png,uncommon,1294,0,0,1294,0
1391,2810,7465,115,Nanofluids,"Nanofluids are refined and crafted into components, modules and other items.",Nanofluids.png,common,1137,0,0,1137,0
1391,2941,7465,42,Base Minerals,"Base Minerals are refined and crafted into components, modules and other items.",Base_Mineral.png,abundant,5238,0,0,5238,0
1391,3088,7465,115,Nanofluids,"Nanofluids are refined and crafted into components, modules and other items.",Nanofluids.png,common,2814,0,0,2814,0
1395,2177,1368,118,Platinyx,"Platinyx is refined and crafted into components, modules and other items.",Platinyx.png,uncommon,1455,1455,0,0,1455
1395,2779,1368,118,Platinyx,"Platinyx is refined and crafted into components, modules and other items.",Platinyx.png,uncommon,2779,2779,0,0,2779
1395,2780,1368,110,Plutonium,"Plutonium is refined and crafted into components, modules and other items.",Plutonium.png,common,4295,4295,0,0,4295
1395,17427,7468,120,Metamagnetic Ore,"Metamagnetic Ore is refined and crafted into components, modules and other items.",Metamagnetic_Ore.png,uncommon,1362,0,0,1362,0
1397,16214,1369,112,Amphoteric Substances,"Amphoteric Substances are refined and crafted into components, modules and other items.",Amphoteric_Substances.png,common,1032,0,0,1032,0
1397,16215,1369,123,Neolysium,"Neolysium is refined and crafted into components, modules and other items.",Neolysium.png,uncommon,1093,0,0,1093,0
1397,16216,1369,105,Silicates,"Silicates are refined and crafted into components, modules and other items.",Silicates.png,abundant,5106,0,0,5106,0
1397,17590,1369,109,Titanium,"Titanium is refined and crafted into components, modules and other items.",Titanium.png,common,2640,0,0,2640,0
1406,2708,1374,128,Tchaikovium,"Tchaikovium is refined and crafted into components, modules and other items.",Tchaikovium.png,rare,814,0,0,814,0
1406,4269,1374,112,Amphoteric Substances,"Amphoteric Substances are refined and crafted into components, modules and other items.",Amphoteric_Substances.png,common,2985,0,0,2985,0
1406,8251,1374,106,Elastomers,"Elastomers are refined and crafted into components, modules and other items.",Elastomers.png,abundant,4076,0,0,4076,0
1406,8252,1374,42,Base Minerals,"Base Minerals are refined and crafted into components, modules and other items.",Base_Mineral.png,abundant,4892,0,0,4892,0
1408,893,1375,110,Plutonium,"Plutonium is refined and crafted into components, modules and other items.",Plutonium.png,common,4773,0,0,4773,0
1408,901,1375,114,Ectopolymers,"Ectopolymers are refined and crafted into components, modules and other items.",Ectopolymers.png,common,2649,0,0,2649,0
1408,933,1375,128,Tchaikovium,"Tchaikovium is refined and crafted into components, modules and other items.",Tchaikovium.png,rare,813,0,0,813,0
1408,18025,7475,110,Plutonium,"Plutonium is refined and crafted into components, modules and other items.",Plutonium.png,common,1181,0,0,1181,0
1408,18026,7475,110,Plutonium,"Plutonium is refined and crafted into components, modules and other items.",Plutonium.png,common,2730,0,0,2730,0
1408,18027,7475,106,Elastomers,"Elastomers are refined and crafted into components, modules and other items.",Elastomers.png,abundant,5114,0,0,5114,0
1409,1523,1376,105,Silicates,"Silicates are refined and crafted into components, modules and other items.",Silicates.png,abundant,2398,0,0,2398,0
1409,1979,1376,42,Base Minerals,"Base Minerals are refined and crafted into components, modules and other items.",Base_Mineral.png,abundant,4396,0,0,4396,0
1409,1980,1376,105,Silicates,"Silicates are refined and crafted into components, modules and other items.",Silicates.png,abundant,5599,0,0,5599,0
1409,2805,7476,128,Tchaikovium,"Tchaikovium is refined and crafted into components, modules and other items.",Tchaikovium.png,rare,840,0,0,840,0
1409,2806,7476,128,Tchaikovium,"Tchaikovium is refined and crafted into components, modules and other items.",Tchaikovium.png,rare,608,0,0,608,0
1414,1355,1381,42,Base Minerals,"Base Minerals are refined and crafted into components, modules and other items.",Base_Mineral.png,abundant,2910,0,0,2910,0
1414,1399,1381,40,Polymetals,"Polymetals are refined and crafted into components, modules and other items.",Polymetals.png,common,5397,0,0,5397,0
1414,2836,1381,118,Platinyx,"Platinyx is refined and crafted into components, modules and other items.",Platinyx.png,uncommon,1082,0,0,1082,0
1418,16073,1384,127,Microorganisms,"Microorganisms are refined and crafted into components, modules and other items.",Microorganism.png,rare,781,0,0,781,0
1418,16138,1384,121,Hypoatomic Substances,"Hypoatomic Substances are refined and crafted into components, modules and other items.",Hypoatomic_Substances.png,uncommon,2484,0,0,2484,0
1418,16171,1384,107,H2O,"H2O is refined and crafted into components, modules and other items.",H20.png,abundant,4881,0,0,4881,0
1418,16139,7484,41,Xensium,"Xensium is refined and crafted into components, modules and other items.",Xensium.png,uncommon,1037,0,0,1037,0
1418,16238,7484,121,Hypoatomic Substances,"Hypoatomic Substances are refined and crafted into components, modules and other items.",Hypoatomic_Substances.png,uncommon,2671,0,0,2671,0
1418,16534,7484,107,H2O,"H2O is refined and crafted into components, modules and other items.",H20.png,abundant,5877,0,0,5877,0
1421,42,1387,119,Novis Compounds,"Novis Compounds are refined and crafted into components, modules and other items.",Novis_Compound.png,uncommon,4135,414,0,3721,414
1422,3933,1388,118,Platinyx,"Platinyx is refined and crafted into components, modules and other items.",Platinyx.png,uncommon,1393,0,0,1393,0
1422,3934,1388,118,Platinyx,"Platinyx is refined and crafted into components, modules and other items.",Platinyx.png,uncommon,2051,0,0,2051,0
1422,3958,1388,42,Base Minerals,"Base Minerals are refined and crafted into components, modules and other items.",Base_Mineral.png,abundant,4435,0,0,4435,0
1424,241,1390,41,Xensium,"Xensium is refined and crafted into components, modules and other items.",Xensium.png,uncommon,1260,0,0,1260,0
1424,260,1390,107,H2O,"H2O is refined and crafted into components, modules and other items.",H20.png,abundant,4999,0,0,4999,0
1424,353,1390,127,Microorganisms,"Microorganisms are refined and crafted into components, modules and other items.",Microorganism.png,rare,1752,0,0,1752,0
1436,1157,1400,128,Tchaikovium,"Tchaikovium is refined and crafted into components, modules and other items.",Tchaikovium.png,rare,720,0,0,720,0
1436,1238,1400,119,Novis Compounds,"Novis Compounds are refined and crafted into components, modules and other items.",Novis_Compound.png,uncommon,2629,0,0,2629,0
1436,1312,1400,40,Polymetals,"Polymetals are refined and crafted into components, modules and other items.",Polymetals.png,common,4843,0,0,4843,0
1436,1158,7500,127,Microorganisms,"Microorganisms are refined and crafted into components, modules and other items.",Microorganism.png,rare,855,0,0,855,0
1436,1302,7500,40,Polymetals,"Polymetals are refined and crafted into components, modules and other items.",Polymetals.png,common,2604,0,0,2604,0
1436,2113,7500,106,Elastomers,"Elastomers are refined and crafted into components, modules and other items.",Elastomers.png,abundant,4713,0,0,4713,0
1452,510,1412,123,Neolysium,"Neolysium is refined and crafted into components, modules and other items.",Neolysium.png,uncommon,1296,0,0,1296,0
1452,511,1412,42,Base Minerals,"Base Minerals are refined and crafted into components, modules and other items.",Base_Mineral.png,abundant,2440,0,0,2440,0
1452,512,1412,105,Silicates,"Silicates are refined and crafted into components, modules and other items.",Silicates.png,abundant,2684,0,0,2684,0
1452,981,1412,105,Silicates,"Silicates are refined and crafted into components, modules and other items.",Silicates.png,abundant,4380,438,0,3942,438
1452,982,1412,42,Base Minerals,"Base Minerals are refined and crafted into components, modules and other items.",Base_Mineral.png,abundant,4246,0,0,4246,0
1452,2022,7512,120,Metamagnetic Ore,"Metamagnetic Ore is refined and crafted into components, modules and other items.",Metamagnetic_Ore.png,uncommon,2423,0,0,2423,0
1452,3954,7512,110,Plutonium,"Plutonium is refined and crafted into components, modules and other items.",Plutonium.png,common,1016,0,0,1016,0
1452,4249,7512,123,Neolysium,"Neolysium is refined and crafted into components, modules and other items.",Neolysium.png,uncommon,4041,0,0,4041,0
1452,4250,7512,112,Amphoteric Substances,"Amphoteric Substances are refined and crafted into components, modules and other items.",Amphoteric_Substances.png,common,5081,0,0,5081,0
1453,560,1413,128,Tchaikovium,"Tchaikovium is refined and crafted into components, modules and other items.",Tchaikovium.png,rare,751,0,0,751,0
1453,561,1413,109,Titanium,"Titanium is refined and crafted into components, modules and other items.",Titanium.png,common,2407,0,0,2407,0
1453,777,1413,106,Elastomers,"Elastomers are refined and crafted into components, modules and other items.",Elastomers.png,abundant,5986,599,0,5387,599
1453,826,7513,126,Bruma Particles,"Bruma Particles are refined and crafted into components, modules and other items.",Bruma_Particle.png,rare,821,165,0,656,165
1453,1772,7513,105,Silicates,"Silicates are refined and crafted into components, modules and other items.",Silicates.png,abundant,2022,253,0,1769,253
1453,1930,7513,107,H2O,"H2O is refined and crafted into components, modules and other items.",H20.png,abundant,4921,493,0,4428,493
1453,1931,7513,42,Base Minerals,"Base Minerals are refined and crafted into components, modules and other items.",Base_Mineral.png,abundant,5795,0,0,5795,0
1457,1475,1417,119,Novis Compounds,"Novis Compounds are refined and crafted into components, modules and other items.",Novis_Compound.png,uncommon,1374,0,0,1374,0
1457,1535,1417,112,Amphoteric Substances,"Amphoteric Substances are refined and crafted into components, modules and other items.",Amphoteric_Substances.png,common,2322,0,0,2322,0
1457,1536,1417,107,H2O,"H2O is refined and crafted into components, modules and other items.",H20.png,abundant,4862,0,0,4862,0
1457,1659,7517,106,Elastomers,"Elastomers are refined and crafted into components, modules and other items.",Elastomers.png,abundant,5714,0,0,5714,0
1458,10858,1418,109,Titanium,"Titanium is refined and crafted into components, modules and other items.",Titanium.png,common,1191,0,0,1191,0
1458,12772,1418,113,Aerogens,"Aerogens are refined and crafted into components, modules and other items.",Aerogens.png,common,4903,0,0,4903,0
1458,17559,1418,115,Nanofluids,"Nanofluids are refined and crafted into components, modules and other items.",Nanofluids.png,common,2450,0,0,2450,0
1458,10726,7518,113,Aerogens,"Aerogens are refined and crafted into components, modules and other items.",Aerogens.png,common,2076,0,0,2076,0
1459,1537,1419,110,Plutonium,"Plutonium is refined and crafted into components, modules and other items.",Plutonium.png,common,1174,0,0,1174,0
1459,1538,1419,42,Base Minerals,"Base Minerals are refined and crafted into components, modules and other items.",Base_Mineral.png,abundant,4347,0,0,4347,0
1459,1660,1419,42,Base Minerals,"Base Minerals are refined and crafted into components, modules and other items.",Base_Mineral.png,abundant,2855,0,0,2855,0
1459,1661,7519,105,Silicates,"Silicates are refined and crafted into components, modules and other items.",Silicates.png,abundant,5363,0,0,5363,0
1459,1662,7519,107,H2O,"H2O is refined and crafted into components, modules and other items.",H20.png,abundant,5256,0,0,5256,0
1464,78,1422,105,Silicates,"Silicates are refined and crafted into components, modules and other items.",Silicates.png,abundant,4746,0,0,4746,0
1464,11290,1422,40,Polymetals,"Polymetals are refined and crafted into components, modules and other items.",Polymetals.png,common,1069,0,0,1069,0
1464,11291,1422,40,Polymetals,"Polymetals are refined and crafted into components, modules and other items.",Polymetals.png,common,1114,0,0,1114,0
1464,11292,1422,40,Polymetals,"Polymetals are refined and crafted into components, modules and other items.",Polymetals.png,common,2434,0,0,2434,0
1464,223,7522,40,Polymetals,"Polymetals are refined and crafted into components, modules and other items.",Polymetals.png,common,5462,0,0,5462,0
1464,11293,7522,119,Novis Compounds,"Novis Compounds are refined and crafted into components, modules and other items.",Novis_Compound.png,uncommon,1441,0,0,1441,0
1464,11294,7522,120,Metamagnetic Ore,"Metamagnetic Ore is refined and crafted into components, modules and other items.",Metamagnetic_Ore.png,uncommon,2370,0,0,2370,0
1465,955,1423,106,Elastomers,"Elastomers are refined and crafted into components, modules and other items.",Elastomers.png,abundant,5937,0,0,5937,0
1465,3939,1423,114,Ectopolymers,"Ectopolymers are refined and crafted into components, modules and other items.",Ectopolymers.png,common,1068,0,0,1068,0
1465,4787,1423,54,Hyperspecular Crystals,"Hyperspecular Crystals are refined and crafted into components, modules and other items.",Hyperspecular_Crystals.png,uncommon,2892,0,0,2892,0
1465,3912,7523,107,H2O,"H2O is refined and crafted into components, modules and other items.",H20.png,abundant,5340,0,0,5340,0
1465,10100,7523,119,Novis Compounds,"Novis Compounds are refined and crafted into components, modules and other items.",Novis_Compound.png,uncommon,1043,0,0,1043,0
1465,10198,7523,106,Elastomers,"Elastomers are refined and crafted into components, modules and other items.",Elastomers.png,abundant,2436,0,0,2436,0
1467,1335,1425,110,Plutonium,"Plutonium is refined and crafted into components, modules and other items.",Plutonium.png,common,4929,0,0,4929,0
1467,4804,1425,119,Novis Compounds,"Novis Compounds are refined and crafted into components, modules and other items.",Novis_Compound.png,uncommon,1040,0,0,1040,0
1467,4819,1425,110,Plutonium,"Plutonium is refined and crafted into components, modules and other items.",Plutonium.png,common,2595,0,0,2595,0
1467,3940,7525,112,Amphoteric Substances,"Amphoteric Substances are refined and crafted into components, modules and other items.",Amphoteric_Substances.png,common,5832,0,0,5832,0
1467,10365,7525,107,H2O,"H2O is refined and crafted into components, modules and other items.",H20.png,abundant,2662,0,0,2662,0
1467,11717,7525,128,Tchaikovium,"Tchaikovium is refined and crafted into components, modules and other items.",Tchaikovium.png,rare,652,0,0,652,0
1474,1539,1429,112,Amphoteric Substances,"Amphoteric Substances are refined and crafted into components, modules and other items.",Amphoteric_Substances.png,common,5967,0,0,5967,0
1474,1540,1429,112,Amphoteric Substances,"Amphoteric Substances are refined and crafted into components, modules and other items.",Amphoteric_Substances.png,common,5853,0,0,5853,0
1474,1656,1429,53,Ignis Ore,"Ignis Ore is refined and crafted into components, modules and other items.",Ignis_Ore.png,rare,671,0,0,671,0
1474,1657,1429,109,Titanium,"Titanium is refined and crafted into components, modules and other items.",Titanium.png,common,2252,0,0,2252,0
1474,1658,7529,42,Base Minerals,"Base Minerals are refined and crafted into components, modules and other items.",Base_Mineral.png,abundant,5725,0,0,5725,0
1475,19786,1430,128,Tchaikovium,"Tchaikovium is refined and crafted into components, modules and other items.",Tchaikovium.png,rare,639,128,0,511,128
1475,19787,1430,110,Plutonium,"Plutonium is refined and crafted into components, modules and other items.",Plutonium.png,common,2308,289,0,2019,289
1475,19788,1430,119,Novis Compounds,"Novis Compounds are refined and crafted into components, modules and other items.",Novis_Compound.png,uncommon,4402,441,0,3961,441
1475,19789,7530,115,Nanofluids,"Nanofluids are refined and crafted into components, modules and other items.",Nanofluids.png,common,1109,222,0,887,222
1475,19790,7530,52,Organic Compounds,"Organic Compounds are refined and crafted into components, modules and other items.",Organic_Compound.png,common,2111,264,0,1847,264
1475,19791,7530,109,Titanium,"Titanium is refined and crafted into components, modules and other items.",Titanium.png,common,2972,372,0,2600,372
1475,19792,7530,105,Silicates,"Silicates are refined and crafted into components, modules and other items.",Silicates.png,abundant,4212,422,0,3790,422
1475,19793,7530,105,Silicates,"Silicates are refined and crafted into components, modules and other items.",Silicates.png,abundant,5747,0,0,5747,0
1476,15354,1431,106,Elastomers,"Elastomers are refined and crafted into components, modules and other items.",Elastomers.png,abundant,5414,542,0,4872,542
1476,15355,1431,119,Novis Compounds,"Novis Compounds are refined and crafted into components, modules and other items.",Novis_Compound.png,uncommon,2581,323,0,2258,323
1478,2442,1433,119,Novis Compounds,"Novis Compounds are refined and crafted into components, modules and other items.",Novis_Compound.png,uncommon,1016,612,0,404,612
1478,2559,1433,128,Tchaikovium,"Tchaikovium is refined and crafted into components, modules and other items.",Tchaikovium.png,rare,1319,495,0,824,495
1478,2773,1433,119,Novis Compounds,"Novis Compounds are refined and crafted into components, modules and other items.",Novis_Compound.png,uncommon,5369,1611,0,3758,1611
1479,3295,1434,54,Hyperspecular Crystals,"Hyperspecular Crystals are refined and crafted into components, modules and other items.",Hyperspecular_Crystals.png,uncommon,4858,0,0,4858,0
1479,3296,1434,128,Tchaikovium,"Tchaikovium is refined and crafted into components, modules and other items.",Tchaikovium.png,rare,3575,0,0,3575,0
1479,8264,1434,128,Tchaikovium,"Tchaikovium is refined and crafted into components, modules and other items.",Tchaikovium.png,rare,627,0,0,627,0
1479,9275,1434,54,Hyperspecular Crystals,"Hyperspecular Crystals are refined and crafted into components, modules and other items.",Hyperspecular_Crystals.png,uncommon,2653,0,0,2653,0
1479,11882,7534,128,Tchaikovium,"Tchaikovium is refined and crafted into components, modules and other items.",Tchaikovium.png,rare,661,0,0,661,0
1479,12079,7534,110,Plutonium,"Plutonium is refined and crafted into components, modules and other items.",Plutonium.png,common,2018,0,0,2018,0
1479,12211,7534,42,Base Minerals,"Base Minerals are refined and crafted into components, modules and other items.",Base_Mineral.png,abundant,5573,0,0,5573,0
1483,11654,1437,54,Hyperspecular Crystals,"Hyperspecular Crystals are refined and crafted into components, modules and other items.",Hyperspecular_Crystals.png,uncommon,1359,0,0,1359,0
1483,11655,1437,117,Yprasium,"Yprasium is refined and crafted into components, modules and other items.",Yprasium.png,uncommon,2017,0,0,2017,0
1483,11656,1437,107,H2O,"H2O is refined and crafted into components, modules and other items.",H20.png,abundant,5955,0,0,5955,0
1483,767,7537,118,Platinyx,"Platinyx is refined and crafted into components, modules and other items.",Platinyx.png,uncommon,1153,0,0,1153,0
1483,11657,7537,114,Ectopolymers,"Ectopolymers are refined and crafted into components, modules and other items.",Ectopolymers.png,common,2028,0,0,2028,0
1483,11658,7537,105,Silicates,"Silicates are refined and crafted into components, modules and other items.",Silicates.png,abundant,4543,0,0,4543,0
1484,76,1438,126,Bruma Particles,"Bruma Particles are refined and crafted into components, modules and other items.",Bruma_Particle.png,rare,603,603,0,0,603
1484,124,1438,115,Nanofluids,"Nanofluids are refined and crafted into components, modules and other items.",Nanofluids.png,common,2896,0,0,2896,0
1484,364,1438,117,Yprasium,"Yprasium is refined and crafted into components, modules and other items.",Yprasium.png,uncommon,4921,0,0,4921,0
1484,1927,7538,117,Yprasium,"Yprasium is refined and crafted into components, modules and other items.",Yprasium.png,uncommon,1266,0,0,1266,0
1484,2155,7538,121,Hypoatomic Substances,"Hypoatomic Substances are refined and crafted into components, modules and other items.",Hypoatomic_Substances.png,uncommon,2660,0,0,2660,0
1484,2426,7538,106,Elastomers,"Elastomers are refined and crafted into components, modules and other items.",Elastomers.png,abundant,4527,2718,0,1809,2718
1485,596,1439,127,Microorganisms,"Microorganisms are refined and crafted into components, modules and other items.",Microorganism.png,rare,691,0,0,691,0
1485,657,1439,107,H2O,"H2O is refined and crafted into components, modules and other items.",H20.png,abundant,4655,4655,0,0,4655
1485,699,1439,121,Hypoatomic Substances,"Hypoatomic Substances are refined and crafted into components, modules and other items.",Hypoatomic_Substances.png,uncommon,2397,0,0,2397,0
1485,1300,7539,127,Microorganisms,"Microorganisms are refined and crafted into components, modules and other items.",Microorganism.png,rare,892,0,0,892,0
1485,1990,7539,52,Organic Compounds,"Organic Compounds are refined and crafted into components, modules and other items.",Organic_Compound.png,common,2090,0,0,2090,0
1485,1991,7539,107,H2O,"H2O is refined and crafted into components, modules and other items.",H20.png,abundant,4320,864,0,3456,864
1487,17,1440,110,Plutonium,"Plutonium is refined and crafted into components, modules and other items.",Plutonium.png,common,5360,536,0,4824,536
1487,21,1440,40,Polymetals,"Polymetals are refined and crafted into components, modules and other items.",Polymetals.png,common,1461,0,0,1461,0
1487,140,1440,40,Polymetals,"Polymetals are refined and crafted into components, modules and other items.",Polymetals.png,common,2034,0,0,2034,0
1487,132,7540,120,Metamagnetic Ore,"Metamagnetic Ore is refined and crafted into components, modules and other items.",Metamagnetic_Ore.png,uncommon,2200,0,0,2200,0
1487,171,7540,42,Base Minerals,"Base Minerals are refined and crafted into components, modules and other items.",Base_Mineral.png,abundant,5064,0,0,5064,0
1487,202,7540,128,Tchaikovium,"Tchaikovium is refined and crafted into components, modules and other items.",Tchaikovium.png,rare,839,0,0,839,0
1489,13074,1441,41,Xensium,"Xensium is refined and crafted into components, modules and other items.",Xensium.png,uncommon,1360,0,0,1360,0
1489,13075,1441,52,Organic Compounds,"Organic Compounds are refined and crafted into components, modules and other items.",Organic_Compound.png,common,1067,0,0,1067,0
1489,13076,1441,41,Xensium,"Xensium is refined and crafted into components, modules and other items.",Xensium.png,uncommon,2756,0,0,2756,0
1489,13077,1441,42,Base Minerals,"Base Minerals are refined and crafted into components, modules and other items.",Base_Mineral.png,abundant,5638,0,0,5638,0
1489,678,7541,107,H2O,"H2O is refined and crafted into components, modules and other items.",H20.png,abundant,4159,0,0,4159,0
1489,695,7541,115,Nanofluids,"Nanofluids are refined and crafted into components, modules and other items.",Nanofluids.png,common,1234,247,0,987,247
1489,13078,7541,106,Elastomers,"Elastomers are refined and crafted into components, modules and other items.",Elastomers.png,abundant,2079,0,0,2079,0
1490,12475,1442,121,Hypoatomic Substances,"Hypoatomic Substances are refined and crafted into components, modules and other items.",Hypoatomic_Substances.png,uncommon,1088,0,0,1088,0
1490,20959,1442,113,Aerogens,"Aerogens are refined and crafted into components, modules and other items.",Aerogens.png,common,2700,0,0,2700,0
1490,20960,1442,107,H2O,"H2O is refined and crafted into components, modules and other items.",H20.png,abundant,2815,0,0,2815,0
1492,9,1443,109,Titanium,"Titanium is refined and crafted into components, modules and other items.",Titanium.png,common,1476,0,0,1476,0
1492,176,1443,107,H2O,"H2O is refined and crafted into components, modules and other items.",H20.png,abundant,4190,0,0,4190,0
1492,310,1443,40,Polymetals,"Polymetals are refined and crafted into components, modules and other items.",Polymetals.png,common,2018,0,0,2018,0
1492,311,1443,106,Elastomers,"Elastomers are refined and crafted into components, modules and other items.",Elastomers.png,abundant,2289,1148,0,1141,1148
1492,1014,7543,119,Novis Compounds,"Novis Compounds are refined and crafted into components, modules and other items.",Novis_Compound.png,uncommon,1385,0,0,1385,0
1492,1541,7543,105,Silicates,"Silicates are refined and crafted into components, modules and other items.",Silicates.png,abundant,5780,0,0,5780,0
1492,2812,7543,106,Elastomers,"Elastomers are refined and crafted into components, modules and other items.",Elastomers.png,abundant,2674,0,0,2674,0
1494,17722,1445,127,Microorganisms,"Microorganisms are refined and crafted into components, modules and other items.",Microorganism.png,rare,856,0,0,856,0
1494,17732,1445,106,Elastomers,"Elastomers are refined and crafted into components, modules and other items.",Elastomers.png,abundant,5181,0,0,5181,0
1494,18116,1445,113,Aerogens,"Aerogens are refined and crafted into components, modules and other items.",Aerogens.png,common,2595,0,0,2595,0
1500,454,1448,53,Ignis Ore,"Ignis Ore is refined and crafted into components, modules and other items.",Ignis_Ore.png,rare,727,0,0,727,0
1500,455,1448,52,Organic Compounds,"Organic Compounds are refined and crafted into components, modules and other items.",Organic_Compound.png,common,2283,0,0,2283,0
1500,456,1448,52,Organic Compounds,"Organic Compounds are refined and crafted into components, modules and other items.",Organic_Compound.png,common,5778,0,0,5778,0
1501,15577,1449,105,Silicates,"Silicates are refined and crafted into components, modules and other items.",Silicates.png,abundant,5554,0,0,5554,0
1501,15578,1449,117,Yprasium,"Yprasium is refined and crafted into components, modules and other items.",Yprasium.png,uncommon,2521,0,0,2521,0
1502,580,1450,107,H2O,"H2O is refined and crafted into components, modules and other items.",H20.png,abundant,4963,0,0,4963,0
1502,1102,1450,113,Aerogens,"Aerogens are refined and crafted into components, modules and other items.",Aerogens.png,common,1101,0,0,1101,0
1502,1103,1450,109,Titanium,"Titanium is refined and crafted into components, modules and other items.",Titanium.png,common,2433,0,0,2433,0
1502,1332,7550,113,Aerogens,"Aerogens are refined and crafted into components, modules and other items.",Aerogens.png,common,2983,0,0,2983,0
1502,1787,7550,113,Aerogens,"Aerogens are refined and crafted into components, modules and other items.",Aerogens.png,common,4703,0,0,4703,0
1502,2335,7550,119,Novis Compounds,"Novis Compounds are refined and crafted into components, modules and other items.",Novis_Compound.png,uncommon,1471,0,0,1471,0
1507,1663,1452,107,H2O,"H2O is refined and crafted into components, modules and other items.",H20.png,abundant,2728,0,0,2728,0
1507,1664,1452,107,H2O,"H2O is refined and crafted into components, modules and other items.",H20.png,abundant,5885,0,0,5885,0
1507,1774,1452,54,Hyperspecular Crystals,"Hyperspecular Crystals are refined and crafted into components, modules and other items.",Hyperspecular_Crystals.png,uncommon,1248,0,0,1248,0
1507,1665,7552,107,H2O,"H2O is refined and crafted into components, modules and other items.",H20.png,abundant,4244,0,0,4244,0
1510,1356,1454,123,Neolysium,"Neolysium is refined and crafted into components, modules and other items.",Neolysium.png,uncommon,2331,0,0,2331,0
1510,2220,1454,123,Neolysium,"Neolysium is refined and crafted into components, modules and other items.",Neolysium.png,uncommon,1192,0,0,1192,0
1510,2221,1454,126,Bruma Particles,"Bruma Particles are refined and crafted into components, modules and other items.",Bruma_Particle.png,rare,639,0,0,639,0
1510,2222,1454,112,Amphoteric Substances,"Amphoteric Substances are refined and crafted into components, modules and other items.",Amphoteric_Substances.png,common,4052,2436,0,1616,2436
1512,1357,1456,115,Nanofluids,"Nanofluids are refined and crafted into components, modules and other items.",Nanofluids.png,common,2407,0,0,2407,0
1512,2223,1456,115,Nanofluids,"Nanofluids are refined and crafted into components, modules and other items.",Nanofluids.png,common,1288,0,0,1288,0
1512,2224,1456,52,Organic Compounds,"Organic Compounds are refined and crafted into components, modules and other items.",Organic_Compound.png,common,4887,4887,0,0,4887
1518,24,1460,127,Microorganisms,"Microorganisms are refined and crafted into components, modules and other items.",Microorganism.png,rare,787,787,0,0,787
1518,25,1460,115,Nanofluids,"Nanofluids are refined and crafted into components, modules and other items.",Nanofluids.png,common,1480,1480,0,0,1480
1518,108,1460,52,Organic Compounds,"Organic Compounds are refined and crafted into components, modules and other items.",Organic_Compound.png,common,2793,2793,0,0,2793
1518,109,1460,42,Base Minerals,"Base Minerals are refined and crafted into components, modules and other items.",Base_Mineral.png,abundant,4102,2877,0,1225,2877
1518,110,1460,126,Bruma Particles,"Bruma Particles are refined and crafted into components, modules and other items.",Bruma_Particle.png,rare,3587,3587,0,0,3587
1518,1747,7560,106,Elastomers,"Elastomers are refined and crafted into components, modules and other items.",Elastomers.png,abundant,5397,5397,0,0,5397
1518,1806,7560,52,Organic Compounds,"Organic Compounds are refined and crafted into components, modules and other items.",Organic_Compound.png,common,1065,1065,0,0,1065
1518,1981,7560,107,H2O,"H2O is refined and crafted into components, modules and other items.",H20.png,abundant,2484,2484,0,0,2484
1535,8748,1469,113,Aerogens,"Aerogens are refined and crafted into components, modules and other items.",Aerogens.png,common,4236,0,0,4236,0
1535,8749,1469,126,Bruma Particles,"Bruma Particles are refined and crafted into components, modules and other items.",Bruma_Particle.png,rare,890,0,0,890,0
1535,8750,1469,113,Aerogens,"Aerogens are refined and crafted into components, modules and other items.",Aerogens.png,common,2441,0,0,2441,0
1538,2437,1471,115,Nanofluids,"Nanofluids are refined and crafted into components, modules and other items.",Nanofluids.png,common,2860,0,0,2860,0
1538,2438,1471,107,H2O,"H2O is refined and crafted into components, modules and other items.",H20.png,abundant,4997,0,0,4997,0
1538,2519,1471,40,Polymetals,"Polymetals are refined and crafted into components, modules and other items.",Polymetals.png,common,1021,0,0,1021,0
1541,1817,1474,126,Bruma Particles,"Bruma Particles are refined and crafted into components, modules and other items.",Bruma_Particle.png,rare,611,0,0,611,0
1541,1818,1474,113,Aerogens,"Aerogens are refined and crafted into components, modules and other items.",Aerogens.png,common,2941,0,0,2941,0
1541,1819,1474,126,Bruma Particles,"Bruma Particles are refined and crafted into components, modules and other items.",Bruma_Particle.png,rare,1434,0,0,1434,0
1541,1820,1474,117,Yprasium,"Yprasium is refined and crafted into components, modules and other items.",Yprasium.png,uncommon,4708,0,0,4708,0
1541,1822,7574,117,Yprasium,"Yprasium is refined and crafted into components, modules and other items.",Yprasium.png,uncommon,1382,0,0,1382,0
1541,1823,7574,121,Hypoatomic Substances,"Hypoatomic Substances are refined and crafted into components, modules and other items.",Hypoatomic_Substances.png,uncommon,2265,0,0,2265,0
1543,1518,1476,113,Aerogens,"Aerogens are refined and crafted into components, modules and other items.",Aerogens.png,common,1332,0,0,1332,0
1543,1726,1476,113,Aerogens,"Aerogens are refined and crafted into components, modules and other items.",Aerogens.png,common,2081,0,0,2081,0
1543,1727,1476,54,Hyperspecular Crystals,"Hyperspecular Crystals are refined and crafted into components, modules and other items.",Hyperspecular_Crystals.png,uncommon,2989,0,0,2989,0
1543,1728,1476,105,Silicates,"Silicates are refined and crafted into components, modules and other items.",Silicates.png,abundant,4984,0,0,4984,0
1543,6337,7576,113,Aerogens,"Aerogens are refined and crafted into components, modules and other items.",Aerogens.png,common,1393,0,0,1393,0
1543,6436,7576,113,Aerogens,"Aerogens are refined and crafted into components, modules and other items.",Aerogens.png,common,2018,0,0,2018,0
1543,6799,7576,42,Base Minerals,"Base Minerals are refined and crafted into components, modules and other items.",Base_Mineral.png,abundant,4919,0,0,4919,0
1544,198,1477,105,Silicates,"Silicates are refined and crafted into components, modules and other items.",Silicates.png,abundant,2773,0,0,2773,0
1544,487,1477,127,Microorganisms,"Microorganisms are refined and crafted into components, modules and other items.",Microorganism.png,rare,724,0,0,724,0
1544,791,1477,52,Organic Compounds,"Organic Compounds are refined and crafted into components, modules and other items.",Organic_Compound.png,common,4508,2255,0,2253,2255
1547,677,1478,107,H2O,"H2O is refined and crafted into components, modules and other items.",H20.png,abundant,5617,0,0,5617,0
1547,737,1478,118,Platinyx,"Platinyx is refined and crafted into components, modules and other items.",Platinyx.png,uncommon,2309,0,0,2309,0
1547,1857,1478,53,Ignis Ore,"Ignis Ore is refined and crafted into components, modules and other items.",Ignis_Ore.png,rare,858,0,0,858,0
1547,1949,7578,42,Base Minerals,"Base Minerals are refined and crafted into components, modules and other items.",Base_Mineral.png,abundant,2020,0,0,2020,0
1547,3922,7578,53,Ignis Ore,"Ignis Ore is refined and crafted into components, modules and other items.",Ignis_Ore.png,rare,884,0,0,884,0
1550,362,1480,114,Ectopolymers,"Ectopolymers are refined and crafted into components, modules and other items.",Ectopolymers.png,common,1060,0,0,1060,0
1550,520,1480,119,Novis Compounds,"Novis Compounds are refined and crafted into components, modules and other items.",Novis_Compound.png,uncommon,2914,0,0,2914,0
1550,521,1480,106,Elastomers,"Elastomers are refined and crafted into components, modules and other items.",Elastomers.png,abundant,5861,0,0,5861,0
1557,3343,1482,105,Silicates,"Silicates are refined and crafted into components, modules and other items.",Silicates.png,abundant,4478,0,0,4478,0
1557,7759,1482,105,Silicates,"Silicates are refined and crafted into components, modules and other items.",Silicates.png,abundant,2933,0,0,2933,0
1557,7789,1482,128,Tchaikovium,"Tchaikovium is refined and crafted into components, modules and other items.",Tchaikovium.png,rare,899,0,0,899,0
1557,17758,7582,118,Platinyx,"Platinyx is refined and crafted into components, modules and other items.",Platinyx.png,uncommon,1063,0,0,1063,0
1557,18552,7582,119,Novis Compounds,"Novis Compounds are refined and crafted into components, modules and other items.",Novis_Compound.png,uncommon,2055,0,0,2055,0
1566,17317,1487,114,Ectopolymers,"Ectopolymers are refined and crafted into components, modules and other items.",Ectopolymers.png,common,1229,0,0,1229,0
1566,17318,1487,42,Base Minerals,"Base Minerals are refined and crafted into components, modules and other items.",Base_Mineral.png,abundant,2941,0,0,2941,0
1566,17319,1487,114,Ectopolymers,"Ectopolymers are refined and crafted into components, modules and other items.",Ectopolymers.png,common,5401,0,0,5401,0
1568,11258,1489,123,Neolysium,"Neolysium is refined and crafted into components, modules and other items.",Neolysium.png,uncommon,1133,0,0,1133,0
1568,11259,1489,113,Aerogens,"Aerogens are refined and crafted into components, modules and other items.",Aerogens.png,common,2024,0,0,2024,0
1568,11260,1489,107,H2O,"H2O is refined and crafted into components, modules and other items.",H20.png,abundant,4835,0,0,4835,0
1571,20725,1490,118,Platinyx,"Platinyx is refined and crafted into components, modules and other items.",Platinyx.png,uncommon,1346,0,0,1346,0
1571,20727,1490,40,Polymetals,"Polymetals are refined and crafted into components, modules and other items.",Polymetals.png,common,2419,0,0,2419,0
1571,20728,1490,106,Elastomers,"Elastomers are refined and crafted into components, modules and other items.",Elastomers.png,abundant,5218,0,0,5218,0
1571,20729,1490,107,H2O,"H2O is refined and crafted into components, modules and other items.",H20.png,abundant,5270,0,0,5270,0
1572,1547,1491,113,Aerogens,"Aerogens are refined and crafted into components, modules and other items.",Aerogens.png,common,5726,0,0,5726,0
1572,2320,1491,119,Novis Compounds,"Novis Compounds are refined and crafted into components, modules and other items.",Novis_Compound.png,uncommon,1454,0,0,1454,0
1572,3519,1491,110,Plutonium,"Plutonium is refined and crafted into components, modules and other items.",Plutonium.png,common,2802,0,0,2802,0
1572,3313,7591,42,Base Minerals,"Base Minerals are refined and crafted into components, modules and other items.",Base_Mineral.png,abundant,2319,0,0,2319,0
1572,3780,7591,42,Base Minerals,"Base Minerals are refined and crafted into components, modules and other items.",Base_Mineral.png,abundant,5238,0,0,5238,0
1572,4291,7591,128,Tchaikovium,"Tchaikovium is refined and crafted into components, modules and other items.",Tchaikovium.png,rare,674,0,0,674,0
1572,4292,7591,112,Amphoteric Substances,"Amphoteric Substances are refined and crafted into components, modules and other items.",Amphoteric_Substances.png,common,1433,0,0,1433,0
1573,2498,1492,53,Ignis Ore,"Ignis Ore is refined and crafted into components, modules and other items.",Ignis_Ore.png,rare,718,0,0,718,0
1573,2499,1492,109,Titanium,"Titanium is refined and crafted into components, modules and other items.",Titanium.png,common,2045,0,0,2045,0
1573,5019,1492,42,Base Minerals,"Base Minerals are refined and crafted into components, modules and other items.",Base_Mineral.png,abundant,4450,0,0,4450,0
1580,4088,1497,126,Bruma Particles,"Bruma Particles are refined and crafted into components, modules and other items.",Bruma_Particle.png,rare,823,0,0,823,0
1580,4089,1497,113,Aerogens,"Aerogens are refined and crafted into components, modules and other items.",Aerogens.png,common,2426,0,0,2426,0
1580,4090,1497,42,Base Minerals,"Base Minerals are refined and crafted into components, modules and other items.",Base_Mineral.png,abundant,5770,0,0,5770,0
1586,2176,1500,54,Hyperspecular Crystals,"Hyperspecular Crystals are refined and crafted into components, modules and other items.",Hyperspecular_Crystals.png,uncommon,2853,357,0,2496,357
1586,2508,1500,107,H2O,"H2O is refined and crafted into components, modules and other items.",H20.png,abundant,4354,0,0,4354,0
1586,2509,1500,106,Elastomers,"Elastomers are refined and crafted into components, modules and other items.",Elastomers.png,abundant,5026,0,0,5026,0
1586,4245,1500,110,Plutonium,"Plutonium is refined and crafted into components, modules and other items.",Plutonium.png,common,1109,0,0,1109,0
1586,4264,7600,121,Hypoatomic Substances,"Hypoatomic Substances are refined and crafted into components, modules and other items.",Hypoatomic_Substances.png,uncommon,2515,0,0,2515,0
1586,4405,7600,110,Plutonium,"Plutonium is refined and crafted into components, modules and other items.",Plutonium.png,common,5649,0,0,5649,0
1586,4510,7600,128,Tchaikovium,"Tchaikovium is refined and crafted into components, modules and other items.",Tchaikovium.png,rare,798,0,0,798,0
1589,626,1503,114,Ectopolymers,"Ectopolymers are refined and crafted into components, modules and other items.",Ectopolymers.png,common,2742,0,0,2742,0
1589,804,1503,54,Hyperspecular Crystals,"Hyperspecular Crystals are refined and crafted into components, modules and other items.",Hyperspecular_Crystals.png,uncommon,1296,0,0,1296,0
1589,890,1503,114,Ectopolymers,"Ectopolymers are refined and crafted into components, modules and other items.",Ectopolymers.png,common,5665,0,0,5665,0
1589,18028,7603,110,Plutonium,"Plutonium is refined and crafted into components, modules and other items.",Plutonium.png,common,1480,0,0,1480,0
1589,18030,7603,114,Ectopolymers,"Ectopolymers are refined and crafted into components, modules and other items.",Ectopolymers.png,common,2603,0,0,2603,0
1589,18031,7603,110,Plutonium,"Plutonium is refined and crafted into components, modules and other items.",Plutonium.png,common,4691,0,0,4691,0
1590,1596,1504,115,Nanofluids,"Nanofluids are refined and crafted into components, modules and other items.",Nanofluids.png,common,4746,0,0,4746,0
1590,1858,1504,117,Yprasium,"Yprasium is refined and crafted into components, modules and other items.",Yprasium.png,uncommon,1004,0,0,1004,0
1590,2021,1504,106,Elastomers,"Elastomers are refined and crafted into components, modules and other items.",Elastomers.png,abundant,2534,0,0,2534,0
1590,2258,7604,114,Ectopolymers,"Ectopolymers are refined and crafted into components, modules and other items.",Ectopolymers.png,common,2931,0,0,2931,0
1590,4213,7604,107,H2O,"H2O is refined and crafted into components, modules and other items.",H20.png,abundant,4844,0,0,4844,0
1590,4268,7604,53,Ignis Ore,"Ignis Ore is refined and crafted into components, modules and other items.",Ignis_Ore.png,rare,660,264,0,396,264
1593,2861,1507,121,Hypoatomic Substances,"Hypoatomic Substances are refined and crafted into components, modules and other items.",Hypoatomic_Substances.png,uncommon,1159,0,0,1159,0
1593,2862,1507,113,Aerogens,"Aerogens are refined and crafted into components, modules and other items.",Aerogens.png,common,2812,0,0,2812,0
1593,2863,1507,106,Elastomers,"Elastomers are refined and crafted into components, modules and other items.",Elastomers.png,abundant,5725,0,0,5725,0
1594,7503,1508,54,Hyperspecular Crystals,"Hyperspecular Crystals are refined and crafted into components, modules and other items.",Hyperspecular_Crystals.png,uncommon,1284,257,0,1027,257
1594,7694,1508,113,Aerogens,"Aerogens are refined and crafted into components, modules and other items.",Aerogens.png,common,2548,1276,0,1272,1276
1594,8258,1508,42,Base Minerals,"Base Minerals are refined and crafted into components, modules and other items.",Base_Mineral.png,abundant,4919,0,0,4919,0
1594,8259,7608,126,Bruma Particles,"Bruma Particles are refined and crafted into components, modules and other items.",Bruma_Particle.png,rare,604,242,0,362,242
1594,8260,7608,42,Base Minerals,"Base Minerals are refined and crafted into components, modules and other items.",Base_Mineral.png,abundant,2222,556,0,1666,556
1594,8261,7608,42,Base Minerals,"Base Minerals are refined and crafted into components, modules and other items.",Base_Mineral.png,abundant,5587,0,0,5587,0
1596,2981,1510,42,Base Minerals,"Base Minerals are refined and crafted into components, modules and other items.",Base_Mineral.png,abundant,4127,0,0,4127,0
1596,3523,1510,42,Base Minerals,"Base Minerals are refined and crafted into components, modules and other items.",Base_Mineral.png,abundant,2603,0,0,2603,0
1596,4206,1510,53,Ignis Ore,"Ignis Ore is refined and crafted into components, modules and other items.",Ignis_Ore.png,rare,600,360,0,240,360
1596,7793,7610,53,Ignis Ore,"Ignis Ore is refined and crafted into components, modules and other items.",Ignis_Ore.png,rare,1316,165,0,1151,165
1596,7794,7610,112,Amphoteric Substances,"Amphoteric Substances are refined and crafted into components, modules and other items.",Amphoteric_Substances.png,common,2322,0,0,2322,0
1596,8482,7610,120,Metamagnetic Ore,"Metamagnetic Ore is refined and crafted into components, modules and other items.",Metamagnetic_Ore.png,uncommon,1455,582,0,873,582
1596,13400,7610,105,Silicates,"Silicates are refined and crafted into components, modules and other items.",Silicates.png,abundant,4869,0,0,4869,0
1598,13079,1511,127,Microorganisms,"Microorganisms are refined and crafted into components, modules and other items.",Microorganism.png,rare,886,0,0,886,0
1598,13080,1511,41,Xensium,"Xensium is refined and crafted into components, modules and other items.",Xensium.png,uncommon,2097,0,0,2097,0
1598,13081,1511,107,H2O,"H2O is refined and crafted into components, modules and other items.",H20.png,abundant,4648,0,0,4648,0
1598,13082,7611,121,Hypoatomic Substances,"Hypoatomic Substances are refined and crafted into components, modules and other items.",Hypoatomic_Substances.png,uncommon,1195,0,0,1195,0
1598,13083,7611,112,Amphoteric Substances,"Amphoteric Substances are refined and crafted into components, modules and other items.",Amphoteric_Substances.png,common,2785,0,0,2785,0
1598,13084,7611,105,Silicates,"Silicates are refined and crafted into components, modules and other items.",Silicates.png,abundant,5321,0,0,5321,0
1600,463,1513,112,Amphoteric Substances,"Amphoteric Substances are refined and crafted into components, modules and other items.",Amphoteric_Substances.png,common,1215,0,0,1215,0
1600,2179,1513,112,Amphoteric Substances,"Amphoteric Substances are refined and crafted into components, modules and other items.",Amphoteric_Substances.png,common,2521,0,0,2521,0
1600,2180,1513,107,H2O,"H2O is refined and crafted into components, modules and other items.",H20.png,abundant,4390,0,0,4390,0
1605,11683,1517,53,Ignis Ore,"Ignis Ore is refined and crafted into components, modules and other items.",Ignis_Ore.png,rare,861,0,0,861,0
1605,11684,1517,112,Amphoteric Substances,"Amphoteric Substances are refined and crafted into components, modules and other items.",Amphoteric_Substances.png,common,2910,0,0,2910,0
1605,11685,1517,106,Elastomers,"Elastomers are refined and crafted into components, modules and other items.",Elastomers.png,abundant,4946,0,0,4946,0
1605,99,7617,40,Polymetals,"Polymetals are refined and crafted into components, modules and other items.",Polymetals.png,common,2518,315,0,2203,315
1605,738,7617,112,Amphoteric Substances,"Amphoteric Substances are refined and crafted into components, modules and other items.",Amphoteric_Substances.png,common,5279,5279,0,0,5279
1605,10597,7617,54,Hyperspecular Crystals,"Hyperspecular Crystals are refined and crafted into components, modules and other items.",Hyperspecular_Crystals.png,uncommon,1168,234,0,934,234
1614,8,1522,53,Ignis Ore,"Ignis Ore is refined and crafted into components, modules and other items.",Ignis_Ore.png,rare,704,704,0,0,704
1614,13,1522,112,Amphoteric Substances,"Amphoteric Substances are refined and crafted into components, modules and other items.",Amphoteric_Substances.png,common,2245,0,0,2245,0
1614,365,1522,110,Plutonium,"Plutonium is refined and crafted into components, modules and other items.",Plutonium.png,common,4661,0,0,4661,0
1614,1936,7622,114,Ectopolymers,"Ectopolymers are refined and crafted into components, modules and other items.",Ectopolymers.png,common,1106,0,0,1106,0
1614,2227,7622,105,Silicates,"Silicates are refined and crafted into components, modules and other items.",Silicates.png,abundant,2686,2686,0,0,2686
1614,2439,7622,112,Amphoteric Substances,"Amphoteric Substances are refined and crafted into components, modules and other items.",Amphoteric_Substances.png,common,4172,0,0,4172,0
1622,1490,1529,112,Amphoteric Substances,"Amphoteric Substances are refined and crafted into components, modules and other items.",Amphoteric_Substances.png,common,1338,0,0,1338,0
1622,1491,1529,106,Elastomers,"Elastomers are refined and crafted into components, modules and other items.",Elastomers.png,abundant,4430,0,0,4430,0
1622,2312,1529,40,Polymetals,"Polymetals are refined and crafted into components, modules and other items.",Polymetals.png,common,2983,0,0,2983,0
1623,1859,1530,105,Silicates,"Silicates are refined and crafted into components, modules and other items.",Silicates.png,abundant,4806,0,0,4806,0
1623,1869,1530,54,Hyperspecular Crystals,"Hyperspecular Crystals are refined and crafted into components, modules and other items.",Hyperspecular_Crystals.png,uncommon,1488,0,0,1488,0
1623,2025,1530,106,Elastomers,"Elastomers are refined and crafted into components, modules and other items.",Elastomers.png,abundant,2599,0,0,2599,0
1623,3923,7630,121,Hypoatomic Substances,"Hypoatomic Substances are refined and crafted into components, modules and other items.",Hypoatomic_Substances.png,uncommon,2285,0,0,2285,0
1623,4379,7630,107,H2O,"H2O is refined and crafted into components, modules and other items.",H20.png,abundant,4800,0,0,4800,0
1623,4416,7630,126,Bruma Particles,"Bruma Particles are refined and crafted into components, modules and other items.",Bruma_Particle.png,rare,750,750,0,0,750
1623,4417,7630,109,Titanium,"Titanium is refined and crafted into components, modules and other items.",Titanium.png,common,1123,0,0,1123,0
1624,785,1531,115,Nanofluids,"Nanofluids are refined and crafted into components, modules and other items.",Nanofluids.png,common,2524,0,0,2524,0
1624,1045,1531,107,H2O,"H2O is refined and crafted into components, modules and other items.",H20.png,abundant,5945,595,0,5350,595
1624,1219,1531,117,Yprasium,"Yprasium is refined and crafted into components, modules and other items.",Yprasium.png,uncommon,1190,0,0,1190,0
1624,851,7631,40,Polymetals,"Polymetals are refined and crafted into components, modules and other items.",Polymetals.png,common,2173,0,0,2173,0
1624,882,7631,115,Nanofluids,"Nanofluids are refined and crafted into components, modules and other items.",Nanofluids.png,common,1069,0,0,1069,0
1624,4503,7631,110,Plutonium,"Plutonium is refined and crafted into components, modules and other items.",Plutonium.png,common,4447,0,0,4447,0
1626,537,1533,123,Neolysium,"Neolysium is refined and crafted into components, modules and other items.",Neolysium.png,uncommon,2874,0,0,2874,0
1629,6,1536,128,Tchaikovium,"Tchaikovium is refined and crafted into components, modules and other items.",Tchaikovium.png,rare,854,854,0,0,854
1629,125,1536,115,Nanofluids,"Nanofluids are refined and crafted into components, modules and other items.",Nanofluids.png,common,2707,0,0,2707,0
1629,377,1536,42,Base Minerals,"Base Minerals are refined and crafted into components, modules and other items.",Base_Mineral.png,abundant,5156,5156,0,0,5156
1629,1952,7636,128,Tchaikovium,"Tchaikovium is refined and crafted into components, modules and other items.",Tchaikovium.png,rare,801,0,0,801,0
1629,2288,7636,53,Ignis Ore,"Ignis Ore is refined and crafted into components, modules and other items.",Ignis_Ore.png,rare,1667,0,0,1667,0
1629,2443,7636,115,Nanofluids,"Nanofluids are refined and crafted into components, modules and other items.",Nanofluids.png,common,5669,0,0,5669,0
1630,16237,1537,128,Tchaikovium,"Tchaikovium is refined and crafted into components, modules and other items.",Tchaikovium.png,rare,654,0,0,654,0
1630,16370,1537,40,Polymetals,"Polymetals are refined and crafted into components, modules and other items.",Polymetals.png,common,2266,0,0,2266,0
1630,17293,1537,105,Silicates,"Silicates are refined and crafted into components, modules and other items.",Silicates.png,abundant,5404,0,0,5404,0
1630,17294,7637,128,Tchaikovium,"Tchaikovium is refined and crafted into components, modules and other items.",Tchaikovium.png,rare,838,0,0,838,0
1630,17959,7637,128,Tchaikovium,"Tchaikovium is refined and crafted into components, modules and other items.",Tchaikovium.png,rare,1427,0,0,1427,0
1630,18153,7637,110,Plutonium,"Plutonium is refined and crafted into components, modules and other items.",Plutonium.png,common,5379,0,0,5379,0
1630,18154,7637,107,H2O,"H2O is refined and crafted into components, modules and other items.",H20.png,abundant,4555,0,0,4555,0
1633,786,1539,113,Aerogens,"Aerogens are refined and crafted into components, modules and other items.",Aerogens.png,common,2514,0,0,2514,0
1633,973,1539,107,H2O,"H2O is refined and crafted into components, modules and other items.",H20.png,abundant,4816,0,0,4816,0
1633,1318,1539,54,Hyperspecular Crystals,"Hyperspecular Crystals are refined and crafted into components, modules and other items.",Hyperspecular_Crystals.png,uncommon,1005,0,0,1005,0
1633,974,7639,127,Microorganisms,"Microorganisms are refined and crafted into components, modules and other items.",Microorganism.png,rare,626,0,0,626,0
1633,1550,7639,123,Neolysium,"Neolysium is refined and crafted into components, modules and other items.",Neolysium.png,uncommon,2824,0,0,2824,0
1634,3320,1540,42,Base Minerals,"Base Minerals are refined and crafted into components, modules and other items.",Base_Mineral.png,abundant,5414,0,0,5414,0
1634,9277,1540,40,Polymetals,"Polymetals are refined and crafted into components, modules and other items.",Polymetals.png,common,1112,0,0,1112,0
1634,9819,1540,42,Base Minerals,"Base Minerals are refined and crafted into components, modules and other items.",Base_Mineral.png,abundant,2890,0,0,2890,0
1634,12706,7640,114,Ectopolymers,"Ectopolymers are refined and crafted into components, modules and other items.",Ectopolymers.png,common,1436,0,0,1436,0
1634,13333,7640,110,Plutonium,"Plutonium is refined and crafted into components, modules and other items.",Plutonium.png,common,2974,0,0,2974,0
1634,15361,7640,110,Plutonium,"Plutonium is refined and crafted into components, modules and other items.",Plutonium.png,common,4471,0,0,4471,0
1637,1144,1542,128,Tchaikovium,"Tchaikovium is refined and crafted into components, modules and other items.",Tchaikovium.png,rare,768,616,0,152,616
1637,15313,1542,107,H2O,"H2O is refined and crafted into components, modules and other items.",H20.png,abundant,4564,0,0,4564,0
1637,18255,1542,42,Base Minerals,"Base Minerals are refined and crafted into components, modules and other items.",Base_Mineral.png,abundant,2976,0,0,2976,0
1639,1977,1543,128,Tchaikovium,"Tchaikovium is refined and crafted into components, modules and other items.",Tchaikovium.png,rare,718,0,0,718,0
1639,2560,1543,42,Base Minerals,"Base Minerals are refined and crafted into components, modules and other items.",Base_Mineral.png,abundant,2132,0,0,2132,0
1639,2774,1543,42,Base Minerals,"Base Minerals are refined and crafted into components, modules and other items.",Base_Mineral.png,abundant,5738,1148,0,4590,1148
1641,1897,1545,126,Bruma Particles,"Bruma Particles are refined and crafted into components, modules and other items.",Bruma_Particle.png,rare,775,0,0,775,0
1641,1898,1545,115,Nanofluids,"Nanofluids are refined and crafted into components, modules and other items.",Nanofluids.png,common,2311,0,0,2311,0
1641,1899,1545,106,Elastomers,"Elastomers are refined and crafted into components, modules and other items.",Elastomers.png,abundant,4034,0,0,4034,0
1643,2178,1547,126,Bruma Particles,"Bruma Particles are refined and crafted into components, modules and other items.",Bruma_Particle.png,rare,861,173,0,688,173
1643,2781,1547,52,Organic Compounds,"Organic Compounds are refined and crafted into components, modules and other items.",Organic_Compound.png,common,4968,1988,0,2980,1988
1643,2824,1547,107,H2O,"H2O is refined and crafted into components, modules and other items.",H20.png,abundant,2102,1841,0,261,1841
1649,81,1551,118,Platinyx,"Platinyx is refined and crafted into components, modules and other items.",Platinyx.png,uncommon,1090,0,0,1090,0
1649,126,1551,128,Tchaikovium,"Tchaikovium is refined and crafted into components, modules and other items.",Tchaikovium.png,rare,1790,1790,0,0,1790
1649,378,1551,105,Silicates,"Silicates are refined and crafted into components, modules and other items.",Silicates.png,abundant,5527,5527,0,0,5527
1649,1962,7651,53,Ignis Ore,"Ignis Ore is refined and crafted into components, modules and other items.",Ignis_Ore.png,rare,691,0,0,691,0
1649,2361,7651,107,H2O,"H2O is refined and crafted into components, modules and other items.",H20.png,abundant,2123,266,0,1857,266
1649,2459,7651,105,Silicates,"Silicates are refined and crafted into components, modules and other items.",Silicates.png,abundant,4634,0,0,4634,0
1650,3325,1552,115,Nanofluids,"Nanofluids are refined and crafted into components, modules and other items.",Nanofluids.png,common,4625,0,0,4625,0
1650,9814,1552,126,Bruma Particles,"Bruma Particles are refined and crafted into components, modules and other items.",Bruma_Particle.png,rare,795,0,0,795,0
1650,9820,1552,117,Yprasium,"Yprasium is refined and crafted into components, modules and other items.",Yprasium.png,uncommon,2005,0,0,2005,0
1650,15610,7652,117,Yprasium,"Yprasium is refined and crafted into components, modules and other items.",Yprasium.png,uncommon,2932,0,0,2932,0
1650,17936,7652,115,Nanofluids,"Nanofluids are refined and crafted into components, modules and other items.",Nanofluids.png,common,1162,0,0,1162,0
1650,17986,7652,106,Elastomers,"Elastomers are refined and crafted into components, modules and other items.",Elastomers.png,abundant,5990,0,0,5990,0
1653,823,1554,127,Microorganisms,"Microorganisms are refined and crafted into components, modules and other items.",Microorganism.png,rare,655,0,0,655,0
1653,825,1554,114,Ectopolymers,"Ectopolymers are refined and crafted into components, modules and other items.",Ectopolymers.png,common,2697,0,0,2697,0
1653,861,1554,105,Silicates,"Silicates are refined and crafted into components, modules and other items.",Silicates.png,abundant,5704,571,0,5133,571
1653,2952,7654,127,Microorganisms,"Microorganisms are refined and crafted into components, modules and other items.",Microorganism.png,rare,788,0,0,788,0
1653,3121,7654,114,Ectopolymers,"Ectopolymers are refined and crafted into components, modules and other items.",Ectopolymers.png,common,2330,0,0,2330,0
1653,4561,7654,114,Ectopolymers,"Ectopolymers are refined and crafted into components, modules and other items.",Ectopolymers.png,common,5593,0,0,5593,0
1654,3488,1555,128,Tchaikovium,"Tchaikovium is refined and crafted into components, modules and other items.",Tchaikovium.png,rare,613,0,0,613,0
1654,3489,1555,115,Nanofluids,"Nanofluids are refined and crafted into components, modules and other items.",Nanofluids.png,common,2684,0,0,2684,0
1654,3490,1555,52,Organic Compounds,"Organic Compounds are refined and crafted into components, modules and other items.",Organic_Compound.png,common,2647,0,0,2647,0
1654,3491,1555,107,H2O,"H2O is refined and crafted into components, modules and other items.",H20.png,abundant,5509,0,0,5509,0
1654,3492,7655,107,H2O,"H2O is refined and crafted into components, modules and other items.",H20.png,abundant,2413,0,0,2413,0
1654,6272,7655,113,Aerogens,"Aerogens are refined and crafted into components, modules and other items.",Aerogens.png,common,4485,0,0,4485,0
1654,6469,7655,121,Hypoatomic Substances,"Hypoatomic Substances are refined and crafted into components, modules and other items.",Hypoatomic_Substances.png,uncommon,1201,0,0,1201,0
1654,6470,7655,41,Xensium,"Xensium is refined and crafted into components, modules and other items.",Xensium.png,uncommon,1335,0,0,1335,0
1655,88,1556,53,Ignis Ore,"Ignis Ore is refined and crafted into components, modules and other items.",Ignis_Ore.png,rare,628,0,0,628,0
1655,128,1556,42,Base Minerals,"Base Minerals are refined and crafted into components, modules and other items.",Base_Mineral.png,abundant,2850,2850,0,0,2850
1655,379,1556,110,Plutonium,"Plutonium is refined and crafted into components, modules and other items.",Plutonium.png,common,5969,0,0,5969,0
1655,1972,7656,128,Tchaikovium,"Tchaikovium is refined and crafted into components, modules and other items.",Tchaikovium.png,rare,718,0,0,718,0
1655,2364,7656,112,Amphoteric Substances,"Amphoteric Substances are refined and crafted into components, modules and other items.",Amphoteric_Substances.png,common,2652,0,0,2652,0
1655,2480,7656,105,Silicates,"Silicates are refined and crafted into components, modules and other items.",Silicates.png,abundant,5406,0,0,5406,0
1658,3354,1559,106,Elastomers,"Elastomers are refined and crafted into components, modules and other items.",Elastomers.png,abundant,4276,0,0,4276,0
1658,7760,1559,117,Yprasium,"Yprasium is refined and crafted into components, modules and other items.",Yprasium.png,uncommon,2094,0,0,2094,0
1658,15414,1559,117,Yprasium,"Yprasium is refined and crafted into components, modules and other items.",Yprasium.png,uncommon,1009,0,0,1009,0
1658,18553,7659,121,Hypoatomic Substances,"Hypoatomic Substances are refined and crafted into components, modules and other items.",Hypoatomic_Substances.png,uncommon,2408,0,0,2408,0
1661,2434,1561,127,Microorganisms,"Microorganisms are refined and crafted into components, modules and other items.",Microorganism.png,rare,683,0,0,683,0
1661,2782,1561,107,H2O,"H2O is refined and crafted into components, modules and other items.",H20.png,abundant,4535,4535,0,0,4535
1661,2823,1561,112,Amphoteric Substances,"Amphoteric Substances are refined and crafted into components, modules and other items.",Amphoteric_Substances.png,common,2987,2987,0,0,2987
1662,8185,1562,115,Nanofluids,"Nanofluids are refined and crafted into components, modules and other items.",Nanofluids.png,common,1029,412,0,617,412
1662,8186,1562,52,Organic Compounds,"Organic Compounds are refined and crafted into components, modules and other items.",Organic_Compound.png,common,2298,288,0,2010,288
1662,8187,1562,115,Nanofluids,"Nanofluids are refined and crafted into components, modules and other items.",Nanofluids.png,common,2475,310,0,2165,310
1662,8190,1562,106,Elastomers,"Elastomers are refined and crafted into components, modules and other items.",Elastomers.png,abundant,4749,0,0,4749,0
1662,8219,7662,113,Aerogens,"Aerogens are refined and crafted into components, modules and other items.",Aerogens.png,common,1400,280,0,1120,280
1662,8220,7662,127,Microorganisms,"Microorganisms are refined and crafted into components, modules and other items.",Microorganism.png,rare,791,0,0,791,0
1662,8253,7662,41,Xensium,"Xensium is refined and crafted into components, modules and other items.",Xensium.png,uncommon,2843,356,0,2487,356
1662,8262,7662,115,Nanofluids,"Nanofluids are refined and crafted into components, modules and other items.",Nanofluids.png,common,4345,0,0,4345,0
1663,8713,1563,42,Base Minerals,"Base Minerals are refined and crafted into components, modules and other items.",Base_Mineral.png,abundant,5582,0,0,5582,0
1663,8714,1563,106,Elastomers,"Elastomers are refined and crafted into components, modules and other items.",Elastomers.png,abundant,2608,0,0,2608,0
1663,17766,1563,128,Tchaikovium,"Tchaikovium is refined and crafted into components, modules and other items.",Tchaikovium.png,rare,644,0,0,644,0
1663,17926,7663,110,Plutonium,"Plutonium is refined and crafted into components, modules and other items.",Plutonium.png,common,2785,0,0,2785,0
1663,17927,7663,128,Tchaikovium,"Tchaikovium is refined and crafted into components, modules and other items.",Tchaikovium.png,rare,645,0,0,645,0
1663,18482,7663,107,H2O,"H2O is refined and crafted into components, modules and other items.",H20.png,abundant,4272,0,0,4272,0
1666,361,1566,107,H2O,"H2O is refined and crafted into components, modules and other items.",H20.png,abundant,2377,0,0,2377,0
1666,369,1566,127,Microorganisms,"Microorganisms are refined and crafted into components, modules and other items.",Microorganism.png,rare,763,0,0,763,0
1666,2864,1566,106,Elastomers,"Elastomers are refined and crafted into components, modules and other items.",Elastomers.png,abundant,5845,0,0,5845,0
1667,3137,1567,114,Ectopolymers,"Ectopolymers are refined and crafted into components, modules and other items.",Ectopolymers.png,common,1193,0,0,1193,0
1667,3138,1567,110,Plutonium,"Plutonium is refined and crafted into components, modules and other items.",Plutonium.png,common,2880,0,0,2880,0
1667,3139,1567,119,Novis Compounds,"Novis Compounds are refined and crafted into components, modules and other items.",Novis_Compound.png,uncommon,5057,0,0,5057,0
1667,15511,7667,110,Plutonium,"Plutonium is refined and crafted into components, modules and other items.",Plutonium.png,common,1228,0,0,1228,0
1668,597,1568,127,Microorganisms,"Microorganisms are refined and crafted into components, modules and other items.",Microorganism.png,rare,760,0,0,760,0
1668,658,1568,107,H2O,"H2O is refined and crafted into components, modules and other items.",H20.png,abundant,4796,0,0,4796,0
1668,753,1568,109,Titanium,"Titanium is refined and crafted into components, modules and other items.",Titanium.png,common,2674,0,0,2674,0
1668,1992,7668,127,Microorganisms,"Microorganisms are refined and crafted into components, modules and other items.",Microorganism.png,rare,819,0,0,819,0
1668,1993,7668,105,Silicates,"Silicates are refined and crafted into components, modules and other items.",Silicates.png,abundant,2659,0,0,2659,0
1668,3555,7668,109,Titanium,"Titanium is refined and crafted into components, modules and other items.",Titanium.png,common,5221,0,0,5221,0
1669,650,1569,126,Bruma Particles,"Bruma Particles are refined and crafted into components, modules and other items.",Bruma_Particle.png,rare,656,132,0,524,132
1669,727,1569,42,Base Minerals,"Base Minerals are refined and crafted into components, modules and other items.",Base_Mineral.png,abundant,4220,0,0,4220,0
1669,754,1569,40,Polymetals,"Polymetals are refined and crafted into components, modules and other items.",Polymetals.png,common,2399,0,0,2399,0
1669,1994,7669,127,Microorganisms,"Microorganisms are refined and crafted into components, modules and other items.",Microorganism.png,rare,791,0,0,791,0
1669,1995,7669,113,Aerogens,"Aerogens are refined and crafted into components, modules and other items.",Aerogens.png,common,1425,0,0,1425,0
1669,2808,7669,107,H2O,"H2O is refined and crafted into components, modules and other items.",H20.png,abundant,2685,0,0,2685,0
1669,4271,7669,107,H2O,"H2O is refined and crafted into components, modules and other items.",H20.png,abundant,5703,0,0,5703,0
1670,19,1570,121,Hypoatomic Substances,"Hypoatomic Substances are refined and crafted into components, modules and other items.",Hypoatomic_Substances.png,uncommon,1259,0,0,1259,0
1670,31,1570,114,Ectopolymers,"Ectopolymers are refined and crafted into components, modules and other items.",Ectopolymers.png,common,2778,0,0,2778,0
1670,222,1570,42,Base Minerals,"Base Minerals are refined and crafted into components, modules and other items.",Base_Mineral.png,abundant,5932,0,0,5932,0
1670,772,7670,113,Aerogens,"Aerogens are refined and crafted into components, modules and other items.",Aerogens.png,common,2526,0,0,2526,0
1670,1183,7670,117,Yprasium,"Yprasium is refined and crafted into components, modules and other items.",Yprasium.png,uncommon,1159,232,0,927,232
1670,1184,7670,105,Silicates,"Silicates are refined and crafted into components, modules and other items.",Silicates.png,abundant,4162,0,0,4162,0
1675,13085,1574,113,Aerogens,"Aerogens are refined and crafted into components, modules and other items.",Aerogens.png,common,1137,0,0,1137,0
1675,13086,1574,118,Platinyx,"Platinyx is refined and crafted into components, modules and other items.",Platinyx.png,uncommon,1293,0,0,1293,0
1675,13087,1574,115,Nanofluids,"Nanofluids are refined and crafted into components, modules and other items.",Nanofluids.png,common,2805,0,0,2805,0
1675,13088,1574,128,Tchaikovium,"Tchaikovium is refined and crafted into components, modules and other items.",Tchaikovium.png,rare,1873,0,0,1873,0
1676,3353,1575,118,Platinyx,"Platinyx is refined and crafted into components, modules and other items.",Platinyx.png,uncommon,5431,0,0,5431,0
1676,10001,1575,128,Tchaikovium,"Tchaikovium is refined and crafted into components, modules and other items.",Tchaikovium.png,rare,766,0,0,766,0
1676,10067,1575,105,Silicates,"Silicates are refined and crafted into components, modules and other items.",Silicates.png,abundant,2202,0,0,2202,0
1676,18251,7675,118,Platinyx,"Platinyx is refined and crafted into components, modules and other items.",Platinyx.png,uncommon,1228,0,0,1228,0
1676,18349,7675,107,H2O,"H2O is refined and crafted into components, modules and other items.",H20.png,abundant,2649,0,0,2649,0
1676,18429,7675,118,Platinyx,"Platinyx is refined and crafted into components, modules and other items.",Platinyx.png,uncommon,5593,0,0,5593,0
1681,2865,1578,113,Aerogens,"Aerogens are refined and crafted into components, modules and other items.",Aerogens.png,common,1070,0,0,1070,0
1681,2866,1578,41,Xensium,"Xensium is refined and crafted into components, modules and other items.",Xensium.png,uncommon,2038,0,0,2038,0
1681,2867,1578,106,Elastomers,"Elastomers are refined and crafted into components, modules and other items.",Elastomers.png,abundant,4204,0,0,4204,0
1683,4279,1580,119,Novis Compounds,"Novis Compounds are refined and crafted into components, modules and other items.",Novis_Compound.png,uncommon,1071,0,0,1071,0
1683,7501,1580,128,Tchaikovium,"Tchaikovium is refined and crafted into components, modules and other items.",Tchaikovium.png,rare,1406,0,0,1406,0
1683,7502,1580,106,Elastomers,"Elastomers are refined and crafted into components, modules and other items.",Elastomers.png,abundant,2720,0,0,2720,0
1683,8086,1580,106,Elastomers,"Elastomers are refined and crafted into components, modules and other items.",Elastomers.png,abundant,5192,0,0,5192,0
1685,17955,1582,119,Novis Compounds,"Novis Compounds are refined and crafted into components, modules and other items.",Novis_Compound.png,uncommon,1146,0,0,1146,0
1685,17960,1582,106,Elastomers,"Elastomers are refined and crafted into components, modules and other items.",Elastomers.png,abundant,2831,0,0,2831,0
1685,18155,1582,106,Elastomers,"Elastomers are refined and crafted into components, modules and other items.",Elastomers.png,abundant,4870,0,0,4870,0
1685,18421,7682,128,Tchaikovium,"Tchaikovium is refined and crafted into components, modules and other items.",Tchaikovium.png,rare,865,0,0,865,0
1685,18489,7682,119,Novis Compounds,"Novis Compounds are refined and crafted into components, modules and other items.",Novis_Compound.png,uncommon,2328,0,0,2328,0
1685,18517,7682,114,Ectopolymers,"Ectopolymers are refined and crafted into components, modules and other items.",Ectopolymers.png,common,5676,0,0,5676,0
1687,620,1584,119,Novis Compounds,"Novis Compounds are refined and crafted into components, modules and other items.",Novis_Compound.png,uncommon,1396,0,0,1396,0
1688,20,1585,40,Polymetals,"Polymetals are refined and crafted into components, modules and other items.",Polymetals.png,common,4286,858,0,3428,858
1688,237,1585,40,Polymetals,"Polymetals are refined and crafted into components, modules and other items.",Polymetals.png,common,2979,2979,0,0,2979
1688,11653,1585,40,Polymetals,"Polymetals are refined and crafted into components, modules and other items.",Polymetals.png,common,1053,0,0,1053,0
1688,52,7685,106,Elastomers,"Elastomers are refined and crafted into components, modules and other items.",Elastomers.png,abundant,2165,2165,0,0,2165
1688,97,7685,126,Bruma Particles,"Bruma Particles are refined and crafted into components, modules and other items.",Bruma_Particle.png,rare,842,842,0,0,842
1688,189,7685,42,Base Minerals,"Base Minerals are refined and crafted into components, modules and other items.",Base_Mineral.png,abundant,4383,0,0,4383,0
1697,991,1592,128,Tchaikovium,"Tchaikovium is refined and crafted into components, modules and other items.",Tchaikovium.png,rare,690,0,0,690,0
1697,992,1592,128,Tchaikovium,"Tchaikovium is refined and crafted into components, modules and other items.",Tchaikovium.png,rare,869,0,0,869,0
1697,1054,1592,113,Aerogens,"Aerogens are refined and crafted into components, modules and other items.",Aerogens.png,common,5160,0,0,5160,0
1697,2311,1592,40,Polymetals,"Polymetals are refined and crafted into components, modules and other items.",Polymetals.png,common,2391,0,0,2391,0
1707,972,1602,110,Plutonium,"Plutonium is refined and crafted into components, modules and other items.",Plutonium.png,common,5519,0,0,5519,0
1707,1142,1602,119,Novis Compounds,"Novis Compounds are refined and crafted into components, modules and other items.",Novis_Compound.png,uncommon,1043,0,0,1043,0
1707,1176,1602,42,Base Minerals,"Base Minerals are refined and crafted into components, modules and other items.",Base_Mineral.png,abundant,2063,0,0,2063,0
1707,18033,7702,128,Tchaikovium,"Tchaikovium is refined and crafted into components, modules and other items.",Tchaikovium.png,rare,798,0,0,798,0
1707,18034,7702,106,Elastomers,"Elastomers are refined and crafted into components, modules and other items.",Elastomers.png,abundant,2820,0,0,2820,0
1707,18035,7702,107,H2O,"H2O is refined and crafted into components, modules and other items.",H20.png,abundant,5698,0,0,5698,0
1711,807,1605,110,Plutonium,"Plutonium is refined and crafted into components, modules and other items.",Plutonium.png,common,2080,0,0,2080,0
1711,813,1605,128,Tchaikovium,"Tchaikovium is refined and crafted into components, modules and other items.",Tchaikovium.png,rare,668,0,0,668,0
1711,891,1605,105,Silicates,"Silicates are refined and crafted into components, modules and other items.",Silicates.png,abundant,4705,0,0,4705,0
1711,18036,7705,119,Novis Compounds,"Novis Compounds are refined and crafted into components, modules and other items.",Novis_Compound.png,uncommon,1000,0,0,1000,0
1711,18037,7705,54,Hyperspecular Crystals,"Hyperspecular Crystals are refined and crafted into components, modules and other items.",Hyperspecular_Crystals.png,uncommon,2753,0,0,2753,0
1711,18038,7705,42,Base Minerals,"Base Minerals are refined and crafted into components, modules and other items.",Base_Mineral.png,abundant,4125,0,0,4125,0
1711,18039,7705,106,Elastomers,"Elastomers are refined and crafted into components, modules and other items.",Elastomers.png,abundant,4769,0,0,4769,0
1721,3075,1610,110,Plutonium,"Plutonium is refined and crafted into components, modules and other items.",Plutonium.png,common,2481,0,0,2481,0
1723,2868,1612,127,Microorganisms,"Microorganisms are refined and crafted into components, modules and other items.",Microorganism.png,rare,614,0,0,614,0
1723,2869,1612,41,Xensium,"Xensium is refined and crafted into components, modules and other items.",Xensium.png,uncommon,2175,0,0,2175,0
1723,2870,1612,105,Silicates,"Silicates are refined and crafted into components, modules and other items.",Silicates.png,abundant,4655,0,0,4655,0
1725,18260,1614,126,Bruma Particles,"Bruma Particles are refined and crafted into components, modules and other items.",Bruma_Particle.png,rare,864,0,0,864,0
1725,18261,1614,106,Elastomers,"Elastomers are refined and crafted into components, modules and other items.",Elastomers.png,abundant,2584,0,0,2584,0
1725,18262,1614,42,Base Minerals,"Base Minerals are refined and crafted into components, modules and other items.",Base_Mineral.png,abundant,2341,0,0,2341,0
1725,18263,1614,105,Silicates,"Silicates are refined and crafted into components, modules and other items.",Silicates.png,abundant,5095,0,0,5095,0
1726,1666,1615,107,H2O,"H2O is refined and crafted into components, modules and other items.",H20.png,abundant,6000,0,0,6000,0
1726,1775,1615,41,Xensium,"Xensium is refined and crafted into components, modules and other items.",Xensium.png,uncommon,1322,0,0,1322,0
1726,1776,1615,105,Silicates,"Silicates are refined and crafted into components, modules and other items.",Silicates.png,abundant,2895,0,0,2895,0
1726,1777,7715,52,Organic Compounds,"Organic Compounds are refined and crafted into components, modules and other items.",Organic_Compound.png,common,4877,0,0,4877,0
1728,2777,1616,114,Ectopolymers,"Ectopolymers are refined and crafted into components, modules and other items.",Ectopolymers.png,common,1005,0,0,1005,0
1728,2783,1616,40,Polymetals,"Polymetals are refined and crafted into components, modules and other items.",Polymetals.png,common,2208,0,0,2208,0
1728,2796,1616,42,Base Minerals,"Base Minerals are refined and crafted into components, modules and other items.",Base_Mineral.png,abundant,4180,0,0,4180,0
1739,44,1624,107,H2O,"H2O is refined and crafted into components, modules and other items.",H20.png,abundant,2687,0,0,2687,0
1739,190,1624,107,H2O,"H2O is refined and crafted into components, modules and other items.",H20.png,abundant,5986,0,0,5986,0
1739,1052,1624,114,Ectopolymers,"Ectopolymers are refined and crafted into components, modules and other items.",Ectopolymers.png,common,1365,0,0,1365,0
1739,2932,7724,54,Hyperspecular Crystals,"Hyperspecular Crystals are refined and crafted into components, modules and other items.",Hyperspecular_Crystals.png,uncommon,1298,0,0,1298,0
1739,4686,7724,119,Novis Compounds,"Novis Compounds are refined and crafted into components, modules and other items.",Novis_Compound.png,uncommon,2417,0,0,2417,0
1739,4795,7724,42,Base Minerals,"Base Minerals are refined and crafted into components, modules and other items.",Base_Mineral.png,abundant,5346,0,0,5346,0
1741,2776,1625,113,Aerogens,"Aerogens are refined and crafted into components, modules and other items.",Aerogens.png,common,1013,0,0,1013,0
1741,2797,1625,113,Aerogens,"Aerogens are refined and crafted into components, modules and other items.",Aerogens.png,common,2794,0,0,2794,0
1741,2833,1625,107,H2O,"H2O is refined and crafted into components, modules and other items.",H20.png,abundant,5782,1158,0,4624,1158
1743,33,1627,105,Silicates,"Silicates are refined and crafted into components, modules and other items.",Silicates.png,abundant,5468,0,0,5468,0
1743,129,7727,105,Silicates,"Silicates are refined and crafted into components, modules and other items.",Silicates.png,abundant,2256,0,0,2256,0
1743,238,7727,112,Amphoteric Substances,"Amphoteric Substances are refined and crafted into components, modules and other items.",Amphoteric_Substances.png,common,4588,4588,0,0,4588
1743,545,7727,112,Amphoteric Substances,"Amphoteric Substances are refined and crafted into components, modules and other items.",Amphoteric_Substances.png,common,1430,0,0,1430,0
1743,546,7727,112,Amphoteric Substances,"Amphoteric Substances are refined and crafted into components, modules and other items.",Amphoteric_Substances.png,common,1261,0,0,1261,0
1750,41,1631,119,Novis Compounds,"Novis Compounds are refined and crafted into components, modules and other items.",Novis_Compound.png,uncommon,1132,0,0,1132,0
1750,43,1631,106,Elastomers,"Elastomers are refined and crafted into components, modules and other items.",Elastomers.png,abundant,2939,0,0,2939,0
1750,134,1631,110,Plutonium,"Plutonium is refined and crafted into components, modules and other items.",Plutonium.png,common,5888,0,0,5888,0
1750,2106,7731,127,Microorganisms,"Microorganisms are refined and crafted into components, modules and other items.",Microorganism.png,rare,850,0,0,850,0
1750,2982,7731,119,Novis Compounds,"Novis Compounds are refined and crafted into components, modules and other items.",Novis_Compound.png,uncommon,4900,0,0,4900,0
1750,3079,7731,110,Plutonium,"Plutonium is refined and crafted into components, modules and other items.",Plutonium.png,common,2111,0,0,2111,0
1754,1432,1634,114,Ectopolymers,"Ectopolymers are refined and crafted into components, modules and other items.",Ectopolymers.png,common,1426,0,0,1426,0
1754,1433,1634,128,Tchaikovium,"Tchaikovium is refined and crafted into components, modules and other items.",Tchaikovium.png,rare,733,0,0,733,0
1754,1916,1634,114,Ectopolymers,"Ectopolymers are refined and crafted into components, modules and other items.",Ectopolymers.png,common,2989,0,0,2989,0
1754,3009,1634,105,Silicates,"Silicates are refined and crafted into components, modules and other items.",Silicates.png,abundant,5075,0,0,5075,0
1756,452,1635,128,Tchaikovium,"Tchaikovium is refined and crafted into components, modules and other items.",Tchaikovium.png,rare,663,0,0,663,0
1756,453,1635,114,Ectopolymers,"Ectopolymers are refined and crafted into components, modules and other items.",Ectopolymers.png,common,2446,0,0,2446,0
1756,814,1635,54,Hyperspecular Crystals,"Hyperspecular Crystals are refined and crafted into components, modules and other items.",Hyperspecular_Crystals.png,uncommon,5299,530,0,4769,530
1756,483,7735,114,Ectopolymers,"Ectopolymers are refined and crafted into components, modules and other items.",Ectopolymers.png,common,1147,0,0,1147,0
1756,484,7735,54,Hyperspecular Crystals,"Hyperspecular Crystals are refined and crafted into components, modules and other items.",Hyperspecular_Crystals.png,uncommon,1143,229,0,914,229
1756,1060,7735,112,Amphoteric Substances,"Amphoteric Substances are refined and crafted into components, modules and other items.",Amphoteric_Substances.png,common,2584,0,0,2584,0
1756,1842,7735,106,Elastomers,"Elastomers are refined and crafted into components, modules and other items.",Elastomers.png,abundant,5373,538,0,4835,538
1759,862,1637,119,Novis Compounds,"Novis Compounds are refined and crafted into components, modules and other items.",Novis_Compound.png,uncommon,1354,271,0,1083,271
1759,1012,1637,106,Elastomers,"Elastomers are refined and crafted into components, modules and other items.",Elastomers.png,abundant,5620,562,0,5058,562
1759,1499,1637,114,Ectopolymers,"Ectopolymers are refined and crafted into components, modules and other items.",Ectopolymers.png,common,2142,0,0,2142,0
1759,3026,7737,54,Hyperspecular Crystals,"Hyperspecular Crystals are refined and crafted into components, modules and other items.",Hyperspecular_Crystals.png,uncommon,1303,0,0,1303,0
1759,3027,7737,106,Elastomers,"Elastomers are refined and crafted into components, modules and other items.",Elastomers.png,abundant,5683,569,0,5114,569
1759,3124,7737,114,Ectopolymers,"Ectopolymers are refined and crafted into components, modules and other items.",Ectopolymers.png,common,2109,0,0,2109,0
1764,1410,1640,53,Ignis Ore,"Ignis Ore is refined and crafted into components, modules and other items.",Ignis_Ore.png,rare,829,0,0,829,0
1764,1411,1640,107,H2O,"H2O is refined and crafted into components, modules and other items.",H20.png,abundant,2271,0,0,2271,0
1764,1412,1640,109,Titanium,"Titanium is refined and crafted into components, modules and other items.",Titanium.png,common,5298,0,0,5298,0
1764,1419,7740,123,Neolysium,"Neolysium is refined and crafted into components, modules and other items.",Neolysium.png,uncommon,1197,0,0,1197,0
1764,1420,7740,53,Ignis Ore,"Ignis Ore is refined and crafted into components, modules and other items.",Ignis_Ore.png,rare,621,0,0,621,0
1764,1421,7740,109,Titanium,"Titanium is refined and crafted into components, modules and other items.",Titanium.png,common,2993,0,0,2993,0
1764,1422,7740,42,Base Minerals,"Base Minerals are refined and crafted into components, modules and other items.",Base_Mineral.png,abundant,4817,0,0,4817,0
1768,3669,1643,121,Hypoatomic Substances,"Hypoatomic Substances are refined and crafted into components, modules and other items.",Hypoatomic_Substances.png,uncommon,1266,0,0,1266,0
1768,4293,1643,110,Plutonium,"Plutonium is refined and crafted into components, modules and other items.",Plutonium.png,common,5956,0,0,5956,0
1768,8879,1643,41,Xensium,"Xensium is refined and crafted into components, modules and other items.",Xensium.png,uncommon,2736,0,0,2736,0
1768,4223,7743,121,Hypoatomic Substances,"Hypoatomic Substances are refined and crafted into components, modules and other items.",Hypoatomic_Substances.png,uncommon,4967,0,0,4967,0
1768,4376,7743,115,Nanofluids,"Nanofluids are refined and crafted into components, modules and other items.",Nanofluids.png,common,1481,0,0,1481,0
1768,4467,7743,114,Ectopolymers,"Ectopolymers are refined and crafted into components, modules and other items.",Ectopolymers.png,common,2595,0,0,2595,0
1774,3493,1647,105,Silicates,"Silicates are refined and crafted into components, modules and other items.",Silicates.png,abundant,2803,0,0,2803,0
1774,3494,1647,115,Nanofluids,"Nanofluids are refined and crafted into components, modules and other items.",Nanofluids.png,common,4450,0,0,4450,0
1774,4457,1647,53,Ignis Ore,"Ignis Ore is refined and crafted into components, modules and other items.",Ignis_Ore.png,rare,647,0,0,647,0
1774,3495,7747,121,Hypoatomic Substances,"Hypoatomic Substances are refined and crafted into components, modules and other items.",Hypoatomic_Substances.png,uncommon,2208,0,0,2208,0
1774,3496,7747,121,Hypoatomic Substances,"Hypoatomic Substances are refined and crafted into components, modules and other items.",Hypoatomic_Substances.png,uncommon,2701,0,0,2701,0
1774,9049,7747,127,Microorganisms,"Microorganisms are refined and crafted into components, modules and other items.",Microorganism.png,rare,794,0,0,794,0
1774,9050,7747,110,Plutonium,"Plutonium is refined and crafted into components, modules and other items.",Plutonium.png,common,1238,0,0,1238,0
1774,9051,7747,106,Elastomers,"Elastomers are refined and crafted into components, modules and other items.",Elastomers.png,abundant,4375,0,0,4375,0
1780,2871,1650,107,H2O,"H2O is refined and crafted into components, modules and other items.",H20.png,abundant,5573,0,0,5573,0
1780,2872,1650,127,Microorganisms,"Microorganisms are refined and crafted into components, modules and other items.",Microorganism.png,rare,672,0,0,672,0
1780,2873,1650,41,Xensium,"Xensium is refined and crafted into components, modules and other items.",Xensium.png,uncommon,2013,0,0,2013,0
1783,13069,1653,40,Polymetals,"Polymetals are refined and crafted into components, modules and other items.",Polymetals.png,common,1253,0,0,1253,0
1783,13070,1653,119,Novis Compounds,"Novis Compounds are refined and crafted into components, modules and other items.",Novis_Compound.png,uncommon,2637,0,0,2637,0
1783,13071,1653,115,Nanofluids,"Nanofluids are refined and crafted into components, modules and other items.",Nanofluids.png,common,5503,0,0,5503,0
1783,739,7753,106,Elastomers,"Elastomers are refined and crafted into components, modules and other items.",Elastomers.png,abundant,4664,0,0,4664,0
1783,13072,7753,127,Microorganisms,"Microorganisms are refined and crafted into components, modules and other items.",Microorganism.png,rare,723,0,0,723,0
1783,13073,7753,40,Polymetals,"Polymetals are refined and crafted into components, modules and other items.",Polymetals.png,common,2915,0,0,2915,0
1784,392,1654,106,Elastomers,"Elastomers are refined and crafted into components, modules and other items.",Elastomers.png,abundant,5634,0,0,5634,0
1784,393,1654,110,Plutonium,"Plutonium is refined and crafted into components, modules and other items.",Plutonium.png,common,2316,0,0,2316,0
1784,417,1654,128,Tchaikovium,"Tchaikovium is refined and crafted into components, modules and other items.",Tchaikovium.png,rare,630,0,0,630,0
1784,18040,7754,110,Plutonium,"Plutonium is refined and crafted into components, modules and other items.",Plutonium.png,common,1484,0,0,1484,0
1784,18041,7754,119,Novis Compounds,"Novis Compounds are refined and crafted into components, modules and other items.",Novis_Compound.png,uncommon,2767,0,0,2767,0
1784,18042,7754,119,Novis Compounds,"Novis Compounds are refined and crafted into components, modules and other items.",Novis_Compound.png,uncommon,2004,0,0,2004,0
1784,18043,7754,114,Ectopolymers,"Ectopolymers are refined and crafted into components, modules and other items.",Ectopolymers.png,common,4012,0,0,4012,0
1785,5182,1655,53,Ignis Ore,"Ignis Ore is refined and crafted into components, modules and other items.",Ignis_Ore.png,rare,703,0,0,703,0
1785,12225,1655,115,Nanofluids,"Nanofluids are refined and crafted into components, modules and other items.",Nanofluids.png,common,4855,0,0,4855,0
1785,13631,1655,53,Ignis Ore,"Ignis Ore is refined and crafted into components, modules and other items.",Ignis_Ore.png,rare,1641,0,0,1641,0
1786,2435,1656,128,Tchaikovium,"Tchaikovium is refined and crafted into components, modules and other items.",Tchaikovium.png,rare,747,0,0,747,0
1786,2939,1656,105,Silicates,"Silicates are refined and crafted into components, modules and other items.",Silicates.png,abundant,2949,2949,0,0,2949
1786,3129,1656,107,H2O,"H2O is refined and crafted into components, modules and other items.",H20.png,abundant,5894,1180,0,4714,1180
1787,3076,1657,113,Aerogens,"Aerogens are refined and crafted into components, modules and other items.",Aerogens.png,common,2631,0,0,2631,0
1788,1778,1658,42,Base Minerals,"Base Minerals are refined and crafted into components, modules and other items.",Base_Mineral.png,abundant,5196,0,0,5196,0
1788,1779,7758,120,Metamagnetic Ore,"Metamagnetic Ore is refined and crafted into components, modules and other items.",Metamagnetic_Ore.png,uncommon,5512,0,0,5512,0
1789,1780,1659,109,Titanium,"Titanium is refined and crafted into components, modules and other items.",Titanium.png,common,5898,0,0,5898,0
1789,1781,7759,109,Titanium,"Titanium is refined and crafted into components, modules and other items.",Titanium.png,common,4529,0,0,4529,0
1790,305,1660,123,Neolysium,"Neolysium is refined and crafted into components, modules and other items.",Neolysium.png,uncommon,1129,0,0,1129,0
1790,590,1660,123,Neolysium,"Neolysium is refined and crafted into components, modules and other items.",Neolysium.png,uncommon,2878,0,0,2878,0
1790,591,1660,42,Base Minerals,"Base Minerals are refined and crafted into components, modules and other items.",Base_Mineral.png,abundant,4863,4383,0,480,4383
1790,2506,7760,127,Microorganisms,"Microorganisms are refined and crafted into components, modules and other items.",Microorganism.png,rare,619,0,0,619,0
1790,4687,7760,107,H2O,"H2O is refined and crafted into components, modules and other items.",H20.png,abundant,2874,0,0,2874,0
1790,4844,7760,107,H2O,"H2O is refined and crafted into components, modules and other items.",H20.png,abundant,4092,0,0,4092,0
1792,651,1662,110,Plutonium,"Plutonium is refined and crafted into components, modules and other items.",Plutonium.png,common,1461,0,0,1461,0
1792,652,1662,54,Hyperspecular Crystals,"Hyperspecular Crystals are refined and crafted into components, modules and other items.",Hyperspecular_Crystals.png,uncommon,1310,0,0,1310,0
1792,731,1662,106,Elastomers,"Elastomers are refined and crafted into components, modules and other items.",Elastomers.png,abundant,5979,0,0,5979,0
1792,755,1662,106,Elastomers,"Elastomers are refined and crafted into components, modules and other items.",Elastomers.png,abundant,2441,0,0,2441,0
1792,2073,7762,126,Bruma Particles,"Bruma Particles are refined and crafted into components, modules and other items.",Bruma_Particle.png,rare,805,0,0,805,0
1792,2074,7762,40,Polymetals,"Polymetals are refined and crafted into components, modules and other items.",Polymetals.png,common,2750,0,0,2750,0
1792,4270,7762,105,Silicates,"Silicates are refined and crafted into components, modules and other items.",Silicates.png,abundant,4531,0,0,4531,0
1796,2191,1663,41,Xensium,"Xensium is refined and crafted into components, modules and other items.",Xensium.png,uncommon,1129,0,0,1129,0
1796,2795,1663,119,Novis Compounds,"Novis Compounds are refined and crafted into components, modules and other items.",Novis_Compound.png,uncommon,2192,0,0,2192,0
1796,4354,1663,105,Silicates,"Silicates are refined and crafted into components, modules and other items.",Silicates.png,abundant,4494,0,0,4494,0
1800,200,1665,112,Amphoteric Substances,"Amphoteric Substances are refined and crafted into components, modules and other items.",Amphoteric_Substances.png,common,1042,0,0,1042,0
1800,259,1665,42,Base Minerals,"Base Minerals are refined and crafted into components, modules and other items.",Base_Mineral.png,abundant,4887,0,0,4887,0
1800,352,1665,105,Silicates,"Silicates are refined and crafted into components, modules and other items.",Silicates.png,abundant,2831,0,0,2831,0
1800,426,7765,120,Metamagnetic Ore,"Metamagnetic Ore is refined and crafted into components, modules and other items.",Metamagnetic_Ore.png,uncommon,2882,0,0,2882,0
1800,549,7765,126,Bruma Particles,"Bruma Particles are refined and crafted into components, modules and other items.",Bruma_Particle.png,rare,778,0,0,778,0
1800,931,7765,105,Silicates,"Silicates are refined and crafted into components, modules and other items.",Silicates.png,abundant,5930,0,0,5930,0
1804,3910,1668,106,Elastomers,"Elastomers are refined and crafted into components, modules and other items.",Elastomers.png,abundant,4790,479,0,4311,479
1804,17738,1668,107,H2O,"H2O is refined and crafted into components, modules and other items.",H20.png,abundant,2870,0,0,2870,0
1804,17739,1668,114,Ectopolymers,"Ectopolymers are refined and crafted into components, modules and other items.",Ectopolymers.png,common,2762,0,0,2762,0
1804,17745,1668,119,Novis Compounds,"Novis Compounds are refined and crafted into components, modules and other items.",Novis_Compound.png,uncommon,1135,0,0,1135,0
1804,3916,7768,110,Plutonium,"Plutonium is refined and crafted into components, modules and other items.",Plutonium.png,common,4232,0,0,4232,0
1804,17920,7768,53,Ignis Ore,"Ignis Ore is refined and crafted into components, modules and other items.",Ignis_Ore.png,rare,638,0,0,638,0
1804,17921,7768,114,Ectopolymers,"Ectopolymers are refined and crafted into components, modules and other items.",Ectopolymers.png,common,1140,0,0,1140,0
1811,306,1672,54,Hyperspecular Crystals,"Hyperspecular Crystals are refined and crafted into components, modules and other items.",Hyperspecular_Crystals.png,uncommon,1153,0,0,1153,0
1811,592,1672,123,Neolysium,"Neolysium is refined and crafted into components, modules and other items.",Neolysium.png,uncommon,2640,0,0,2640,0
1811,664,1672,123,Neolysium,"Neolysium is refined and crafted into components, modules and other items.",Neolysium.png,uncommon,5529,0,0,5529,0
1811,2539,7772,110,Plutonium,"Plutonium is refined and crafted into components, modules and other items.",Plutonium.png,common,1364,0,0,1364,0
1811,4702,7772,54,Hyperspecular Crystals,"Hyperspecular Crystals are refined and crafted into components, modules and other items.",Hyperspecular_Crystals.png,uncommon,2263,0,0,2263,0
1811,4703,7772,109,Titanium,"Titanium is refined and crafted into components, modules and other items.",Titanium.png,common,4811,0,0,4811,0
1818,4517,1676,115,Nanofluids,"Nanofluids are refined and crafted into components, modules and other items.",Nanofluids.png,common,1421,0,0,1421,0
1818,4518,1676,114,Ectopolymers,"Ectopolymers are refined and crafted into components, modules and other items.",Ectopolymers.png,common,1135,0,0,1135,0
1818,4519,1676,109,Titanium,"Titanium is refined and crafted into components, modules and other items.",Titanium.png,common,2543,0,0,2543,0
1818,4520,1676,106,Elastomers,"Elastomers are refined and crafted into components, modules and other items.",Elastomers.png,abundant,5718,0,0,5718,0
1819,975,1677,42,Base Minerals,"Base Minerals are refined and crafted into components, modules and other items.",Base_Mineral.png,abundant,5425,0,0,5425,0
1819,1044,1677,110,Plutonium,"Plutonium is refined and crafted into components, modules and other items.",Plutonium.png,common,2934,0,0,2934,0
1819,1319,1677,128,Tchaikovium,"Tchaikovium is refined and crafted into components, modules and other items.",Tchaikovium.png,rare,833,0,0,833,0
1819,1320,1677,120,Metamagnetic Ore,"Metamagnetic Ore is refined and crafted into components, modules and other items.",Metamagnetic_Ore.png,uncommon,1165,0,0,1165,0
1819,2307,7777,105,Silicates,"Silicates are refined and crafted into components, modules and other items.",Silicates.png,abundant,2441,0,0,2441,0
1819,19240,7777,113,Aerogens,"Aerogens are refined and crafted into components, modules and other items.",Aerogens.png,common,5998,0,0,5998,0
1824,63,1682,126,Bruma Particles,"Bruma Particles are refined and crafted into components, modules and other items.",Bruma_Particle.png,rare,774,0,0,774,0
1824,429,1682,54,Hyperspecular Crystals,"Hyperspecular Crystals are refined and crafted into components, modules and other items.",Hyperspecular_Crystals.png,uncommon,2674,0,0,2674,0
1824,430,1682,42,Base Minerals,"Base Minerals are refined and crafted into components, modules and other items.",Base_Mineral.png,abundant,2957,0,0,2957,0
1824,665,1682,107,H2O,"H2O is refined and crafted into components, modules and other items.",H20.png,abundant,4758,0,0,4758,0
1824,2520,7782,54,Hyperspecular Crystals,"Hyperspecular Crystals are refined and crafted into components, modules and other items.",Hyperspecular_Crystals.png,uncommon,1394,0,0,1394,0
1824,3106,7782,123,Neolysium,"Neolysium is refined and crafted into components, modules and other items.",Neolysium.png,uncommon,2219,0,0,2219,0
1824,3107,7782,126,Bruma Particles,"Bruma Particles are refined and crafted into components, modules and other items.",Bruma_Particle.png,rare,1533,0,0,1533,0
1824,4724,7782,105,Silicates,"Silicates are refined and crafted into components, modules and other items.",Silicates.png,abundant,5775,0,0,5775,0
1833,2540,1689,117,Yprasium,"Yprasium is refined and crafted into components, modules and other items.",Yprasium.png,uncommon,1258,0,0,1258,0
1833,2541,1689,105,Silicates,"Silicates are refined and crafted into components, modules and other items.",Silicates.png,abundant,4113,0,0,4113,0
1833,2940,1689,52,Organic Compounds,"Organic Compounds are refined and crafted into components, modules and other items.",Organic_Compound.png,common,2221,834,0,1387,834
1834,740,7790,106,Elastomers,"Elastomers are refined and crafted into components, modules and other items.",Elastomers.png,abundant,5335,0,0,5335,0
1835,2319,1691,118,Platinyx,"Platinyx is refined and crafted into components, modules and other items.",Platinyx.png,uncommon,1247,0,0,1247,0
1835,4364,1691,110,Plutonium,"Plutonium is refined and crafted into components, modules and other items.",Plutonium.png,common,2368,0,0,2368,0
1835,4499,1691,110,Plutonium,"Plutonium is refined and crafted into components, modules and other items.",Plutonium.png,common,5877,0,0,5877,0
1841,11617,1695,118,Platinyx,"Platinyx is refined and crafted into components, modules and other items.",Platinyx.png,uncommon,1037,0,0,1037,0
1841,12145,1695,120,Metamagnetic Ore,"Metamagnetic Ore is refined and crafted into components, modules and other items.",Metamagnetic_Ore.png,uncommon,2544,0,0,2544,0
1841,12310,1695,118,Platinyx,"Platinyx is refined and crafted into components, modules and other items.",Platinyx.png,uncommon,4088,0,0,4088,0
1843,2874,1697,109,Titanium,"Titanium is refined and crafted into components, modules and other items.",Titanium.png,common,1170,0,0,1170,0
1843,2875,1697,106,Elastomers,"Elastomers are refined and crafted into components, modules and other items.",Elastomers.png,abundant,2953,0,0,2953,0
1843,2876,1697,106,Elastomers,"Elastomers are refined and crafted into components, modules and other items.",Elastomers.png,abundant,5066,0,0,5066,0
1847,15579,1700,105,Silicates,"Silicates are refined and crafted into components, modules and other items.",Silicates.png,abundant,4080,0,0,4080,0
1848,5,1701,114,Ectopolymers,"Ectopolymers are refined and crafted into components, modules and other items.",Ectopolymers.png,common,2642,0,0,2642,0
1848,26,1701,106,Elastomers,"Elastomers are refined and crafted into components, modules and other items.",Elastomers.png,abundant,5033,0,0,5033,0
1848,141,1701,119,Novis Compounds,"Novis Compounds are refined and crafted into components, modules and other items.",Novis_Compound.png,uncommon,1138,0,0,1138,0
1848,172,7801,42,Base Minerals,"Base Minerals are refined and crafted into components, modules and other items.",Base_Mineral.png,abundant,4869,0,0,4869,0
1848,203,7801,106,Elastomers,"Elastomers are refined and crafted into components, modules and other items.",Elastomers.png,abundant,2468,0,0,2468,0
1848,204,7801,128,Tchaikovium,"Tchaikovium is refined and crafted into components, modules and other items.",Tchaikovium.png,rare,1890,0,0,1890,0
1855,683,1707,118,Platinyx,"Platinyx is refined and crafted into components, modules and other items.",Platinyx.png,uncommon,1237,0,0,1237,0
1855,732,1707,107,H2O,"H2O is refined and crafted into components, modules and other items.",H20.png,abundant,5590,0,0,5590,0
1855,733,1707,105,Silicates,"Silicates are refined and crafted into components, modules and other items.",Silicates.png,abundant,4660,0,0,4660,0
1855,770,1707,105,Silicates,"Silicates are refined and crafted into components, modules and other items.",Silicates.png,abundant,2273,0,0,2273,0
1855,2075,7807,128,Tchaikovium,"Tchaikovium is refined and crafted into components, modules and other items.",Tchaikovium.png,rare,652,393,0,259,393
1855,4182,7807,105,Silicates,"Silicates are refined and crafted into components, modules and other items.",Silicates.png,abundant,2229,0,0,2229,0
1855,4183,7807,120,Metamagnetic Ore,"Metamagnetic Ore is refined and crafted into components, modules and other items.",Metamagnetic_Ore.png,uncommon,5648,0,0,5648,0
1856,2390,1708,41,Xensium,"Xensium is refined and crafted into components, modules and other items.",Xensium.png,uncommon,1473,0,0,1473,0
1856,2391,1708,106,Elastomers,"Elastomers are refined and crafted into components, modules and other items.",Elastomers.png,abundant,4300,0,0,4300,0
1856,3543,1708,112,Amphoteric Substances,"Amphoteric Substances are refined and crafted into components, modules and other items.",Amphoteric_Substances.png,common,2617,0,0,2617,0
1857,313,1709,40,Polymetals,"Polymetals are refined and crafted into components, modules and other items.",Polymetals.png,common,2698,0,0,2698,0
1857,314,1709,107,H2O,"H2O is refined and crafted into components, modules and other items.",H20.png,abundant,5738,0,0,5738,0
1857,869,1709,128,Tchaikovium,"Tchaikovium is refined and crafted into components, modules and other items.",Tchaikovium.png,rare,874,0,0,874,0
1857,2574,7809,128,Tchaikovium,"Tchaikovium is refined and crafted into components, modules and other items.",Tchaikovium.png,rare,825,0,0,825,0
1857,4704,7809,120,Metamagnetic Ore,"Metamagnetic Ore is refined and crafted into components, modules and other items.",Metamagnetic_Ore.png,uncommon,2369,0,0,2369,0
1857,5018,7809,105,Silicates,"Silicates are refined and crafted into components, modules and other items.",Silicates.png,abundant,5399,0,0,5399,0
1860,3271,1711,128,Tchaikovium,"Tchaikovium is refined and crafted into components, modules and other items.",Tchaikovium.png,rare,708,0,0,708,0
1860,3272,1711,107,H2O,"H2O is refined and crafted into components, modules and other items.",H20.png,abundant,2816,0,0,2816,0
1860,3273,1711,42,Base Minerals,"Base Minerals are refined and crafted into components, modules and other items.",Base_Mineral.png,abundant,4016,0,0,4016,0
1861,16701,1712,127,Microorganisms,"Microorganisms are refined and crafted into components, modules and other items.",Microorganism.png,rare,879,0,0,879,0
1861,16702,1712,115,Nanofluids,"Nanofluids are refined and crafted into components, modules and other items.",Nanofluids.png,common,2940,0,0,2940,0
1861,16704,1712,106,Elastomers,"Elastomers are refined and crafted into components, modules and other items.",Elastomers.png,abundant,5488,0,0,5488,0
1862,46,1713,54,Hyperspecular Crystals,"Hyperspecular Crystals are refined and crafted into components, modules and other items.",Hyperspecular_Crystals.png,uncommon,1112,0,0,1112,0
1862,54,1713,113,Aerogens,"Aerogens are refined and crafted into components, modules and other items.",Aerogens.png,common,2473,0,0,2473,0
1862,338,1713,42,Base Minerals,"Base Minerals are refined and crafted into components, modules and other items.",Base_Mineral.png,abundant,4250,0,0,4250,0
1862,778,7813,113,Aerogens,"Aerogens are refined and crafted into components, modules and other items.",Aerogens.png,common,2023,0,0,2023,0
1862,3535,7813,54,Hyperspecular Crystals,"Hyperspecular Crystals are refined and crafted into components, modules and other items.",Hyperspecular_Crystals.png,uncommon,1362,0,0,1362,0
1862,3536,7813,113,Aerogens,"Aerogens are refined and crafted into components, modules and other items.",Aerogens.png,common,5937,0,0,5937,0
1865,5117,1715,123,Neolysium,"Neolysium is refined and crafted into components, modules and other items.",Neolysium.png,uncommon,1438,0,0,1438,0
1865,5118,1715,54,Hyperspecular Crystals,"Hyperspecular Crystals are refined and crafted into components, modules and other items.",Hyperspecular_Crystals.png,uncommon,2765,0,0,2765,0
1869,4482,1717,54,Hyperspecular Crystals,"Hyperspecular Crystals are refined and crafted into components, modules and other items.",Hyperspecular_Crystals.png,uncommon,1144,0,0,1144,0
1869,4554,1717,42,Base Minerals,"Base Minerals are refined and crafted into components, modules and other items.",Base_Mineral.png,abundant,2724,0,0,2724,0
1869,4563,1717,42,Base Minerals,"Base Minerals are refined and crafted into components, modules and other items.",Base_Mineral.png,abundant,5628,2252,0,3376,2252
1869,4555,7817,114,Ectopolymers,"Ectopolymers are refined and crafted into components, modules and other items.",Ectopolymers.png,common,2218,0,0,2218,0
1869,4601,7817,106,Elastomers,"Elastomers are refined and crafted into components, modules and other items.",Elastomers.png,abundant,4742,0,0,4742,0
1869,4773,7817,128,Tchaikovium,"Tchaikovium is refined and crafted into components, modules and other items.",Tchaikovium.png,rare,819,0,0,819,0
1870,1784,1718,110,Plutonium,"Plutonium is refined and crafted into components, modules and other items.",Plutonium.png,common,5613,0,0,5613,0
1873,1407,1720,115,Nanofluids,"Nanofluids are refined and crafted into components, modules and other items.",Nanofluids.png,common,1420,0,0,1420,0
1873,1408,1720,52,Organic Compounds,"Organic Compounds are refined and crafted into components, modules and other items.",Organic_Compound.png,common,2987,0,0,2987,0
1873,1409,1720,105,Silicates,"Silicates are refined and crafted into components, modules and other items.",Silicates.png,abundant,5063,0,0,5063,0
1873,1423,7820,121,Hypoatomic Substances,"Hypoatomic Substances are refined and crafted into components, modules and other items.",Hypoatomic_Substances.png,uncommon,1497,0,0,1497,0
1873,1424,7820,106,Elastomers,"Elastomers are refined and crafted into components, modules and other items.",Elastomers.png,abundant,2896,0,0,2896,0
1873,1425,7820,107,H2O,"H2O is refined and crafted into components, modules and other items.",H20.png,abundant,4341,0,0,4341,0
1880,3274,1723,54,Hyperspecular Crystals,"Hyperspecular Crystals are refined and crafted into components, modules and other items.",Hyperspecular_Crystals.png,uncommon,1106,0,0,1106,0
1880,3275,1723,113,Aerogens,"Aerogens are refined and crafted into components, modules and other items.",Aerogens.png,common,2864,0,0,2864,0
1880,3276,1723,106,Elastomers,"Elastomers are refined and crafted into components, modules and other items.",Elastomers.png,abundant,4470,0,0,4470,0
1881,536,1724,128,Tchaikovium,"Tchaikovium is refined and crafted into components, modules and other items.",Tchaikovium.png,rare,1723,0,0,1723,0
1889,3667,1729,115,Nanofluids,"Nanofluids are refined and crafted into components, modules and other items.",Nanofluids.png,common,1459,0,0,1459,0
1889,3668,1729,127,Microorganisms,"Microorganisms are refined and crafted into components, modules and other items.",Microorganism.png,rare,787,0,0,787,0
1889,4229,1729,107,H2O,"H2O is refined and crafted into components, modules and other items.",H20.png,abundant,5609,0,0,5609,0
1889,9070,1729,112,Amphoteric Substances,"Amphoteric Substances are refined and crafted into components, modules and other items.",Amphoteric_Substances.png,common,2327,0,0,2327,0
1889,4228,7829,115,Nanofluids,"Nanofluids are refined and crafted into components, modules and other items.",Nanofluids.png,common,4660,0,0,4660,0
1889,4468,7829,115,Nanofluids,"Nanofluids are refined and crafted into components, modules and other items.",Nanofluids.png,common,1354,0,0,1354,0
1889,4469,7829,115,Nanofluids,"Nanofluids are refined and crafted into components, modules and other items.",Nanofluids.png,common,1107,0,0,1107,0
1889,8880,7829,115,Nanofluids,"Nanofluids are refined and crafted into components, modules and other items.",Nanofluids.png,common,2170,0,0,2170,0
1896,507,1732,128,Tchaikovium,"Tchaikovium is refined and crafted into components, modules and other items.",Tchaikovium.png,rare,603,0,0,603,0
1896,508,1732,128,Tchaikovium,"Tchaikovium is refined and crafted into components, modules and other items.",Tchaikovium.png,rare,710,0,0,710,0
1896,643,1732,42,Base Minerals,"Base Minerals are refined and crafted into components, modules and other items.",Base_Mineral.png,abundant,2580,0,0,2580,0
1896,3018,1732,105,Silicates,"Silicates are refined and crafted into components, modules and other items.",Silicates.png,abundant,5413,0,0,5413,0
1896,3087,7832,54,Hyperspecular Crystals,"Hyperspecular Crystals are refined and crafted into components, modules and other items.",Hyperspecular_Crystals.png,uncommon,1425,0,0,1425,0
1896,9472,7832,115,Nanofluids,"Nanofluids are refined and crafted into components, modules and other items.",Nanofluids.png,common,2853,0,0,2853,0
1896,9540,7832,105,Silicates,"Silicates are refined and crafted into components, modules and other items.",Silicates.png,abundant,4369,0,0,4369,0
1896,9541,7832,114,Ectopolymers,"Ectopolymers are refined and crafted into components, modules and other items.",Ectopolymers.png,common,5926,0,0,5926,0
1897,863,1733,121,Hypoatomic Substances,"Hypoatomic Substances are refined and crafted into components, modules and other items.",Hypoatomic_Substances.png,uncommon,1195,239,0,956,239
1897,1061,1733,40,Polymetals,"Polymetals are refined and crafted into components, modules and other items.",Polymetals.png,common,2070,0,0,2070,0
1897,1062,1733,42,Base Minerals,"Base Minerals are refined and crafted into components, modules and other items.",Base_Mineral.png,abundant,5375,0,0,5375,0
1897,3043,7833,120,Metamagnetic Ore,"Metamagnetic Ore is refined and crafted into components, modules and other items.",Metamagnetic_Ore.png,uncommon,1163,0,0,1163,0
1897,3135,7833,110,Plutonium,"Plutonium is refined and crafted into components, modules and other items.",Plutonium.png,common,2261,0,0,2261,0
1897,3306,7833,128,Tchaikovium,"Tchaikovium is refined and crafted into components, modules and other items.",Tchaikovium.png,rare,3350,0,0,3350,0
1903,7426,7838,128,Tchaikovium,"Tchaikovium is refined and crafted into components, modules and other items.",Tchaikovium.png,rare,822,0,0,822,0
1903,8057,7838,40,Polymetals,"Polymetals are refined and crafted into components, modules and other items.",Polymetals.png,common,2223,0,0,2223,0
1903,8058,7838,105,Silicates,"Silicates are refined and crafted into components, modules and other items.",Silicates.png,abundant,4449,0,0,4449,0
1904,1942,1739,121,Hypoatomic Substances,"Hypoatomic Substances are refined and crafted into components, modules and other items.",Hypoatomic_Substances.png,uncommon,1406,0,0,1406,0
1904,2012,1739,109,Titanium,"Titanium is refined and crafted into components, modules and other items.",Titanium.png,common,4748,0,0,4748,0
1904,2271,1739,115,Nanofluids,"Nanofluids are refined and crafted into components, modules and other items.",Nanofluids.png,common,2742,0,0,2742,0
1904,4053,7839,123,Neolysium,"Neolysium is refined and crafted into components, modules and other items.",Neolysium.png,uncommon,1152,0,0,1152,0
1904,4054,7839,54,Hyperspecular Crystals,"Hyperspecular Crystals are refined and crafted into components, modules and other items.",Hyperspecular_Crystals.png,uncommon,2830,0,0,2830,0
1904,4055,7839,114,Ectopolymers,"Ectopolymers are refined and crafted into components, modules and other items.",Ectopolymers.png,common,5928,0,0,5928,0
1909,47,1741,52,Organic Compounds,"Organic Compounds are refined and crafted into components, modules and other items.",Organic_Compound.png,common,1080,648,0,432,648
1909,339,1741,107,H2O,"H2O is refined and crafted into components, modules and other items.",H20.png,abundant,4104,0,0,4104,0
1909,437,1741,118,Platinyx,"Platinyx is refined and crafted into components, modules and other items.",Platinyx.png,uncommon,2781,0,0,2781,0
1909,779,7841,109,Titanium,"Titanium is refined and crafted into components, modules and other items.",Titanium.png,common,2029,0,0,2029,0
1909,4173,7841,117,Yprasium,"Yprasium is refined and crafted into components, modules and other items.",Yprasium.png,uncommon,1063,0,0,1063,0
1909,4174,7841,107,H2O,"H2O is refined and crafted into components, modules and other items.",H20.png,abundant,5566,0,0,5566,0
1912,8614,1743,128,Tchaikovium,"Tchaikovium is refined and crafted into components, modules and other items.",Tchaikovium.png,rare,682,0,0,682,0
1917,11353,1745,54,Hyperspecular Crystals,"Hyperspecular Crystals are refined and crafted into components, modules and other items.",Hyperspecular_Crystals.png,uncommon,1216,0,0,1216,0
1917,11452,1745,123,Neolysium,"Neolysium is refined and crafted into components, modules and other items.",Neolysium.png,uncommon,2398,0,0,2398,0
1917,11518,1745,42,Base Minerals,"Base Minerals are refined and crafted into components, modules and other items.",Base_Mineral.png,abundant,5955,0,0,5955,0
1917,11519,1745,105,Silicates,"Silicates are refined and crafted into components, modules and other items.",Silicates.png,abundant,5585,0,0,5585,0
1923,12013,1748,118,Platinyx,"Platinyx is refined and crafted into components, modules and other items.",Platinyx.png,uncommon,1322,0,0,1322,0
1923,12014,1748,120,Metamagnetic Ore,"Metamagnetic Ore is refined and crafted into components, modules and other items.",Metamagnetic_Ore.png,uncommon,2889,0,0,2889,0
1923,12015,1748,40,Polymetals,"Polymetals are refined and crafted into components, modules and other items.",Polymetals.png,common,4801,0,0,4801,0
1923,12016,7848,118,Platinyx,"Platinyx is refined and crafted into components, modules and other items.",Platinyx.png,uncommon,1008,0,0,1008,0
1923,12017,7848,110,Plutonium,"Plutonium is refined and crafted into components, modules and other items.",Plutonium.png,common,2177,0,0,2177,0
1923,12018,7848,110,Plutonium,"Plutonium is refined and crafted into components, modules and other items.",Plutonium.png,common,5090,0,0,5090,0
1925,14640,1749,117,Yprasium,"Yprasium is refined and crafted into components, modules and other items.",Yprasium.png,uncommon,2728,0,0,2728,0
1926,10101,1750,126,Bruma Particles,"Bruma Particles are refined and crafted into components, modules and other items.",Bruma_Particle.png,rare,848,0,0,848,0
1926,10199,1750,110,Plutonium,"Plutonium is refined and crafted into components, modules and other items.",Plutonium.png,common,2733,0,0,2733,0
1926,10264,1750,106,Elastomers,"Elastomers are refined and crafted into components, modules and other items.",Elastomers.png,abundant,5876,0,0,5876,0
1926,18490,7850,117,Yprasium,"Yprasium is refined and crafted into components, modules and other items.",Yprasium.png,uncommon,1358,0,0,1358,0
1926,18578,7850,115,Nanofluids,"Nanofluids are refined and crafted into components, modules and other items.",Nanofluids.png,common,2211,0,0,2211,0
1926,18679,7850,113,Aerogens,"Aerogens are refined and crafted into components, modules and other items.",Aerogens.png,common,4391,0,0,4391,0
1930,984,1752,106,Elastomers,"Elastomers are refined and crafted into components, modules and other items.",Elastomers.png,abundant,5682,0,0,5682,0
1930,1143,1752,53,Ignis Ore,"Ignis Ore is refined and crafted into components, modules and other items.",Ignis_Ore.png,rare,743,0,0,743,0
1930,1177,1752,114,Ectopolymers,"Ectopolymers are refined and crafted into components, modules and other items.",Ectopolymers.png,common,2310,0,0,2310,0
1930,18044,7852,110,Plutonium,"Plutonium is refined and crafted into components, modules and other items.",Plutonium.png,common,1098,0,0,1098,0
1930,18045,7852,110,Plutonium,"Plutonium is refined and crafted into components, modules and other items.",Plutonium.png,common,2671,0,0,2671,0
1930,18046,7852,105,Silicates,"Silicates are refined and crafted into components, modules and other items.",Silicates.png,abundant,4711,0,0,4711,0
1930,18047,7852,113,Aerogens,"Aerogens are refined and crafted into components, modules and other items.",Aerogens.png,common,4938,0,0,4938,0
1933,6007,1754,123,Neolysium,"Neolysium is refined and crafted into components, modules and other items.",Neolysium.png,uncommon,1382,0,0,1382,0
1933,12244,1754,107,H2O,"H2O is refined and crafted into components, modules and other items.",H20.png,abundant,5948,0,0,5948,0
1933,13632,1754,42,Base Minerals,"Base Minerals are refined and crafted into components, modules and other items.",Base_Mineral.png,abundant,2040,0,0,2040,0
1933,13633,1754,120,Metamagnetic Ore,"Metamagnetic Ore is refined and crafted into components, modules and other items.",Metamagnetic_Ore.png,uncommon,2442,0,0,2442,0
1935,6700,1756,112,Amphoteric Substances,"Amphoteric Substances are refined and crafted into components, modules and other items.",Amphoteric_Substances.png,common,2601,0,0,2601,0
1938,6733,1759,119,Novis Compounds,"Novis Compounds are refined and crafted into components, modules and other items.",Novis_Compound.png,uncommon,2348,0,0,2348,0
1938,20532,1759,128,Tchaikovium,"Tchaikovium is refined and crafted into components, modules and other items.",Tchaikovium.png,rare,711,0,0,711,0
1939,10366,1760,118,Platinyx,"Platinyx is refined and crafted into components, modules and other items.",Platinyx.png,uncommon,1193,0,0,1193,0
1939,10678,1760,40,Polymetals,"Polymetals are refined and crafted into components, modules and other items.",Polymetals.png,common,5840,0,0,5840,0
1939,11419,1760,120,Metamagnetic Ore,"Metamagnetic Ore is refined and crafted into components, modules and other items.",Metamagnetic_Ore.png,uncommon,2904,0,0,2904,0
1939,19504,7860,110,Plutonium,"Plutonium is refined and crafted into components, modules and other items.",Plutonium.png,common,2469,0,0,2469,0
1945,1681,1764,42,Base Minerals,"Base Minerals are refined and crafted into components, modules and other items.",Base_Mineral.png,abundant,4782,0,0,4782,0
1945,1695,1764,110,Plutonium,"Plutonium is refined and crafted into components, modules and other items.",Plutonium.png,common,1461,0,0,1461,0
1945,1696,1764,128,Tchaikovium,"Tchaikovium is refined and crafted into components, modules and other items.",Tchaikovium.png,rare,741,0,0,741,0
1945,1699,1764,107,H2O,"H2O is refined and crafted into components, modules and other items.",H20.png,abundant,2444,0,0,2444,0
1954,158,1768,115,Nanofluids,"Nanofluids are refined and crafted into components, modules and other items.",Nanofluids.png,common,4327,0,0,4327,0
1954,215,1768,127,Microorganisms,"Microorganisms are refined and crafted into components, modules and other items.",Microorganism.png,rare,726,0,0,726,0
1954,216,1768,52,Organic Compounds,"Organic Compounds are refined and crafted into components, modules and other items.",Organic_Compound.png,common,2521,0,0,2521,0
1954,1782,7868,107,H2O,"H2O is refined and crafted into components, modules and other items.",H20.png,abundant,5660,0,0,5660,0
1954,1783,7868,42,Base Minerals,"Base Minerals are refined and crafted into components, modules and other items.",Base_Mineral.png,abundant,5948,0,0,5948,0
1957,924,1770,115,Nanofluids,"Nanofluids are refined and crafted into components, modules and other items.",Nanofluids.png,common,2653,0,0,2653,0
1957,939,1770,115,Nanofluids,"Nanofluids are refined and crafted into components, modules and other items.",Nanofluids.png,common,1192,0,0,1192,0
1957,940,1770,126,Bruma Particles,"Bruma Particles are refined and crafted into components, modules and other items.",Bruma_Particle.png,rare,888,0,0,888,0
1957,941,1770,105,Silicates,"Silicates are refined and crafted into components, modules and other items.",Silicates.png,abundant,4332,0,0,4332,0
1957,942,1770,105,Silicates,"Silicates are refined and crafted into components, modules and other items.",Silicates.png,abundant,5912,0,0,5912,0
1958,756,1771,109,Titanium,"Titanium is refined and crafted into components, modules and other items.",Titanium.png,common,1302,0,0,1302,0
1958,757,1771,105,Silicates,"Silicates are refined and crafted into components, modules and other items.",Silicates.png,abundant,2675,0,0,2675,0
1958,758,1771,105,Silicates,"Silicates are refined and crafted into components, modules and other items.",Silicates.png,abundant,5213,0,0,5213,0
1958,759,7871,53,Ignis Ore,"Ignis Ore is refined and crafted into components, modules and other items.",Ignis_Ore.png,rare,605,0,0,605,0
1958,760,7871,112,Amphoteric Substances,"Amphoteric Substances are refined and crafted into components, modules and other items.",Amphoteric_Substances.png,common,2497,0,0,2497,0
1958,761,7871,109,Titanium,"Titanium is refined and crafted into components, modules and other items.",Titanium.png,common,2330,0,0,2330,0
1958,762,7871,42,Base Minerals,"Base Minerals are refined and crafted into components, modules and other items.",Base_Mineral.png,abundant,4103,0,0,4103,0
1960,4719,1772,112,Amphoteric Substances,"Amphoteric Substances are refined and crafted into components, modules and other items.",Amphoteric_Substances.png,common,1315,0,0,1315,0
1961,3372,1773,120,Metamagnetic Ore,"Metamagnetic Ore is refined and crafted into components, modules and other items.",Metamagnetic_Ore.png,uncommon,2927,0,0,2927,0
1961,3373,1773,117,Yprasium,"Yprasium is refined and crafted into components, modules and other items.",Yprasium.png,uncommon,1261,0,0,1261,0
1961,3670,1773,114,Ectopolymers,"Ectopolymers are refined and crafted into components, modules and other items.",Ectopolymers.png,common,5331,0,0,5331,0
1963,587,7874,109,Titanium,"Titanium is refined and crafted into components, modules and other items.",Titanium.png,common,1181,0,0,1181,0
1963,588,7874,106,Elastomers,"Elastomers are refined and crafted into components, modules and other items.",Elastomers.png,abundant,5388,1078,0,4310,1078
1963,10792,7874,41,Xensium,"Xensium is refined and crafted into components, modules and other items.",Xensium.png,uncommon,2371,0,0,2371,0
1965,4556,1776,107,H2O,"H2O is refined and crafted into components, modules and other items.",H20.png,abundant,2515,2515,0,0,2515
1965,4582,1776,123,Neolysium,"Neolysium is refined and crafted into components, modules and other items.",Neolysium.png,uncommon,1274,0,0,1274,0
1965,4591,1776,107,H2O,"H2O is refined and crafted into components, modules and other items.",H20.png,abundant,5329,1599,0,3730,1599
1965,4557,7876,109,Titanium,"Titanium is refined and crafted into components, modules and other items.",Titanium.png,common,2977,0,0,2977,0
1965,4641,7876,119,Novis Compounds,"Novis Compounds are refined and crafted into components, modules and other items.",Novis_Compound.png,uncommon,1274,0,0,1274,0
1965,4675,7876,107,H2O,"H2O is refined and crafted into components, modules and other items.",H20.png,abundant,5696,0,0,5696,0
1966,17308,1777,53,Ignis Ore,"Ignis Ore is refined and crafted into components, modules and other items.",Ignis_Ore.png,rare,685,0,0,685,0
1966,17309,1777,123,Neolysium,"Neolysium is refined and crafted into components, modules and other items.",Neolysium.png,uncommon,1254,0,0,1254,0
1966,17310,1777,107,H2O,"H2O is refined and crafted into components, modules and other items.",H20.png,abundant,2104,0,0,2104,0
1966,17311,1777,42,Base Minerals,"Base Minerals are refined and crafted into components, modules and other items.",Base_Mineral.png,abundant,2914,0,0,2914,0
1966,17312,1777,105,Silicates,"Silicates are refined and crafted into components, modules and other items.",Silicates.png,abundant,5617,0,0,5617,0
1969,3072,1779,113,Aerogens,"Aerogens are refined and crafted into components, modules and other items.",Aerogens.png,common,2829,0,0,2829,0
1969,3073,1779,117,Yprasium,"Yprasium is refined and crafted into components, modules and other items.",Yprasium.png,uncommon,2601,0,0,2601,0
1969,3074,1779,106,Elastomers,"Elastomers are refined and crafted into components, modules and other items.",Elastomers.png,abundant,4990,0,0,4990,0
1970,2813,1780,119,Novis Compounds,"Novis Compounds are refined and crafted into components, modules and other items.",Novis_Compound.png,uncommon,1173,235,0,938,235
1970,3103,1780,40,Polymetals,"Polymetals are refined and crafted into components, modules and other items.",Polymetals.png,common,2188,0,0,2188,0
1970,4817,1780,105,Silicates,"Silicates are refined and crafted into components, modules and other items.",Silicates.png,abundant,4564,0,0,4564,0
1973,983,1782,113,Aerogens,"Aerogens are refined and crafted into components, modules and other items.",Aerogens.png,common,1330,0,0,1330,0
1973,1500,1782,106,Elastomers,"Elastomers are refined and crafted into components, modules and other items.",Elastomers.png,abundant,5480,548,0,4932,548
1973,1668,1782,107,H2O,"H2O is refined and crafted into components, modules and other items.",H20.png,abundant,2792,349,0,2443,349
1973,3317,7882,107,H2O,"H2O is refined and crafted into components, modules and other items.",H20.png,abundant,5701,571,0,5130,571
1973,3329,7882,54,Hyperspecular Crystals,"Hyperspecular Crystals are refined and crafted into components, modules and other items.",Hyperspecular_Crystals.png,uncommon,1313,0,0,1313,0
1973,3330,7882,123,Neolysium,"Neolysium is refined and crafted into components, modules and other items.",Neolysium.png,uncommon,1291,259,0,1032,259
1973,3344,7882,109,Titanium,"Titanium is refined and crafted into components, modules and other items.",Titanium.png,common,2325,0,0,2325,0
1973,3345,7882,123,Neolysium,"Neolysium is refined and crafted into components, modules and other items.",Neolysium.png,uncommon,2356,295,0,2061,295
1976,11716,1785,128,Tchaikovium,"Tchaikovium is refined and crafted into components, modules and other items.",Tchaikovium.png,rare,669,0,0,669,0
1976,11881,1785,113,Aerogens,"Aerogens are refined and crafted into components, modules and other items.",Aerogens.png,common,2761,0,0,2761,0
1976,11915,1785,106,Elastomers,"Elastomers are refined and crafted into components, modules and other items.",Elastomers.png,abundant,4969,0,0,4969,0
1976,19737,7885,117,Yprasium,"Yprasium is refined and crafted into components, modules and other items.",Yprasium.png,uncommon,1148,0,0,1148,0
1976,19772,7885,105,Silicates,"Silicates are refined and crafted into components, modules and other items.",Silicates.png,abundant,2058,0,0,2058,0
1976,19873,7885,115,Nanofluids,"Nanofluids are refined and crafted into components, modules and other items.",Nanofluids.png,common,5686,0,0,5686,0
1977,4521,1786,117,Yprasium,"Yprasium is refined and crafted into components, modules and other items.",Yprasium.png,uncommon,1063,0,0,1063,0
1977,4522,1786,112,Amphoteric Substances,"Amphoteric Substances are refined and crafted into components, modules and other items.",Amphoteric_Substances.png,common,2972,0,0,2972,0
1977,4523,1786,123,Neolysium,"Neolysium is refined and crafted into components, modules and other items.",Neolysium.png,uncommon,2463,0,0,2463,0
1977,4524,1786,105,Silicates,"Silicates are refined and crafted into components, modules and other items.",Silicates.png,abundant,5119,0,0,5119,0
1978,2992,1787,52,Organic Compounds,"Organic Compounds are refined and crafted into components, modules and other items.",Organic_Compound.png,common,1423,1423,0,0,1423
1978,2995,1787,115,Nanofluids,"Nanofluids are refined and crafted into components, modules and other items.",Nanofluids.png,common,2042,768,0,1274,768
1978,7619,1787,42,Base Minerals,"Base Minerals are refined and crafted into components, modules and other items.",Base_Mineral.png,abundant,4658,1864,0,2794,1864
1979,2109,1788,114,Ectopolymers,"Ectopolymers are refined and crafted into components, modules and other items.",Ectopolymers.png,common,5258,0,0,5258,0
1979,2367,1788,53,Ignis Ore,"Ignis Ore is refined and crafted into components, modules and other items.",Ignis_Ore.png,rare,618,0,0,618,0
1979,4208,1788,114,Ectopolymers,"Ectopolymers are refined and crafted into components, modules and other items.",Ectopolymers.png,common,2640,0,0,2640,0
1979,2368,7888,118,Platinyx,"Platinyx is refined and crafted into components, modules and other items.",Platinyx.png,uncommon,1259,0,0,1259,0
1979,4209,7888,113,Aerogens,"Aerogens are refined and crafted into components, modules and other items.",Aerogens.png,common,2343,0,0,2343,0
1979,4654,7888,52,Organic Compounds,"Organic Compounds are refined and crafted into components, modules and other items.",Organic_Compound.png,common,5314,0,0,5314,0
1983,11782,1790,123,Neolysium,"Neolysium is refined and crafted into components, modules and other items.",Neolysium.png,uncommon,1357,0,0,1357,0
1983,12376,1790,113,Aerogens,"Aerogens are refined and crafted into components, modules and other items.",Aerogens.png,common,2255,0,0,2255,0
1983,12508,1790,42,Base Minerals,"Base Minerals are refined and crafted into components, modules and other items.",Base_Mineral.png,abundant,4753,0,0,4753,0
1985,5149,1791,117,Yprasium,"Yprasium is refined and crafted into components, modules and other items.",Yprasium.png,uncommon,1469,0,0,1469,0
1985,5150,1791,115,Nanofluids,"Nanofluids are refined and crafted into components, modules and other items.",Nanofluids.png,common,2633,0,0,2633,0
1985,5151,1791,105,Silicates,"Silicates are refined and crafted into components, modules and other items.",Silicates.png,abundant,5456,0,0,5456,0
1999,2993,1798,126,Bruma Particles,"Bruma Particles are refined and crafted into components, modules and other items.",Bruma_Particle.png,rare,862,0,0,862,0
1999,2994,1798,107,H2O,"H2O is refined and crafted into components, modules and other items.",H20.png,abundant,2925,1464,0,1461,1464
1999,3130,1798,105,Silicates,"Silicates are refined and crafted into components, modules and other items.",Silicates.png,abundant,5017,5017,0,0,5017
2007,17313,1805,110,Plutonium,"Plutonium is refined and crafted into components, modules and other items.",Plutonium.png,common,1378,0,0,1378,0
2007,17314,1805,128,Tchaikovium,"Tchaikovium is refined and crafted into components, modules and other items.",Tchaikovium.png,rare,786,0,0,786,0
2007,17315,1805,128,Tchaikovium,"Tchaikovium is refined and crafted into components, modules and other items.",Tchaikovium.png,rare,1348,0,0,1348,0
2007,17316,1805,110,Plutonium,"Plutonium is refined and crafted into components, modules and other items.",Plutonium.png,common,4289,0,0,4289,0
2015,2877,1809,123,Neolysium,"Neolysium is refined and crafted into components, modules and other items.",Neolysium.png,uncommon,1052,0,0,1052,0
2015,2878,1809,123,Neolysium,"Neolysium is refined and crafted into components, modules and other items.",Neolysium.png,uncommon,2326,0,0,2326,0
2015,2879,1809,115,Nanofluids,"Nanofluids are refined and crafted into components, modules and other items.",Nanofluids.png,common,5156,0,0,5156,0
2016,4525,1810,114,Ectopolymers,"Ectopolymers are refined and crafted into components, modules and other items.",Ectopolymers.png,common,2750,0,0,2750,0
2016,9052,1810,53,Ignis Ore,"Ignis Ore is refined and crafted into components, modules and other items.",Ignis_Ore.png,rare,774,0,0,774,0
2016,9053,1810,106,Elastomers,"Elastomers are refined and crafted into components, modules and other items.",Elastomers.png,abundant,4281,0,0,4281,0
2019,3011,1811,40,Polymetals,"Polymetals are refined and crafted into components, modules and other items.",Polymetals.png,common,1283,0,0,1283,0
2019,5582,1811,112,Amphoteric Substances,"Amphoteric Substances are refined and crafted into components, modules and other items.",Amphoteric_Substances.png,common,4308,1293,0,3015,1293
2019,8450,1811,112,Amphoteric Substances,"Amphoteric Substances are refined and crafted into components, modules and other items.",Amphoteric_Substances.png,common,2455,0,0,2455,0
2020,17744,1812,128,Tchaikovium,"Tchaikovium is refined and crafted into components, modules and other items.",Tchaikovium.png,rare,899,0,0,899,0
2020,17752,1812,42,Base Minerals,"Base Minerals are refined and crafted into components, modules and other items.",Base_Mineral.png,abundant,5307,0,0,5307,0
2020,18258,1812,105,Silicates,"Silicates are refined and crafted into components, modules and other items.",Silicates.png,abundant,2332,0,0,2332,0
2020,18259,1812,42,Base Minerals,"Base Minerals are refined and crafted into components, modules and other items.",Base_Mineral.png,abundant,2503,0,0,2503,0
2021,877,1813,110,Plutonium,"Plutonium is refined and crafted into components, modules and other items.",Plutonium.png,common,2816,0,0,2816,0
2021,1257,1813,106,Elastomers,"Elastomers are refined and crafted into components, modules and other items.",Elastomers.png,abundant,4058,0,0,4058,0
2021,1879,1813,128,Tchaikovium,"Tchaikovium is refined and crafted into components, modules and other items.",Tchaikovium.png,rare,879,0,0,879,0
2021,1880,1813,114,Ectopolymers,"Ectopolymers are refined and crafted into components, modules and other items.",Ectopolymers.png,common,1232,0,0,1232,0
2021,2491,7913,128,Tchaikovium,"Tchaikovium is refined and crafted into components, modules and other items.",Tchaikovium.png,rare,675,0,0,675,0
2021,4334,7913,114,Ectopolymers,"Ectopolymers are refined and crafted into components, modules and other items.",Ectopolymers.png,common,2324,0,0,2324,0
2021,5017,7913,128,Tchaikovium,"Tchaikovium is refined and crafted into components, modules and other items.",Tchaikovium.png,rare,3940,0,0,3940,0
2023,98,1814,128,Tchaikovium,"Tchaikovium is refined and crafted into components, modules and other items.",Tchaikovium.png,rare,759,0,0,759,0
2023,135,1814,40,Polymetals,"Polymetals are refined and crafted into components, modules and other items.",Polymetals.png,common,2839,0,0,2839,0
2023,401,1814,42,Base Minerals,"Base Minerals are refined and crafted into components, modules and other items.",Base_Mineral.png,abundant,5103,5103,0,0,5103
2023,2030,7914,114,Ectopolymers,"Ectopolymers are refined and crafted into components, modules and other items.",Ectopolymers.png,common,1204,0,0,1204,0
2023,2488,7914,105,Silicates,"Silicates are refined and crafted into components, modules and other items.",Silicates.png,abundant,5892,0,0,5892,0
2023,2538,7914,128,Tchaikovium,"Tchaikovium is refined and crafted into components, modules and other items.",Tchaikovium.png,rare,1633,0,0,1633,0
2028,633,1819,127,Microorganisms,"Microorganisms are refined and crafted into components, modules and other items.",Microorganism.png,rare,860,0,0,860,0
2028,634,1819,127,Microorganisms,"Microorganisms are refined and crafted into components, modules and other items.",Microorganism.png,rare,736,0,0,736,0
2028,2264,1819,106,Elastomers,"Elastomers are refined and crafted into components, modules and other items.",Elastomers.png,abundant,2268,0,0,2268,0
2028,4438,1819,112,Amphoteric Substances,"Amphoteric Substances are refined and crafted into components, modules and other items.",Amphoteric_Substances.png,common,5096,0,0,5096,0
2028,4240,7919,40,Polymetals,"Polymetals are refined and crafted into components, modules and other items.",Polymetals.png,common,2864,0,0,2864,0
2028,9079,7919,106,Elastomers,"Elastomers are refined and crafted into components, modules and other items.",Elastomers.png,abundant,4015,0,0,4015,0
2028,9811,7919,41,Xensium,"Xensium is refined and crafted into components, modules and other items.",Xensium.png,uncommon,1120,0,0,1120,0
2032,10793,7922,123,Neolysium,"Neolysium is refined and crafted into components, modules and other items.",Neolysium.png,uncommon,1185,0,0,1185,0
2032,10794,7922,112,Amphoteric Substances,"Amphoteric Substances are refined and crafted into components, modules and other items.",Amphoteric_Substances.png,common,2864,0,0,2864,0
2032,10795,7922,105,Silicates,"Silicates are refined and crafted into components, modules and other items.",Silicates.png,abundant,4928,0,0,4928,0
2039,2013,1828,53,Ignis Ore,"Ignis Ore is refined and crafted into components, modules and other items.",Ignis_Ore.png,rare,759,0,0,759,0
2039,2014,1828,40,Polymetals,"Polymetals are refined and crafted into components, modules and other items.",Polymetals.png,common,4697,0,0,4697,0
2039,2272,1828,109,Titanium,"Titanium is refined and crafted into components, modules and other items.",Titanium.png,common,2069,0,0,2069,0
2039,4056,7928,41,Xensium,"Xensium is refined and crafted into components, modules and other items.",Xensium.png,uncommon,1273,0,0,1273,0
2039,4057,7928,112,Amphoteric Substances,"Amphoteric Substances are refined and crafted into components, modules and other items.",Amphoteric_Substances.png,common,2592,0,0,2592,0
2039,4058,7928,105,Silicates,"Silicates are refined and crafted into components, modules and other items.",Silicates.png,abundant,5083,0,0,5083,0
2040,1101,1829,54,Hyperspecular Crystals,"Hyperspecular Crystals are refined and crafted into components, modules and other items.",Hyperspecular_Crystals.png,uncommon,1129,0,0,1129,0
2040,1258,1829,42,Base Minerals,"Base Minerals are refined and crafted into components, modules and other items.",Base_Mineral.png,abundant,5953,0,0,5953,0
2040,1259,1829,42,Base Minerals,"Base Minerals are refined and crafted into components, modules and other items.",Base_Mineral.png,abundant,4267,0,0,4267,0
2040,1353,1829,42,Base Minerals,"Base Minerals are refined and crafted into components, modules and other items.",Base_Mineral.png,abundant,2047,0,0,2047,0
2040,2831,7929,128,Tchaikovium,"Tchaikovium is refined and crafted into components, modules and other items.",Tchaikovium.png,rare,799,0,0,799,0
2040,6305,7929,112,Amphoteric Substances,"Amphoteric Substances are refined and crafted into components, modules and other items.",Amphoteric_Substances.png,common,2401,0,0,2401,0
2040,7524,7929,54,Hyperspecular Crystals,"Hyperspecular Crystals are refined and crafted into components, modules and other items.",Hyperspecular_Crystals.png,uncommon,4176,0,0,4176,0
2041,100,1830,119,Novis Compounds,"Novis Compounds are refined and crafted into components, modules and other items.",Novis_Compound.png,uncommon,1039,0,0,1039,0
2041,175,1830,119,Novis Compounds,"Novis Compounds are refined and crafted into components, modules and other items.",Novis_Compound.png,uncommon,2922,0,0,2922,0
2041,402,1830,107,H2O,"H2O is refined and crafted into components, modules and other items.",H20.png,abundant,4627,0,0,4627,0
2041,2036,7930,53,Ignis Ore,"Ignis Ore is refined and crafted into components, modules and other items.",Ignis_Ore.png,rare,760,0,0,760,0
2041,2507,7930,42,Base Minerals,"Base Minerals are refined and crafted into components, modules and other items.",Base_Mineral.png,abundant,5120,0,0,5120,0
2041,2568,7930,106,Elastomers,"Elastomers are refined and crafted into components, modules and other items.",Elastomers.png,abundant,2244,0,0,2244,0
2044,1303,1832,109,Titanium,"Titanium is refined and crafted into components, modules and other items.",Titanium.png,common,1344,0,0,1344,0
2044,1333,1832,112,Amphoteric Substances,"Amphoteric Substances are refined and crafted into components, modules and other items.",Amphoteric_Substances.png,common,2042,0,0,2042,0
2044,1502,1832,40,Polymetals,"Polymetals are refined and crafted into components, modules and other items.",Polymetals.png,common,4581,0,0,4581,0
2044,1313,7932,42,Base Minerals,"Base Minerals are refined and crafted into components, modules and other items.",Base_Mineral.png,abundant,2404,0,0,2404,0
2044,1334,7932,109,Titanium,"Titanium is refined and crafted into components, modules and other items.",Titanium.png,common,1283,0,0,1283,0
2044,2195,7932,109,Titanium,"Titanium is refined and crafted into components, modules and other items.",Titanium.png,common,4179,0,0,4179,0
2048,608,7936,105,Silicates,"Silicates are refined and crafted into components, modules and other items.",Silicates.png,abundant,4370,0,0,4370,0
2062,309,1843,126,Bruma Particles,"Bruma Particles are refined and crafted into components, modules and other items.",Bruma_Particle.png,rare,758,0,0,758,0
2062,666,1843,115,Nanofluids,"Nanofluids are refined and crafted into components, modules and other items.",Nanofluids.png,common,2701,0,0,2701,0
2062,1006,1843,42,Base Minerals,"Base Minerals are refined and crafted into components, modules and other items.",Base_Mineral.png,abundant,5724,0,0,5724,0
2062,2938,7943,41,Xensium,"Xensium is refined and crafted into components, modules and other items.",Xensium.png,uncommon,1030,0,0,1030,0
2062,4796,7943,115,Nanofluids,"Nanofluids are refined and crafted into components, modules and other items.",Nanofluids.png,common,2363,0,0,2363,0
2062,7525,7943,106,Elastomers,"Elastomers are refined and crafted into components, modules and other items.",Elastomers.png,abundant,4436,0,0,4436,0
2062,7526,7943,107,H2O,"H2O is refined and crafted into components, modules and other items.",H20.png,abundant,5320,0,0,5320,0
2068,2060,1846,109,Titanium,"Titanium is refined and crafted into components, modules and other items.",Titanium.png,common,2876,0,0,2876,0
2068,3148,1846,42,Base Minerals,"Base Minerals are refined and crafted into components, modules and other items.",Base_Mineral.png,abundant,5794,0,0,5794,0
2068,7519,1846,53,Ignis Ore,"Ignis Ore is refined and crafted into components, modules and other items.",Ignis_Ore.png,rare,769,0,0,769,0
2068,1971,7946,53,Ignis Ore,"Ignis Ore is refined and crafted into components, modules and other items.",Ignis_Ore.png,rare,784,0,0,784,0
2068,3149,7946,42,Base Minerals,"Base Minerals are refined and crafted into components, modules and other items.",Base_Mineral.png,abundant,2251,0,0,2251,0
2068,7593,7946,109,Titanium,"Titanium is refined and crafted into components, modules and other items.",Titanium.png,common,4007,0,0,4007,0
2069,1013,1847,128,Tchaikovium,"Tchaikovium is refined and crafted into components, modules and other items.",Tchaikovium.png,rare,711,0,0,711,0
2069,1629,1847,107,H2O,"H2O is refined and crafted into components, modules and other items.",H20.png,abundant,4571,458,0,4113,458
2069,1647,1847,112,Amphoteric Substances,"Amphoteric Substances are refined and crafted into components, modules and other items.",Amphoteric_Substances.png,common,2284,0,0,2284,0
2069,3378,7947,128,Tchaikovium,"Tchaikovium is refined and crafted into components, modules and other items.",Tchaikovium.png,rare,788,0,0,788,0
2069,3379,7947,42,Base Minerals,"Base Minerals are refined and crafted into components, modules and other items.",Base_Mineral.png,abundant,4034,0,0,4034,0
2069,3441,7947,107,H2O,"H2O is refined and crafted into components, modules and other items.",H20.png,abundant,2491,0,0,2491,0
2072,684,1849,123,Neolysium,"Neolysium is refined and crafted into components, modules and other items.",Neolysium.png,uncommon,1134,0,0,1134,0
2072,798,1849,120,Metamagnetic Ore,"Metamagnetic Ore is refined and crafted into components, modules and other items.",Metamagnetic_Ore.png,uncommon,2663,0,0,2663,0
2072,961,1849,114,Ectopolymers,"Ectopolymers are refined and crafted into components, modules and other items.",Ectopolymers.png,common,5795,0,0,5795,0
2072,4152,7949,53,Ignis Ore,"Ignis Ore is refined and crafted into components, modules and other items.",Ignis_Ore.png,rare,814,0,0,814,0
2072,4153,7949,109,Titanium,"Titanium is refined and crafted into components, modules and other items.",Titanium.png,common,2247,0,0,2247,0
2072,4154,7949,109,Titanium,"Titanium is refined and crafted into components, modules and other items.",Titanium.png,common,4295,0,0,4295,0
2074,16218,1850,127,Microorganisms,"Microorganisms are refined and crafted into components, modules and other items.",Microorganism.png,rare,762,0,0,762,0
2074,16567,1850,41,Xensium,"Xensium is refined and crafted into components, modules and other items.",Xensium.png,uncommon,2216,0,0,2216,0
2074,17761,1850,42,Base Minerals,"Base Minerals are refined and crafted into components, modules and other items.",Base_Mineral.png,abundant,5804,0,0,5804,0
2074,17762,7950,106,Elastomers,"Elastomers are refined and crafted into components, modules and other items.",Elastomers.png,abundant,5538,0,0,5538,0
2074,18006,7950,107,H2O,"H2O is refined and crafted into components, modules and other items.",H20.png,abundant,2788,0,0,2788,0
2074,18250,7950,121,Hypoatomic Substances,"Hypoatomic Substances are refined and crafted into components, modules and other items.",Hypoatomic_Substances.png,uncommon,1273,0,0,1273,0
2080,4377,1855,107,H2O,"H2O is refined and crafted into components, modules and other items.",H20.png,abundant,5338,0,0,5338,0
2080,4470,1855,126,Bruma Particles,"Bruma Particles are refined and crafted into components, modules and other items.",Bruma_Particle.png,rare,744,0,0,744,0
2080,9346,1855,109,Titanium,"Titanium is refined and crafted into components, modules and other items.",Titanium.png,common,2598,0,0,2598,0
2080,4471,7955,126,Bruma Particles,"Bruma Particles are refined and crafted into components, modules and other items.",Bruma_Particle.png,rare,644,0,0,644,0
2080,4472,7955,113,Aerogens,"Aerogens are refined and crafted into components, modules and other items.",Aerogens.png,common,4623,0,0,4623,0
2080,9071,7955,109,Titanium,"Titanium is refined and crafted into components, modules and other items.",Titanium.png,common,2199,0,0,2199,0
2085,427,1858,110,Plutonium,"Plutonium is refined and crafted into components, modules and other items.",Plutonium.png,common,2594,0,0,2594,0
2085,734,1858,42,Base Minerals,"Base Minerals are refined and crafted into components, modules and other items.",Base_Mineral.png,abundant,5089,2545,0,2544,2545
2085,4298,1858,128,Tchaikovium,"Tchaikovium is refined and crafted into components, modules and other items.",Tchaikovium.png,rare,686,0,0,686,0
2085,4566,7958,114,Ectopolymers,"Ectopolymers are refined and crafted into components, modules and other items.",Ectopolymers.png,common,2772,0,0,2772,0
2085,15181,7958,54,Hyperspecular Crystals,"Hyperspecular Crystals are refined and crafted into components, modules and other items.",Hyperspecular_Crystals.png,uncommon,1115,0,0,1115,0
2085,17264,7958,128,Tchaikovium,"Tchaikovium is refined and crafted into components, modules and other items.",Tchaikovium.png,rare,2963,0,0,2963,0
2088,9054,1861,53,Ignis Ore,"Ignis Ore is refined and crafted into components, modules and other items.",Ignis_Ore.png,rare,682,0,0,682,0
2088,9055,1861,52,Organic Compounds,"Organic Compounds are refined and crafted into components, modules and other items.",Organic_Compound.png,common,2115,0,0,2115,0
2088,9056,1861,112,Amphoteric Substances,"Amphoteric Substances are refined and crafted into components, modules and other items.",Amphoteric_Substances.png,common,4836,0,0,4836,0
2092,667,1865,42,Base Minerals,"Base Minerals are refined and crafted into components, modules and other items.",Base_Mineral.png,abundant,4733,0,0,4733,0
2092,1104,1865,126,Bruma Particles,"Bruma Particles are refined and crafted into components, modules and other items.",Bruma_Particle.png,rare,833,0,0,833,0
2092,1750,1865,107,H2O,"H2O is refined and crafted into components, modules and other items.",H20.png,abundant,2383,0,0,2383,0
2092,1908,7965,112,Amphoteric Substances,"Amphoteric Substances are refined and crafted into components, modules and other items.",Amphoteric_Substances.png,common,5538,0,0,5538,0
2092,2336,7965,107,H2O,"H2O is refined and crafted into components, modules and other items.",H20.png,abundant,2070,0,0,2070,0
2092,4397,7965,126,Bruma Particles,"Bruma Particles are refined and crafted into components, modules and other items.",Bruma_Particle.png,rare,847,0,0,847,0
2094,2034,1866,52,Organic Compounds,"Organic Compounds are refined and crafted into components, modules and other items.",Organic_Compound.png,common,1067,0,0,1067,0
2094,2035,1866,52,Organic Compounds,"Organic Compounds are refined and crafted into components, modules and other items.",Organic_Compound.png,common,5803,0,0,5803,0
2094,2273,1866,52,Organic Compounds,"Organic Compounds are refined and crafted into components, modules and other items.",Organic_Compound.png,common,2393,0,0,2393,0
2094,4059,7966,117,Yprasium,"Yprasium is refined and crafted into components, modules and other items.",Yprasium.png,uncommon,1194,0,0,1194,0
2094,4060,7966,113,Aerogens,"Aerogens are refined and crafted into components, modules and other items.",Aerogens.png,common,2757,0,0,2757,0
2094,4061,7966,117,Yprasium,"Yprasium is refined and crafted into components, modules and other items.",Yprasium.png,uncommon,5117,0,0,5117,0
2098,499,1868,114,Ectopolymers,"Ectopolymers are refined and crafted into components, modules and other items.",Ectopolymers.png,common,1017,0,0,1017,0
2103,2880,1871,127,Microorganisms,"Microorganisms are refined and crafted into components, modules and other items.",Microorganism.png,rare,611,0,0,611,0
2103,2881,1871,126,Bruma Particles,"Bruma Particles are refined and crafted into components, modules and other items.",Bruma_Particle.png,rare,1662,0,0,1662,0
2103,2882,1871,107,H2O,"H2O is refined and crafted into components, modules and other items.",H20.png,abundant,4182,0,0,4182,0
2108,64,1875,117,Yprasium,"Yprasium is refined and crafted into components, modules and other items.",Yprasium.png,uncommon,1031,0,0,1031,0
2108,136,1875,105,Silicates,"Silicates are refined and crafted into components, modules and other items.",Silicates.png,abundant,5297,0,0,5297,0
2108,408,1875,114,Ectopolymers,"Ectopolymers are refined and crafted into components, modules and other items.",Ectopolymers.png,common,2432,0,0,2432,0
2108,409,1875,105,Silicates,"Silicates are refined and crafted into components, modules and other items.",Silicates.png,abundant,2953,0,0,2953,0
2108,1921,7975,118,Platinyx,"Platinyx is refined and crafted into components, modules and other items.",Platinyx.png,uncommon,1414,0,0,1414,0
2108,1922,7975,117,Yprasium,"Yprasium is refined and crafted into components, modules and other items.",Yprasium.png,uncommon,1485,0,0,1485,0
2108,3004,7975,107,H2O,"H2O is refined and crafted into components, modules and other items.",H20.png,abundant,4149,415,0,3734,415
2108,3028,7975,107,H2O,"H2O is refined and crafted into components, modules and other items.",H20.png,abundant,2299,0,0,2299,0
2113,943,1880,54,Hyperspecular Crystals,"Hyperspecular Crystals are refined and crafted into components, modules and other items.",Hyperspecular_Crystals.png,uncommon,2866,0,0,2866,0
2113,1095,1880,128,Tchaikovium,"Tchaikovium is refined and crafted into components, modules and other items.",Tchaikovium.png,rare,654,131,0,523,131
2114,74,1881,123,Neolysium,"Neolysium is refined and crafted into components, modules and other items.",Neolysium.png,uncommon,1089,1089,0,0,1089
2114,75,1881,120,Metamagnetic Ore,"Metamagnetic Ore is refined and crafted into components, modules and other items.",Metamagnetic_Ore.png,uncommon,1049,1049,0,0,1049
2114,251,1881,120,Metamagnetic Ore,"Metamagnetic Ore is refined and crafted into components, modules and other items.",Metamagnetic_Ore.png,uncommon,2931,2931,0,0,2931
2114,295,1881,105,Silicates,"Silicates are refined and crafted into components, modules and other items.",Silicates.png,abundant,5409,5409,0,0,5409
2114,1809,7981,109,Titanium,"Titanium is refined and crafted into components, modules and other items.",Titanium.png,common,5783,5783,0,0,5783
2114,2146,7981,120,Metamagnetic Ore,"Metamagnetic Ore is refined and crafted into components, modules and other items.",Metamagnetic_Ore.png,uncommon,1141,1141,0,0,1141
2114,2147,7981,42,Base Minerals,"Base Minerals are refined and crafted into components, modules and other items.",Base_Mineral.png,abundant,2562,321,0,2241,321
2117,2248,1883,114,Ectopolymers,"Ectopolymers are refined and crafted into components, modules and other items.",Ectopolymers.png,common,1473,0,0,1473,0
2117,2249,1883,107,H2O,"H2O is refined and crafted into components, modules and other items.",H20.png,abundant,4471,0,0,4471,0
2119,1886,1884,53,Ignis Ore,"Ignis Ore is refined and crafted into components, modules and other items.",Ignis_Ore.png,rare,627,0,0,627,0
2119,2064,1884,42,Base Minerals,"Base Minerals are refined and crafted into components, modules and other items.",Base_Mineral.png,abundant,4970,994,0,3976,994
2119,2286,1884,40,Polymetals,"Polymetals are refined and crafted into components, modules and other items.",Polymetals.png,common,2047,512,0,1535,512
2131,1263,1893,53,Ignis Ore,"Ignis Ore is refined and crafted into components, modules and other items.",Ignis_Ore.png,rare,840,0,0,840,0
2131,1630,1893,128,Tchaikovium,"Tchaikovium is refined and crafted into components, modules and other items.",Tchaikovium.png,rare,3640,0,0,3640,0
2131,1646,1893,114,Ectopolymers,"Ectopolymers are refined and crafted into components, modules and other items.",Ectopolymers.png,common,2355,0,0,2355,0
2131,3029,7993,128,Tchaikovium,"Tchaikovium is refined and crafted into components, modules and other items.",Tchaikovium.png,rare,638,0,0,638,0
2131,3510,7993,107,H2O,"H2O is refined and crafted into components, modules and other items.",H20.png,abundant,2374,0,0,2374,0
2131,3600,7993,42,Base Minerals,"Base Minerals are refined and crafted into components, modules and other items.",Base_Mineral.png,abundant,5666,0,0,5666,0
2142,969,1901,53,Ignis Ore,"Ignis Ore is refined and crafted into components, modules and other items.",Ignis_Ore.png,rare,869,0,0,869,0
2142,1503,1901,107,H2O,"H2O is refined and crafted into components, modules and other items.",H20.png,abundant,4680,0,0,4680,0
2142,1504,1901,42,Base Minerals,"Base Minerals are refined and crafted into components, modules and other items.",Base_Mineral.png,abundant,4194,0,0,4194,0
2142,1963,1901,42,Base Minerals,"Base Minerals are refined and crafted into components, modules and other items.",Base_Mineral.png,abundant,2663,0,0,2663,0
2142,970,8001,127,Microorganisms,"Microorganisms are refined and crafted into components, modules and other items.",Microorganism.png,rare,769,0,0,769,0
2142,1139,8001,52,Organic Compounds,"Organic Compounds are refined and crafted into components, modules and other items.",Organic_Compound.png,common,2417,0,0,2417,0
2142,1964,8001,105,Silicates,"Silicates are refined and crafted into components, modules and other items.",Silicates.png,abundant,5019,0,0,5019,0
2142,1965,8001,42,Base Minerals,"Base Minerals are refined and crafted into components, modules and other items.",Base_Mineral.png,abundant,4790,0,0,4790,0
2148,663,1905,40,Polymetals,"Polymetals are refined and crafted into components, modules and other items.",Polymetals.png,common,2183,0,0,2183,0
2148,687,1905,106,Elastomers,"Elastomers are refined and crafted into components, modules and other items.",Elastomers.png,abundant,4920,0,0,4920,0
2148,1816,1905,41,Xensium,"Xensium is refined and crafted into components, modules and other items.",Xensium.png,uncommon,1330,0,0,1330,0
2149,13597,1906,106,Elastomers,"Elastomers are refined and crafted into components, modules and other items.",Elastomers.png,abundant,4925,0,0,4925,0
2149,13795,1906,115,Nanofluids,"Nanofluids are refined and crafted into components, modules and other items.",Nanofluids.png,common,2965,0,0,2965,0
2149,15949,1906,40,Polymetals,"Polymetals are refined and crafted into components, modules and other items.",Polymetals.png,common,1106,0,0,1106,0
2152,3277,1908,127,Microorganisms,"Microorganisms are refined and crafted into components, modules and other items.",Microorganism.png,rare,848,0,0,848,0
2152,3278,1908,107,H2O,"H2O is refined and crafted into components, modules and other items.",H20.png,abundant,3000,0,0,3000,0
2152,3279,1908,107,H2O,"H2O is refined and crafted into components, modules and other items.",H20.png,abundant,4392,0,0,4392,0
2155,1007,1911,126,Bruma Particles,"Bruma Particles are refined and crafted into components, modules and other items.",Bruma_Particle.png,rare,740,148,0,592,148
2155,1077,1911,107,H2O,"H2O is refined and crafted into components, modules and other items.",H20.png,abundant,5175,0,0,5175,0
2155,1116,1911,105,Silicates,"Silicates are refined and crafted into components, modules and other items.",Silicates.png,abundant,2856,0,0,2856,0
2155,4526,8011,126,Bruma Particles,"Bruma Particles are refined and crafted into components, modules and other items.",Bruma_Particle.png,rare,662,0,0,662,0
2155,4527,8011,126,Bruma Particles,"Bruma Particles are refined and crafted into components, modules and other items.",Bruma_Particle.png,rare,790,0,0,790,0
2155,4541,8011,105,Silicates,"Silicates are refined and crafted into components, modules and other items.",Silicates.png,abundant,5165,0,0,5165,0
2155,4542,8011,115,Nanofluids,"Nanofluids are refined and crafted into components, modules and other items.",Nanofluids.png,common,5012,0,0,5012,0
2155,4639,8011,105,Silicates,"Silicates are refined and crafted into components, modules and other items.",Silicates.png,abundant,2745,0,0,2745,0
2157,875,1912,128,Tchaikovium,"Tchaikovium is refined and crafted into components, modules and other items.",Tchaikovium.png,rare,705,0,0,705,0
2157,2479,1912,106,Elastomers,"Elastomers are refined and crafted into components, modules and other items.",Elastomers.png,abundant,5899,2950,0,2949,2950
2157,2492,1912,118,Platinyx,"Platinyx is refined and crafted into components, modules and other items.",Platinyx.png,uncommon,2306,0,0,2306,0
2161,17937,1915,123,Neolysium,"Neolysium is refined and crafted into components, modules and other items.",Neolysium.png,uncommon,1343,0,0,1343,0
2161,17987,1915,107,H2O,"H2O is refined and crafted into components, modules and other items.",H20.png,abundant,2612,0,0,2612,0
2161,18252,1915,110,Plutonium,"Plutonium is refined and crafted into components, modules and other items.",Plutonium.png,common,5611,0,0,5611,0
2161,20006,8015,54,Hyperspecular Crystals,"Hyperspecular Crystals are refined and crafted into components, modules and other items.",Hyperspecular_Crystals.png,uncommon,1377,0,0,1377,0
2161,20008,8015,54,Hyperspecular Crystals,"Hyperspecular Crystals are refined and crafted into components, modules and other items.",Hyperspecular_Crystals.png,uncommon,2264,0,0,2264,0
2161,20395,8015,42,Base Minerals,"Base Minerals are refined and crafted into components, modules and other items.",Base_Mineral.png,abundant,5007,0,0,5007,0
2162,3497,1916,117,Yprasium,"Yprasium is refined and crafted into components, modules and other items.",Yprasium.png,uncommon,2190,0,0,2190,0
2162,3498,1916,114,Ectopolymers,"Ectopolymers are refined and crafted into components, modules and other items.",Ectopolymers.png,common,2271,0,0,2271,0
2162,3499,1916,105,Silicates,"Silicates are refined and crafted into components, modules and other items.",Silicates.png,abundant,4937,0,0,4937,0
2162,3500,1916,105,Silicates,"Silicates are refined and crafted into components, modules and other items.",Silicates.png,abundant,5428,0,0,5428,0
2162,4455,1916,53,Ignis Ore,"Ignis Ore is refined and crafted into components, modules and other items.",Ignis_Ore.png,rare,827,0,0,827,0
2162,4456,8016,107,H2O,"H2O is refined and crafted into components, modules and other items.",H20.png,abundant,2124,0,0,2124,0
2162,7711,8016,105,Silicates,"Silicates are refined and crafted into components, modules and other items.",Silicates.png,abundant,5991,0,0,5991,0
2165,7987,1918,110,Plutonium,"Plutonium is refined and crafted into components, modules and other items.",Plutonium.png,common,1172,0,0,1172,0
2165,12607,1918,106,Elastomers,"Elastomers are refined and crafted into components, modules and other items.",Elastomers.png,abundant,4457,0,0,4457,0
2175,4777,1923,105,Silicates,"Silicates are refined and crafted into components, modules and other items.",Silicates.png,abundant,5317,0,0,5317,0
2175,4778,1923,115,Nanofluids,"Nanofluids are refined and crafted into components, modules and other items.",Nanofluids.png,common,1448,0,0,1448,0
2175,16633,1923,106,Elastomers,"Elastomers are refined and crafted into components, modules and other items.",Elastomers.png,abundant,2224,0,0,2224,0
2175,4779,8023,115,Nanofluids,"Nanofluids are refined and crafted into components, modules and other items.",Nanofluids.png,common,2602,0,0,2602,0
2175,4780,8023,40,Polymetals,"Polymetals are refined and crafted into components, modules and other items.",Polymetals.png,common,4307,0,0,4307,0
2175,17194,8023,117,Yprasium,"Yprasium is refined and crafted into components, modules and other items.",Yprasium.png,uncommon,1271,0,0,1271,0
2178,4737,1925,41,Xensium,"Xensium is refined and crafted into components, modules and other items.",Xensium.png,uncommon,2215,0,0,2215,0
2178,4741,1925,106,Elastomers,"Elastomers are refined and crafted into components, modules and other items.",Elastomers.png,abundant,5702,0,0,5702,0
2178,4742,1925,105,Silicates,"Silicates are refined and crafted into components, modules and other items.",Silicates.png,abundant,5282,0,0,5282,0
2178,4743,1925,127,Microorganisms,"Microorganisms are refined and crafted into components, modules and other items.",Microorganism.png,rare,699,0,0,699,0
2178,17361,8025,127,Microorganisms,"Microorganisms are refined and crafted into components, modules and other items.",Microorganism.png,rare,795,0,0,795,0
2178,17362,8025,40,Polymetals,"Polymetals are refined and crafted into components, modules and other items.",Polymetals.png,common,2301,0,0,2301,0
2178,17363,8025,106,Elastomers,"Elastomers are refined and crafted into components, modules and other items.",Elastomers.png,abundant,4604,0,0,4604,0
2179,18647,1926,112,Amphoteric Substances,"Amphoteric Substances are refined and crafted into components, modules and other items.",Amphoteric_Substances.png,common,2514,0,0,2514,0
2179,18686,1926,40,Polymetals,"Polymetals are refined and crafted into components, modules and other items.",Polymetals.png,common,4735,0,0,4735,0
2179,19210,1926,119,Novis Compounds,"Novis Compounds are refined and crafted into components, modules and other items.",Novis_Compound.png,uncommon,1367,0,0,1367,0
2182,1643,1928,114,Ectopolymers,"Ectopolymers are refined and crafted into components, modules and other items.",Ectopolymers.png,common,2798,0,0,2798,0
2182,2807,8028,54,Hyperspecular Crystals,"Hyperspecular Crystals are refined and crafted into components, modules and other items.",Hyperspecular_Crystals.png,uncommon,1113,0,0,1113,0
2194,5613,1936,117,Yprasium,"Yprasium is refined and crafted into components, modules and other items.",Yprasium.png,uncommon,1377,0,0,1377,0
2207,9057,1941,126,Bruma Particles,"Bruma Particles are refined and crafted into components, modules and other items.",Bruma_Particle.png,rare,897,0,0,897,0
2207,9058,1941,118,Platinyx,"Platinyx is refined and crafted into components, modules and other items.",Platinyx.png,uncommon,2724,0,0,2724,0
2207,9059,1941,110,Plutonium,"Plutonium is refined and crafted into components, modules and other items.",Plutonium.png,common,5454,0,0,5454,0
2211,13993,1943,123,Neolysium,"Neolysium is refined and crafted into components, modules and other items.",Neolysium.png,uncommon,4972,0,0,4972,0
2211,14224,1943,117,Yprasium,"Yprasium is refined and crafted into components, modules and other items.",Yprasium.png,uncommon,2577,0,0,2577,0
2211,14290,1943,126,Bruma Particles,"Bruma Particles are refined and crafted into components, modules and other items.",Bruma_Particle.png,rare,642,0,0,642,0
2214,2883,1944,54,Hyperspecular Crystals,"Hyperspecular Crystals are refined and crafted into components, modules and other items.",Hyperspecular_Crystals.png,uncommon,1447,0,0,1447,0
2214,2884,1944,110,Plutonium,"Plutonium is refined and crafted into components, modules and other items.",Plutonium.png,common,2035,0,0,2035,0
2214,2885,1944,42,Base Minerals,"Base Minerals are refined and crafted into components, modules and other items.",Base_Mineral.png,abundant,4898,0,0,4898,0
2214,2886,1944,119,Novis Compounds,"Novis Compounds are refined and crafted into components, modules and other items.",Novis_Compound.png,uncommon,5829,0,0,5829,0
2216,6008,1946,114,Ectopolymers,"Ectopolymers are refined and crafted into components, modules and other items.",Ectopolymers.png,common,1002,0,0,1002,0
2225,1358,1953,107,H2O,"H2O is refined and crafted into components, modules and other items.",H20.png,abundant,2569,0,0,2569,0
2225,2279,1953,41,Xensium,"Xensium is refined and crafted into components, modules and other items.",Xensium.png,uncommon,1455,0,0,1455,0
2225,2280,1953,107,H2O,"H2O is refined and crafted into components, modules and other items.",H20.png,abundant,4960,0,0,4960,0
2227,2545,1955,113,Aerogens,"Aerogens are refined and crafted into components, modules and other items.",Aerogens.png,common,1484,297,0,1187,297
2227,3007,1955,121,Hypoatomic Substances,"Hypoatomic Substances are refined and crafted into components, modules and other items.",Hypoatomic_Substances.png,uncommon,2009,0,0,2009,0
2227,3085,1955,114,Ectopolymers,"Ectopolymers are refined and crafted into components, modules and other items.",Ectopolymers.png,common,4699,2350,0,2349,2350
2231,15973,1958,42,Base Minerals,"Base Minerals are refined and crafted into components, modules and other items.",Base_Mineral.png,abundant,2707,0,0,2707,0
2231,16468,1958,105,Silicates,"Silicates are refined and crafted into components, modules and other items.",Silicates.png,abundant,5921,0,0,5921,0
2231,16700,1958,123,Neolysium,"Neolysium is refined and crafted into components, modules and other items.",Neolysium.png,uncommon,1128,0,0,1128,0
2236,2505,1962,112,Amphoteric Substances,"Amphoteric Substances are refined and crafted into components, modules and other items.",Amphoteric_Substances.png,common,1277,0,0,1277,0
2236,4884,1962,114,Ectopolymers,"Ectopolymers are refined and crafted into components, modules and other items.",Ectopolymers.png,common,2266,0,0,2266,0
2236,4885,1962,114,Ectopolymers,"Ectopolymers are refined and crafted into components, modules and other items.",Ectopolymers.png,common,4805,0,0,4805,0
2238,1805,1964,113,Aerogens,"Aerogens are refined and crafted into components, modules and other items.",Aerogens.png,common,5274,0,0,5274,0
2238,1837,1964,126,Bruma Particles,"Bruma Particles are refined and crafted into components, modules and other items.",Bruma_Particle.png,rare,845,0,0,845,0
2238,1838,1964,113,Aerogens,"Aerogens are refined and crafted into components, modules and other items.",Aerogens.png,common,2292,0,0,2292,0
2244,8615,1969,123,Neolysium,"Neolysium is refined and crafted into components, modules and other items.",Neolysium.png,uncommon,1048,0,0,1048,0
2244,8647,1969,41,Xensium,"Xensium is refined and crafted into components, modules and other items.",Xensium.png,uncommon,2518,0,0,2518,0
2244,8746,1969,115,Nanofluids,"Nanofluids are refined and crafted into components, modules and other items.",Nanofluids.png,common,4831,0,0,4831,0
2244,8648,8069,115,Nanofluids,"Nanofluids are refined and crafted into components, modules and other items.",Nanofluids.png,common,1108,0,0,1108,0
2244,8747,8069,121,Hypoatomic Substances,"Hypoatomic Substances are refined and crafted into components, modules and other items.",Hypoatomic_Substances.png,uncommon,2470,0,0,2470,0
2244,9283,8069,52,Organic Compounds,"Organic Compounds are refined and crafted into components, modules and other items.",Organic_Compound.png,common,5439,0,0,5439,0
2245,105,1970,115,Nanofluids,"Nanofluids are refined and crafted into components, modules and other items.",Nanofluids.png,common,1433,0,0,1433,0
2245,191,1970,123,Neolysium,"Neolysium is refined and crafted into components, modules and other items.",Neolysium.png,uncommon,2759,0,0,2759,0
2245,403,1970,42,Base Minerals,"Base Minerals are refined and crafted into components, modules and other items.",Base_Mineral.png,abundant,4320,0,0,4320,0
2245,2054,8070,113,Aerogens,"Aerogens are refined and crafted into components, modules and other items.",Aerogens.png,common,1031,0,0,1031,0
2245,2514,8070,42,Base Minerals,"Base Minerals are refined and crafted into components, modules and other items.",Base_Mineral.png,abundant,4618,0,0,4618,0
2245,2515,8070,42,Base Minerals,"Base Minerals are refined and crafted into components, modules and other items.",Base_Mineral.png,abundant,5072,0,0,5072,0
2245,2935,8070,113,Aerogens,"Aerogens are refined and crafted into components, modules and other items.",Aerogens.png,common,2046,0,0,2046,0
2245,2936,8070,109,Titanium,"Titanium is refined and crafted into components, modules and other items.",Titanium.png,common,2817,0,0,2817,0
2254,1065,1976,115,Nanofluids,"Nanofluids are refined and crafted into components, modules and other items.",Nanofluids.png,common,2537,0,0,2537,0
2254,1097,1976,114,Ectopolymers,"Ectopolymers are refined and crafted into components, modules and other items.",Ectopolymers.png,common,1312,0,0,1312,0
2254,3021,1976,106,Elastomers,"Elastomers are refined and crafted into components, modules and other items.",Elastomers.png,abundant,5456,0,0,5456,0
2256,1573,1978,115,Nanofluids,"Nanofluids are refined and crafted into components, modules and other items.",Nanofluids.png,common,1472,0,0,1472,0
2256,1574,1978,105,Silicates,"Silicates are refined and crafted into components, modules and other items.",Silicates.png,abundant,4840,0,0,4840,0
2256,1615,1978,106,Elastomers,"Elastomers are refined and crafted into components, modules and other items.",Elastomers.png,abundant,2251,0,0,2251,0
2256,1575,8078,40,Polymetals,"Polymetals are refined and crafted into components, modules and other items.",Polymetals.png,common,1465,0,0,1465,0
2256,1616,8078,42,Base Minerals,"Base Minerals are refined and crafted into components, modules and other items.",Base_Mineral.png,abundant,4897,0,0,4897,0
2256,1810,8078,110,Plutonium,"Plutonium is refined and crafted into components, modules and other items.",Plutonium.png,common,2865,0,0,2865,0
2262,20428,1983,113,Aerogens,"Aerogens are refined and crafted into components, modules and other items.",Aerogens.png,common,1305,0,0,1305,0
2262,20429,1983,117,Yprasium,"Yprasium is refined and crafted into components, modules and other items.",Yprasium.png,uncommon,1443,0,0,1443,0
2262,20433,1983,106,Elastomers,"Elastomers are refined and crafted into components, modules and other items.",Elastomers.png,abundant,2262,0,0,2262,0
2262,20434,1983,106,Elastomers,"Elastomers are refined and crafted into components, modules and other items.",Elastomers.png,abundant,2020,0,0,2020,0
2262,20628,1983,40,Polymetals,"Polymetals are refined and crafted into components, modules and other items.",Polymetals.png,common,4514,0,0,4514,0
2262,20430,8083,126,Bruma Particles,"Bruma Particles are refined and crafted into components, modules and other items.",Bruma_Particle.png,rare,792,0,0,792,0
2262,20435,8083,113,Aerogens,"Aerogens are refined and crafted into components, modules and other items.",Aerogens.png,common,2358,0,0,2358,0
2268,957,1988,110,Plutonium,"Plutonium is refined and crafted into components, modules and other items.",Plutonium.png,common,2281,0,0,2281,0
2268,985,1988,128,Tchaikovium,"Tchaikovium is refined and crafted into components, modules and other items.",Tchaikovium.png,rare,885,0,0,885,0
2268,1247,1988,42,Base Minerals,"Base Minerals are refined and crafted into components, modules and other items.",Base_Mineral.png,abundant,4493,0,0,4493,0
2268,1317,8088,42,Base Minerals,"Base Minerals are refined and crafted into components, modules and other items.",Base_Mineral.png,abundant,2053,0,0,2053,0
2268,1625,8088,53,Ignis Ore,"Ignis Ore is refined and crafted into components, modules and other items.",Ignis_Ore.png,rare,882,0,0,882,0
2268,2418,8088,105,Silicates,"Silicates are refined and crafted into components, modules and other items.",Silicates.png,abundant,4007,0,0,4007,0
2269,4140,1989,106,Elastomers,"Elastomers are refined and crafted into components, modules and other items.",Elastomers.png,abundant,5051,0,0,5051,0
2269,16535,1989,109,Titanium,"Titanium is refined and crafted into components, modules and other items.",Titanium.png,common,1082,0,0,1082,0
2269,1468,8089,127,Microorganisms,"Microorganisms are refined and crafted into components, modules and other items.",Microorganism.png,rare,793,0,0,793,0
2269,3888,8089,105,Silicates,"Silicates are refined and crafted into components, modules and other items.",Silicates.png,abundant,2786,0,0,2786,0
2269,4759,8089,107,H2O,"H2O is refined and crafted into components, modules and other items.",H20.png,abundant,4863,0,0,4863,0
2270,4224,1990,41,Xensium,"Xensium is refined and crafted into components, modules and other items.",Xensium.png,uncommon,1028,0,0,1028,0
2270,4294,1990,107,H2O,"H2O is refined and crafted into components, modules and other items.",H20.png,abundant,4872,0,0,4872,0
2270,9406,1990,112,Amphoteric Substances,"Amphoteric Substances are refined and crafted into components, modules and other items.",Amphoteric_Substances.png,common,2470,0,0,2470,0
2270,4234,8090,119,Novis Compounds,"Novis Compounds are refined and crafted into components, modules and other items.",Novis_Compound.png,uncommon,5155,0,0,5155,0
2270,4473,8090,112,Amphoteric Substances,"Amphoteric Substances are refined and crafted into components, modules and other items.",Amphoteric_Substances.png,common,1202,0,0,1202,0
2270,9347,8090,41,Xensium,"Xensium is refined and crafted into components, modules and other items.",Xensium.png,uncommon,2856,0,0,2856,0
2271,17993,1991,105,Silicates,"Silicates are refined and crafted into components, modules and other items.",Silicates.png,abundant,4971,0,0,4971,0
2272,19506,1992,114,Ectopolymers,"Ectopolymers are refined and crafted into components, modules and other items.",Ectopolymers.png,common,1437,0,0,1437,0
2272,20131,1992,117,Yprasium,"Yprasium is refined and crafted into components, modules and other items.",Yprasium.png,uncommon,2730,0,0,2730,0
2272,20364,1992,42,Base Minerals,"Base Minerals are refined and crafted into components, modules and other items.",Base_Mineral.png,abundant,5357,0,0,5357,0
2272,19507,8092,117,Yprasium,"Yprasium is refined and crafted into components, modules and other items.",Yprasium.png,uncommon,1342,0,0,1342,0
2272,19735,8092,114,Ectopolymers,"Ectopolymers are refined and crafted into components, modules and other items.",Ectopolymers.png,common,2206,0,0,2206,0
2272,20956,8092,105,Silicates,"Silicates are refined and crafted into components, modules and other items.",Silicates.png,abundant,4582,0,0,4582,0
2282,4720,2000,41,Xensium,"Xensium is refined and crafted into components, modules and other items.",Xensium.png,uncommon,1095,0,0,1095,0
2285,3446,2003,105,Silicates,"Silicates are refined and crafted into components, modules and other items.",Silicates.png,abundant,4223,0,0,4223,0
2285,7594,2003,120,Metamagnetic Ore,"Metamagnetic Ore is refined and crafted into components, modules and other items.",Metamagnetic_Ore.png,uncommon,1469,0,0,1469,0
2285,2349,8103,120,Metamagnetic Ore,"Metamagnetic Ore is refined and crafted into components, modules and other items.",Metamagnetic_Ore.png,uncommon,1215,243,0,972,243
2285,3304,8103,121,Hypoatomic Substances,"Hypoatomic Substances are refined and crafted into components, modules and other items.",Hypoatomic_Substances.png,uncommon,2216,277,0,1939,277
2285,3447,8103,112,Amphoteric Substances,"Amphoteric Substances are refined and crafted into components, modules and other items.",Amphoteric_Substances.png,common,5347,0,0,5347,0
2298,11817,2011,53,Ignis Ore,"Ignis Ore is refined and crafted into components, modules and other items.",Ignis_Ore.png,rare,671,0,0,671,0
2298,12673,2011,54,Hyperspecular Crystals,"Hyperspecular Crystals are refined and crafted into components, modules and other items.",Hyperspecular_Crystals.png,uncommon,2246,0,0,2246,0
2298,14158,2011,107,H2O,"H2O is refined and crafted into components, modules and other items.",H20.png,abundant,4586,0,0,4586,0
2305,1799,2015,54,Hyperspecular Crystals,"Hyperspecular Crystals are refined and crafted into components, modules and other items.",Hyperspecular_Crystals.png,uncommon,1354,0,0,1354,0
2305,1800,2015,52,Organic Compounds,"Organic Compounds are refined and crafted into components, modules and other items.",Organic_Compound.png,common,2588,0,0,2588,0
2305,1801,2015,110,Plutonium,"Plutonium is refined and crafted into components, modules and other items.",Plutonium.png,common,4710,0,0,4710,0
2306,2819,2016,121,Hypoatomic Substances,"Hypoatomic Substances are refined and crafted into components, modules and other items.",Hypoatomic_Substances.png,uncommon,1416,0,0,1416,0
2306,2820,2016,121,Hypoatomic Substances,"Hypoatomic Substances are refined and crafted into components, modules and other items.",Hypoatomic_Substances.png,uncommon,2966,0,0,2966,0
2306,2821,2016,52,Organic Compounds,"Organic Compounds are refined and crafted into components, modules and other items.",Organic_Compound.png,common,5128,513,0,4615,513
2306,8977,8116,127,Microorganisms,"Microorganisms are refined and crafted into components, modules and other items.",Microorganism.png,rare,628,0,0,628,0
2308,2996,2018,118,Platinyx,"Platinyx is refined and crafted into components, modules and other items.",Platinyx.png,uncommon,1415,0,0,1415,0
2308,3008,2018,114,Ectopolymers,"Ectopolymers are refined and crafted into components, modules and other items.",Ectopolymers.png,common,2565,0,0,2565,0
2308,3302,2018,107,H2O,"H2O is refined and crafted into components, modules and other items.",H20.png,abundant,5416,0,0,5416,0
2312,14323,2021,128,Tchaikovium,"Tchaikovium is refined and crafted into components, modules and other items.",Tchaikovium.png,rare,828,0,0,828,0
2312,14356,2021,42,Base Minerals,"Base Minerals are refined and crafted into components, modules and other items.",Base_Mineral.png,abundant,2158,0,0,2158,0
2312,14389,2021,40,Polymetals,"Polymetals are refined and crafted into components, modules and other items.",Polymetals.png,common,4644,0,0,4644,0
2314,692,2023,118,Platinyx,"Platinyx is refined and crafted into components, modules and other items.",Platinyx.png,uncommon,1010,202,0,808,202
2314,1632,2023,105,Silicates,"Silicates are refined and crafted into components, modules and other items.",Silicates.png,abundant,4535,0,0,4535,0
2314,1649,2023,110,Plutonium,"Plutonium is refined and crafted into components, modules and other items.",Plutonium.png,common,2026,0,0,2026,0
2314,1650,2023,110,Plutonium,"Plutonium is refined and crafted into components, modules and other items.",Plutonium.png,common,2059,0,0,2059,0
2314,3448,8123,120,Metamagnetic Ore,"Metamagnetic Ore is refined and crafted into components, modules and other items.",Metamagnetic_Ore.png,uncommon,1466,0,0,1466,0
2314,3650,8123,40,Polymetals,"Polymetals are refined and crafted into components, modules and other items.",Polymetals.png,common,2077,0,0,2077,0
2314,3658,8123,42,Base Minerals,"Base Minerals are refined and crafted into components, modules and other items.",Base_Mineral.png,abundant,5567,0,0,5567,0
2315,3318,2024,127,Microorganisms,"Microorganisms are refined and crafted into components, modules and other items.",Microorganism.png,rare,848,170,0,678,170
2317,8192,2026,53,Ignis Ore,"Ignis Ore is refined and crafted into components, modules and other items.",Ignis_Ore.png,rare,869,0,0,869,0
2317,8203,2026,52,Organic Compounds,"Organic Compounds are refined and crafted into components, modules and other items.",Organic_Compound.png,common,2743,0,0,2743,0
2331,1126,2036,114,Ectopolymers,"Ectopolymers are refined and crafted into components, modules and other items.",Ectopolymers.png,common,4825,0,0,4825,0
2331,1154,2036,54,Hyperspecular Crystals,"Hyperspecular Crystals are refined and crafted into components, modules and other items.",Hyperspecular_Crystals.png,uncommon,1320,0,0,1320,0
2331,1155,2036,119,Novis Compounds,"Novis Compounds are refined and crafted into components, modules and other items.",Novis_Compound.png,uncommon,1196,0,0,1196,0
2331,1223,2036,119,Novis Compounds,"Novis Compounds are refined and crafted into components, modules and other items.",Novis_Compound.png,uncommon,2349,0,0,2349,0
2331,18048,8136,110,Plutonium,"Plutonium is refined and crafted into components, modules and other items.",Plutonium.png,common,1395,0,0,1395,0
2331,18049,8136,114,Ectopolymers,"Ectopolymers are refined and crafted into components, modules and other items.",Ectopolymers.png,common,2121,0,0,2121,0
2331,18050,8136,42,Base Minerals,"Base Minerals are refined and crafted into components, modules and other items.",Base_Mineral.png,abundant,4884,0,0,4884,0
2337,18568,2040,112,Amphoteric Substances,"Amphoteric Substances are refined and crafted into components, modules and other items.",Amphoteric_Substances.png,common,2887,0,0,2887,0
2337,18569,2040,107,H2O,"H2O is refined and crafted into components, modules and other items.",H20.png,abundant,4534,0,0,4534,0
2337,18570,2040,113,Aerogens,"Aerogens are refined and crafted into components, modules and other items.",Aerogens.png,common,5344,0,0,5344,0
2340,77,2043,115,Nanofluids,"Nanofluids are refined and crafted into components, modules and other items.",Nanofluids.png,common,1256,1256,0,0,1256
2340,252,2043,113,Aerogens,"Aerogens are refined and crafted into components, modules and other items.",Aerogens.png,common,2042,2042,0,0,2042
2340,296,2043,105,Silicates,"Silicates are refined and crafted into components, modules and other items.",Silicates.png,abundant,5469,4923,0,546,4923
2340,1982,8143,113,Aerogens,"Aerogens are refined and crafted into components, modules and other items.",Aerogens.png,common,5646,1130,0,4516,1130
2340,2394,8143,117,Yprasium,"Yprasium is refined and crafted into components, modules and other items.",Yprasium.png,uncommon,1212,1212,0,0,1212
2340,2395,8143,115,Nanofluids,"Nanofluids are refined and crafted into components, modules and other items.",Nanofluids.png,common,2796,2796,0,0,2796
2345,7361,2046,52,Organic Compounds,"Organic Compounds are refined and crafted into components, modules and other items.",Organic_Compound.png,common,1257,0,0,1257,0
2345,7690,2046,117,Yprasium,"Yprasium is refined and crafted into components, modules and other items.",Yprasium.png,uncommon,2216,0,0,2216,0
2345,8119,2046,52,Organic Compounds,"Organic Compounds are refined and crafted into components, modules and other items.",Organic_Compound.png,common,5643,0,0,5643,0
2345,9835,8146,42,Base Minerals,"Base Minerals are refined and crafted into components, modules and other items.",Base_Mineral.png,abundant,2493,0,0,2493,0
2346,1063,2047,54,Hyperspecular Crystals,"Hyperspecular Crystals are refined and crafted into components, modules and other items.",Hyperspecular_Crystals.png,uncommon,1037,0,0,1037,0
2346,1064,2047,54,Hyperspecular Crystals,"Hyperspecular Crystals are refined and crafted into components, modules and other items.",Hyperspecular_Crystals.png,uncommon,1353,0,0,1353,0
2346,1651,2047,113,Aerogens,"Aerogens are refined and crafted into components, modules and other items.",Aerogens.png,common,5256,0,0,5256,0
2346,1691,2047,113,Aerogens,"Aerogens are refined and crafted into components, modules and other items.",Aerogens.png,common,2325,0,0,2325,0
2346,3614,8147,118,Platinyx,"Platinyx is refined and crafted into components, modules and other items.",Platinyx.png,uncommon,1081,217,0,864,217
2346,4200,8147,54,Hyperspecular Crystals,"Hyperspecular Crystals are refined and crafted into components, modules and other items.",Hyperspecular_Crystals.png,uncommon,2376,0,0,2376,0
2346,4212,8147,42,Base Minerals,"Base Minerals are refined and crafted into components, modules and other items.",Base_Mineral.png,abundant,4171,0,0,4171,0
2353,900,2052,117,Yprasium,"Yprasium is refined and crafted into components, modules and other items.",Yprasium.png,uncommon,1226,0,0,1226,0
2353,929,2052,117,Yprasium,"Yprasium is refined and crafted into components, modules and other items.",Yprasium.png,uncommon,2563,0,0,2563,0
2353,947,2052,107,H2O,"H2O is refined and crafted into components, modules and other items.",H20.png,abundant,5212,0,0,5212,0
2353,930,8152,118,Platinyx,"Platinyx is refined and crafted into components, modules and other items.",Platinyx.png,uncommon,2272,0,0,2272,0
2353,946,8152,114,Ectopolymers,"Ectopolymers are refined and crafted into components, modules and other items.",Ectopolymers.png,common,1105,0,0,1105,0
2353,1956,8152,52,Organic Compounds,"Organic Compounds are refined and crafted into components, modules and other items.",Organic_Compound.png,common,5206,0,0,5206,0
2354,4721,2053,120,Metamagnetic Ore,"Metamagnetic Ore is refined and crafted into components, modules and other items.",Metamagnetic_Ore.png,uncommon,1262,0,0,1262,0
2361,3280,2058,115,Nanofluids,"Nanofluids are refined and crafted into components, modules and other items.",Nanofluids.png,common,1012,0,0,1012,0
2361,3281,2058,115,Nanofluids,"Nanofluids are refined and crafted into components, modules and other items.",Nanofluids.png,common,2707,0,0,2707,0
2361,3282,2058,106,Elastomers,"Elastomers are refined and crafted into components, modules and other items.",Elastomers.png,abundant,4677,0,0,4677,0
2362,1359,2059,42,Base Minerals,"Base Minerals are refined and crafted into components, modules and other items.",Base_Mineral.png,abundant,2971,0,0,2971,0
2362,1360,2059,114,Ectopolymers,"Ectopolymers are refined and crafted into components, modules and other items.",Ectopolymers.png,common,2047,0,0,2047,0
2362,2486,2059,128,Tchaikovium,"Tchaikovium is refined and crafted into components, modules and other items.",Tchaikovium.png,rare,655,0,0,655,0
2362,2487,2059,42,Base Minerals,"Base Minerals are refined and crafted into components, modules and other items.",Base_Mineral.png,abundant,4161,0,0,4161,0
2364,2250,2061,110,Plutonium,"Plutonium is refined and crafted into components, modules and other items.",Plutonium.png,common,1339,0,0,1339,0
2364,2251,2061,106,Elastomers,"Elastomers are refined and crafted into components, modules and other items.",Elastomers.png,abundant,4804,0,0,4804,0
2377,4244,2071,42,Base Minerals,"Base Minerals are refined and crafted into components, modules and other items.",Base_Mineral.png,abundant,4008,0,0,4008,0
2377,14524,2071,117,Yprasium,"Yprasium is refined and crafted into components, modules and other items.",Yprasium.png,uncommon,2287,0,0,2287,0
2377,15415,2071,127,Microorganisms,"Microorganisms are refined and crafted into components, modules and other items.",Microorganism.png,rare,843,0,0,843,0
2378,23,2072,114,Ectopolymers,"Ectopolymers are refined and crafted into components, modules and other items.",Ectopolymers.png,common,1420,1420,0,0,1420
2378,465,2072,115,Nanofluids,"Nanofluids are refined and crafted into components, modules and other items.",Nanofluids.png,common,2666,2004,0,662,2004
2378,466,2072,115,Nanofluids,"Nanofluids are refined and crafted into components, modules and other items.",Nanofluids.png,common,4818,0,0,4818,0
2378,48,8172,121,Hypoatomic Substances,"Hypoatomic Substances are refined and crafted into components, modules and other items.",Hypoatomic_Substances.png,uncommon,1442,1442,0,0,1442
2378,49,8172,121,Hypoatomic Substances,"Hypoatomic Substances are refined and crafted into components, modules and other items.",Hypoatomic_Substances.png,uncommon,1243,0,0,1243,0
2378,464,8172,107,H2O,"H2O is refined and crafted into components, modules and other items.",H20.png,abundant,2230,0,0,2230,0
2378,468,8172,105,Silicates,"Silicates are refined and crafted into components, modules and other items.",Silicates.png,abundant,5209,0,0,5209,0
2379,938,2073,126,Bruma Particles,"Bruma Particles are refined and crafted into components, modules and other items.",Bruma_Particle.png,rare,858,0,0,858,0
2379,1055,2073,53,Ignis Ore,"Ignis Ore is refined and crafted into components, modules and other items.",Ignis_Ore.png,rare,3300,0,0,3300,0
2379,1059,2073,107,H2O,"H2O is refined and crafted into components, modules and other items.",H20.png,abundant,2205,0,0,2205,0
2379,4551,8173,117,Yprasium,"Yprasium is refined and crafted into components, modules and other items.",Yprasium.png,uncommon,1032,0,0,1032,0
2379,4560,8173,115,Nanofluids,"Nanofluids are refined and crafted into components, modules and other items.",Nanofluids.png,common,4801,0,0,4801,0
2379,4653,8173,113,Aerogens,"Aerogens are refined and crafted into components, modules and other items.",Aerogens.png,common,2553,0,0,2553,0
2385,530,2078,109,Titanium,"Titanium is refined and crafted into components, modules and other items.",Titanium.png,common,2657,0,0,2657,0
2385,531,2078,113,Aerogens,"Aerogens are refined and crafted into components, modules and other items.",Aerogens.png,common,1191,0,0,1191,0
2385,855,2078,113,Aerogens,"Aerogens are refined and crafted into components, modules and other items.",Aerogens.png,common,5758,0,0,5758,0
2392,3084,2085,105,Silicates,"Silicates are refined and crafted into components, modules and other items.",Silicates.png,abundant,5473,5473,0,0,5473
2392,3310,2085,117,Yprasium,"Yprasium is refined and crafted into components, modules and other items.",Yprasium.png,uncommon,2953,0,0,2953,0
2392,4679,2085,114,Ectopolymers,"Ectopolymers are refined and crafted into components, modules and other items.",Ectopolymers.png,common,1340,0,0,1340,0
2396,1743,2088,114,Ectopolymers,"Ectopolymers are refined and crafted into components, modules and other items.",Ectopolymers.png,common,4198,0,0,4198,0
2396,1870,2088,54,Hyperspecular Crystals,"Hyperspecular Crystals are refined and crafted into components, modules and other items.",Hyperspecular_Crystals.png,uncommon,1012,0,0,1012,0
2396,2026,2088,119,Novis Compounds,"Novis Compounds are refined and crafted into components, modules and other items.",Novis_Compound.png,uncommon,2183,0,0,2183,0
2396,2366,8188,119,Novis Compounds,"Novis Compounds are refined and crafted into components, modules and other items.",Novis_Compound.png,uncommon,2681,0,0,2681,0
2396,4418,8188,128,Tchaikovium,"Tchaikovium is refined and crafted into components, modules and other items.",Tchaikovium.png,rare,625,625,0,0,625
2396,4485,8188,42,Base Minerals,"Base Minerals are refined and crafted into components, modules and other items.",Base_Mineral.png,abundant,4755,0,0,4755,0
2397,3048,2089,118,Platinyx,"Platinyx is refined and crafted into components, modules and other items.",Platinyx.png,uncommon,1194,0,0,1194,0
2397,3049,2089,126,Bruma Particles,"Bruma Particles are refined and crafted into components, modules and other items.",Bruma_Particle.png,rare,845,0,0,845,0
2397,3050,2089,54,Hyperspecular Crystals,"Hyperspecular Crystals are refined and crafted into components, modules and other items.",Hyperspecular_Crystals.png,uncommon,2419,0,0,2419,0
2397,3051,2089,106,Elastomers,"Elastomers are refined and crafted into components, modules and other items.",Elastomers.png,abundant,5975,0,0,5975,0
2403,2252,2092,128,Tchaikovium,"Tchaikovium is refined and crafted into components, modules and other items.",Tchaikovium.png,rare,754,0,0,754,0
2403,2253,2092,42,Base Minerals,"Base Minerals are refined and crafted into components, modules and other items.",Base_Mineral.png,abundant,5838,0,0,5838,0
2411,2044,2096,127,Microorganisms,"Microorganisms are refined and crafted into components, modules and other items.",Microorganism.png,rare,870,0,0,870,0
2411,2045,2096,127,Microorganisms,"Microorganisms are refined and crafted into components, modules and other items.",Microorganism.png,rare,865,0,0,865,0
2411,2046,2096,109,Titanium,"Titanium is refined and crafted into components, modules and other items.",Titanium.png,common,2607,0,0,2607,0
2411,2047,2096,42,Base Minerals,"Base Minerals are refined and crafted into components, modules and other items.",Base_Mineral.png,abundant,4426,0,0,4426,0
2411,2048,2096,113,Aerogens,"Aerogens are refined and crafted into components, modules and other items.",Aerogens.png,common,4454,0,0,4454,0
2414,7611,2098,120,Metamagnetic Ore,"Metamagnetic Ore is refined and crafted into components, modules and other items.",Metamagnetic_Ore.png,uncommon,2133,0,0,2133,0
2414,7612,8198,112,Amphoteric Substances,"Amphoteric Substances are refined and crafted into components, modules and other items.",Amphoteric_Substances.png,common,2420,0,0,2420,0
2418,1127,2102,42,Base Minerals,"Base Minerals are refined and crafted into components, modules and other items.",Base_Mineral.png,abundant,5215,0,0,5215,0
2418,1173,2102,110,Plutonium,"Plutonium is refined and crafted into components, modules and other items.",Plutonium.png,common,1291,0,0,1291,0
2418,1224,2102,114,Ectopolymers,"Ectopolymers are refined and crafted into components, modules and other items.",Ectopolymers.png,common,2259,0,0,2259,0
2418,18051,8202,110,Plutonium,"Plutonium is refined and crafted into components, modules and other items.",Plutonium.png,common,1022,0,0,1022,0
2418,18052,8202,54,Hyperspecular Crystals,"Hyperspecular Crystals are refined and crafted into components, modules and other items.",Hyperspecular_Crystals.png,uncommon,1400,0,0,1400,0
2418,18053,8202,40,Polymetals,"Polymetals are refined and crafted into components, modules and other items.",Polymetals.png,common,2635,0,0,2635,0
2418,18054,8202,42,Base Minerals,"Base Minerals are refined and crafted into components, modules and other items.",Base_Mineral.png,abundant,5516,0,0,5516,0
2429,509,2110,115,Nanofluids,"Nanofluids are refined and crafted into components, modules and other items.",Nanofluids.png,common,1395,0,0,1395,0
2429,515,2110,115,Nanofluids,"Nanofluids are refined and crafted into components, modules and other items.",Nanofluids.png,common,2382,0,0,2382,0
2429,516,2110,121,Hypoatomic Substances,"Hypoatomic Substances are refined and crafted into components, modules and other items.",Hypoatomic_Substances.png,uncommon,5952,0,0,5952,0
2444,2232,2120,127,Microorganisms,"Microorganisms are refined and crafted into components, modules and other items.",Microorganism.png,rare,616,248,0,368,248
2444,2421,2120,107,H2O,"H2O is refined and crafted into components, modules and other items.",H20.png,abundant,2966,0,0,2966,0
2444,2458,2120,42,Base Minerals,"Base Minerals are refined and crafted into components, modules and other items.",Base_Mineral.png,abundant,5797,1160,0,4637,1160
2457,2887,2128,128,Tchaikovium,"Tchaikovium is refined and crafted into components, modules and other items.",Tchaikovium.png,rare,831,0,0,831,0
2457,2888,2128,110,Plutonium,"Plutonium is refined and crafted into components, modules and other items.",Plutonium.png,common,2448,0,0,2448,0
2457,2889,2128,106,Elastomers,"Elastomers are refined and crafted into components, modules and other items.",Elastomers.png,abundant,5258,0,0,5258,0
2460,39,2131,112,Amphoteric Substances,"Amphoteric Substances are refined and crafted into components, modules and other items.",Amphoteric_Substances.png,common,2478,0,0,2478,0
2460,432,2131,105,Silicates,"Silicates are refined and crafted into components, modules and other items.",Silicates.png,abundant,5007,3006,0,2001,3006
2460,500,2131,112,Amphoteric Substances,"Amphoteric Substances are refined and crafted into components, modules and other items.",Amphoteric_Substances.png,common,1341,0,0,1341,0
2460,1925,8231,40,Polymetals,"Polymetals are refined and crafted into components, modules and other items.",Polymetals.png,common,2634,0,0,2634,0
2460,4139,8231,115,Nanofluids,"Nanofluids are refined and crafted into components, modules and other items.",Nanofluids.png,common,5895,0,0,5895,0
2460,4210,8231,112,Amphoteric Substances,"Amphoteric Substances are refined and crafted into components, modules and other items.",Amphoteric_Substances.png,common,1071,0,0,1071,0
2461,621,2132,117,Yprasium,"Yprasium is refined and crafted into components, modules and other items.",Yprasium.png,uncommon,1102,0,0,1102,0
2461,622,2132,126,Bruma Particles,"Bruma Particles are refined and crafted into components, modules and other items.",Bruma_Particle.png,rare,843,0,0,843,0
2462,2457,2133,126,Bruma Particles,"Bruma Particles are refined and crafted into components, modules and other items.",Bruma_Particle.png,rare,630,0,0,630,0
2462,3001,2133,109,Titanium,"Titanium is refined and crafted into components, modules and other items.",Titanium.png,common,2292,574,0,1718,574
2462,5578,2133,115,Nanofluids,"Nanofluids are refined and crafted into components, modules and other items.",Nanofluids.png,common,4694,940,0,3754,940
2463,595,2134,113,Aerogens,"Aerogens are refined and crafted into components, modules and other items.",Aerogens.png,common,2389,0,0,2389,0
2463,870,2134,126,Bruma Particles,"Bruma Particles are refined and crafted into components, modules and other items.",Bruma_Particle.png,rare,686,0,0,686,0
2463,897,2134,42,Base Minerals,"Base Minerals are refined and crafted into components, modules and other items.",Base_Mineral.png,abundant,4903,0,0,4903,0
2463,3042,8234,123,Neolysium,"Neolysium is refined and crafted into components, modules and other items.",Neolysium.png,uncommon,1404,0,0,1404,0
2463,4850,8234,113,Aerogens,"Aerogens are refined and crafted into components, modules and other items.",Aerogens.png,common,2750,0,0,2750,0
2463,7618,8234,109,Titanium,"Titanium is refined and crafted into components, modules and other items.",Titanium.png,common,5734,0,0,5734,0
2464,1597,2135,106,Elastomers,"Elastomers are refined and crafted into components, modules and other items.",Elastomers.png,abundant,4471,1344,0,3127,1344
2464,2339,2135,42,Base Minerals,"Base Minerals are refined and crafted into components, modules and other items.",Base_Mineral.png,abundant,2820,0,0,2820,0
2466,4657,2137,40,Polymetals,"Polymetals are refined and crafted into components, modules and other items.",Polymetals.png,common,2164,0,0,2164,0
2466,4662,2137,106,Elastomers,"Elastomers are refined and crafted into components, modules and other items.",Elastomers.png,abundant,4281,0,0,4281,0
2466,4706,2137,112,Amphoteric Substances,"Amphoteric Substances are refined and crafted into components, modules and other items.",Amphoteric_Substances.png,common,1001,0,0,1001,0
2466,17364,8237,119,Novis Compounds,"Novis Compounds are refined and crafted into components, modules and other items.",Novis_Compound.png,uncommon,1308,0,0,1308,0
2466,17365,8237,105,Silicates,"Silicates are refined and crafted into components, modules and other items.",Silicates.png,abundant,4135,0,0,4135,0
2466,17961,8237,107,H2O,"H2O is refined and crafted into components, modules and other items.",H20.png,abundant,2587,0,0,2587,0
2467,17524,2138,53,Ignis Ore,"Ignis Ore is refined and crafted into components, modules and other items.",Ignis_Ore.png,rare,795,0,0,795,0
2474,10859,8244,114,Ectopolymers,"Ectopolymers are refined and crafted into components, modules and other items.",Ectopolymers.png,common,1057,0,0,1057,0
2476,6009,2146,118,Platinyx,"Platinyx is refined and crafted into components, modules and other items.",Platinyx.png,uncommon,1042,0,0,1042,0
2476,12245,2146,105,Silicates,"Silicates are refined and crafted into components, modules and other items.",Silicates.png,abundant,4101,0,0,4101,0
2476,14092,2146,52,Organic Compounds,"Organic Compounds are refined and crafted into components, modules and other items.",Organic_Compound.png,common,2837,0,0,2837,0
2484,2233,2151,126,Bruma Particles,"Bruma Particles are refined and crafted into components, modules and other items.",Bruma_Particle.png,rare,668,0,0,668,0
2484,2422,2151,113,Aerogens,"Aerogens are refined and crafted into components, modules and other items.",Aerogens.png,common,2993,375,0,2618,375
2484,2557,2151,106,Elastomers,"Elastomers are refined and crafted into components, modules and other items.",Elastomers.png,abundant,4954,0,0,4954,0
2486,679,8253,106,Elastomers,"Elastomers are refined and crafted into components, modules and other items.",Elastomers.png,abundant,4915,0,0,4915,0
2486,680,8253,119,Novis Compounds,"Novis Compounds are refined and crafted into components, modules and other items.",Novis_Compound.png,uncommon,4411,0,0,4411,0
2490,20695,2156,106,Elastomers,"Elastomers are refined and crafted into components, modules and other items.",Elastomers.png,abundant,5335,0,0,5335,0
2490,20696,2156,106,Elastomers,"Elastomers are refined and crafted into components, modules and other items.",Elastomers.png,abundant,5946,0,0,5946,0
2497,3283,2161,117,Yprasium,"Yprasium is refined and crafted into components, modules and other items.",Yprasium.png,uncommon,1428,0,0,1428,0
2497,3284,2161,41,Xensium,"Xensium is refined and crafted into components, modules and other items.",Xensium.png,uncommon,2371,0,0,2371,0
2497,3285,2161,105,Silicates,"Silicates are refined and crafted into components, modules and other items.",Silicates.png,abundant,4631,0,0,4631,0
2498,2775,2162,53,Ignis Ore,"Ignis Ore is refined and crafted into components, modules and other items.",Ignis_Ore.png,rare,826,664,0,162,664
2498,3104,2162,52,Organic Compounds,"Organic Compounds are refined and crafted into components, modules and other items.",Organic_Compound.png,common,2743,686,0,2057,686
2498,3105,2162,42,Base Minerals,"Base Minerals are refined and crafted into components, modules and other items.",Base_Mineral.png,abundant,2847,712,0,2135,712
2498,5580,2162,107,H2O,"H2O is refined and crafted into components, modules and other items.",H20.png,abundant,5271,1584,0,3687,1584
2500,2890,2164,127,Microorganisms,"Microorganisms are refined and crafted into components, modules and other items.",Microorganism.png,rare,745,0,0,745,0
2500,2891,2164,112,Amphoteric Substances,"Amphoteric Substances are refined and crafted into components, modules and other items.",Amphoteric_Substances.png,common,2570,0,0,2570,0
2500,2892,2164,107,H2O,"H2O is refined and crafted into components, modules and other items.",H20.png,abundant,5805,0,0,5805,0
2504,4828,2167,40,Polymetals,"Polymetals are refined and crafted into components, modules and other items.",Polymetals.png,common,4512,0,0,4512,0
2504,5248,2167,119,Novis Compounds,"Novis Compounds are refined and crafted into components, modules and other items.",Novis_Compound.png,uncommon,1179,0,0,1179,0
2504,5583,2167,112,Amphoteric Substances,"Amphoteric Substances are refined and crafted into components, modules and other items.",Amphoteric_Substances.png,common,2334,0,0,2334,0
2504,6437,8267,41,Xensium,"Xensium is refined and crafted into components, modules and other items.",Xensium.png,uncommon,5718,0,0,5718,0
2504,6767,8267,112,Amphoteric Substances,"Amphoteric Substances are refined and crafted into components, modules and other items.",Amphoteric_Substances.png,common,1242,0,0,1242,0
2504,7762,8267,106,Elastomers,"Elastomers are refined and crafted into components, modules and other items.",Elastomers.png,abundant,2028,0,0,2028,0
2507,232,2169,105,Silicates,"Silicates are refined and crafted into components, modules and other items.",Silicates.png,abundant,5106,0,0,5106,0
2511,3005,2171,53,Ignis Ore,"Ignis Ore is refined and crafted into components, modules and other items.",Ignis_Ore.png,rare,611,0,0,611,0
2511,3115,2171,52,Organic Compounds,"Organic Compounds are refined and crafted into components, modules and other items.",Organic_Compound.png,common,2062,0,0,2062,0
2511,5581,2171,106,Elastomers,"Elastomers are refined and crafted into components, modules and other items.",Elastomers.png,abundant,5603,1122,0,4481,1122
2513,14635,2173,112,Amphoteric Substances,"Amphoteric Substances are refined and crafted into components, modules and other items.",Amphoteric_Substances.png,common,1217,0,0,1217,0
2513,14636,2173,112,Amphoteric Substances,"Amphoteric Substances are refined and crafted into components, modules and other items.",Amphoteric_Substances.png,common,2861,0,0,2861,0
2517,16106,2177,126,Bruma Particles,"Bruma Particles are refined and crafted into components, modules and other items.",Bruma_Particle.png,rare,810,0,0,810,0
2517,16963,2177,113,Aerogens,"Aerogens are refined and crafted into components, modules and other items.",Aerogens.png,common,2471,0,0,2471,0
2517,16964,2177,109,Titanium,"Titanium is refined and crafted into components, modules and other items.",Titanium.png,common,2416,0,0,2416,0
2517,17731,2177,42,Base Minerals,"Base Minerals are refined and crafted into components, modules and other items.",Base_Mineral.png,abundant,4197,0,0,4197,0
2517,17799,8277,107,H2O,"H2O is refined and crafted into components, modules and other items.",H20.png,abundant,4069,0,0,4069,0
2522,17740,2179,120,Metamagnetic Ore,"Metamagnetic Ore is refined and crafted into components, modules and other items.",Metamagnetic_Ore.png,uncommon,2307,0,0,2307,0
2522,17741,2179,110,Plutonium,"Plutonium is refined and crafted into components, modules and other items.",Plutonium.png,common,1466,0,0,1466,0
2522,3931,8279,105,Silicates,"Silicates are refined and crafted into components, modules and other items.",Silicates.png,abundant,5379,0,0,5379,0
2522,17956,8279,128,Tchaikovium,"Tchaikovium is refined and crafted into components, modules and other items.",Tchaikovium.png,rare,770,0,0,770,0
2523,2088,2180,128,Tchaikovium,"Tchaikovium is refined and crafted into components, modules and other items.",Tchaikovium.png,rare,695,0,0,695,0
2523,2089,2180,110,Plutonium,"Plutonium is refined and crafted into components, modules and other items.",Plutonium.png,common,2295,0,0,2295,0
2523,2090,2180,105,Silicates,"Silicates are refined and crafted into components, modules and other items.",Silicates.png,abundant,4616,0,0,4616,0
2538,3286,2186,115,Nanofluids,"Nanofluids are refined and crafted into components, modules and other items.",Nanofluids.png,common,1160,0,0,1160,0
2538,3287,2186,113,Aerogens,"Aerogens are refined and crafted into components, modules and other items.",Aerogens.png,common,2771,0,0,2771,0
2538,3288,2186,42,Base Minerals,"Base Minerals are refined and crafted into components, modules and other items.",Base_Mineral.png,abundant,4648,0,0,4648,0
2539,2234,2187,123,Neolysium,"Neolysium is refined and crafted into components, modules and other items.",Neolysium.png,uncommon,1237,0,0,1237,0
2539,2432,2187,113,Aerogens,"Aerogens are refined and crafted into components, modules and other items.",Aerogens.png,common,2332,0,0,2332,0
2539,2578,2187,112,Amphoteric Substances,"Amphoteric Substances are refined and crafted into components, modules and other items.",Amphoteric_Substances.png,common,5366,1074,0,4292,1074
2547,2037,2192,113,Aerogens,"Aerogens are refined and crafted into components, modules and other items.",Aerogens.png,common,1242,249,0,993,249
2547,2954,2192,105,Silicates,"Silicates are refined and crafted into components, modules and other items.",Silicates.png,abundant,2894,0,0,2894,0
2547,2956,2192,113,Aerogens,"Aerogens are refined and crafted into components, modules and other items.",Aerogens.png,common,5947,0,0,5947,0
2549,20697,2194,40,Polymetals,"Polymetals are refined and crafted into components, modules and other items.",Polymetals.png,common,4659,0,0,4659,0
2550,8067,2195,119,Novis Compounds,"Novis Compounds are refined and crafted into components, modules and other items.",Novis_Compound.png,uncommon,1070,214,0,856,214
2550,8255,2195,114,Ectopolymers,"Ectopolymers are refined and crafted into components, modules and other items.",Ectopolymers.png,common,2364,0,0,2364,0
2550,8256,2195,42,Base Minerals,"Base Minerals are refined and crafted into components, modules and other items.",Base_Mineral.png,abundant,5531,3878,0,1653,3878
2550,8257,2195,42,Base Minerals,"Base Minerals are refined and crafted into components, modules and other items.",Base_Mineral.png,abundant,4708,942,0,3766,942
2550,8065,8295,114,Ectopolymers,"Ectopolymers are refined and crafted into components, modules and other items.",Ectopolymers.png,common,2859,0,0,2859,0
2550,8066,8295,106,Elastomers,"Elastomers are refined and crafted into components, modules and other items.",Elastomers.png,abundant,2150,1883,0,267,1883
2550,8198,8295,128,Tchaikovium,"Tchaikovium is refined and crafted into components, modules and other items.",Tchaikovium.png,rare,855,342,0,513,342
2550,8199,8295,107,H2O,"H2O is refined and crafted into components, modules and other items.",H20.png,abundant,5272,2640,0,2632,2640
2553,1361,2197,121,Hypoatomic Substances,"Hypoatomic Substances are refined and crafted into components, modules and other items.",Hypoatomic_Substances.png,uncommon,2340,0,0,2340,0
2553,2837,2197,121,Hypoatomic Substances,"Hypoatomic Substances are refined and crafted into components, modules and other items.",Hypoatomic_Substances.png,uncommon,1487,0,0,1487,0
2553,2838,2197,106,Elastomers,"Elastomers are refined and crafted into components, modules and other items.",Elastomers.png,abundant,4795,0,0,4795,0
2554,3701,2198,53,Ignis Ore,"Ignis Ore is refined and crafted into components, modules and other items.",Ignis_Ore.png,rare,789,0,0,789,0
2554,3702,2198,120,Metamagnetic Ore,"Metamagnetic Ore is refined and crafted into components, modules and other items.",Metamagnetic_Ore.png,uncommon,2342,0,0,2342,0
2554,3703,2198,42,Base Minerals,"Base Minerals are refined and crafted into components, modules and other items.",Base_Mineral.png,abundant,4859,0,0,4859,0
2559,1610,2202,40,Polymetals,"Polymetals are refined and crafted into components, modules and other items.",Polymetals.png,common,5482,0,0,5482,0
2559,1909,2202,42,Base Minerals,"Base Minerals are refined and crafted into components, modules and other items.",Base_Mineral.png,abundant,2431,0,0,2431,0
2559,2141,2202,128,Tchaikovium,"Tchaikovium is refined and crafted into components, modules and other items.",Tchaikovium.png,rare,786,0,0,786,0
2559,3715,8302,40,Polymetals,"Polymetals are refined and crafted into components, modules and other items.",Polymetals.png,common,2651,0,0,2651,0
2559,4689,8302,128,Tchaikovium,"Tchaikovium is refined and crafted into components, modules and other items.",Tchaikovium.png,rare,836,0,0,836,0
2559,4690,8302,105,Silicates,"Silicates are refined and crafted into components, modules and other items.",Silicates.png,abundant,5251,0,0,5251,0
2561,1362,2203,106,Elastomers,"Elastomers are refined and crafted into components, modules and other items.",Elastomers.png,abundant,2577,0,0,2577,0
2561,2839,2203,113,Aerogens,"Aerogens are refined and crafted into components, modules and other items.",Aerogens.png,common,1221,0,0,1221,0
2561,2840,2203,107,H2O,"H2O is refined and crafted into components, modules and other items.",H20.png,abundant,5783,0,0,5783,0
2566,10627,8307,105,Silicates,"Silicates are refined and crafted into components, modules and other items.",Silicates.png,abundant,5071,0,0,5071,0
2566,10628,8307,126,Bruma Particles,"Bruma Particles are refined and crafted into components, modules and other items.",Bruma_Particle.png,rare,658,0,0,658,0
2566,10629,8307,113,Aerogens,"Aerogens are refined and crafted into components, modules and other items.",Aerogens.png,common,1050,0,0,1050,0
2566,10630,8307,110,Plutonium,"Plutonium is refined and crafted into components, modules and other items.",Plutonium.png,common,2065,0,0,2065,0
2568,2997,2209,119,Novis Compounds,"Novis Compounds are refined and crafted into components, modules and other items.",Novis_Compound.png,uncommon,1318,0,0,1318,0
2568,3046,2209,107,H2O,"H2O is refined and crafted into components, modules and other items.",H20.png,abundant,2107,0,0,2107,0
2568,3303,2209,42,Base Minerals,"Base Minerals are refined and crafted into components, modules and other items.",Base_Mineral.png,abundant,5185,3114,0,2071,3114
2575,2322,2213,120,Metamagnetic Ore,"Metamagnetic Ore is refined and crafted into components, modules and other items.",Metamagnetic_Ore.png,uncommon,2860,0,0,2860,0
2575,17933,2213,109,Titanium,"Titanium is refined and crafted into components, modules and other items.",Titanium.png,common,4143,0,0,4143,0
2579,22,2217,106,Elastomers,"Elastomers are refined and crafted into components, modules and other items.",Elastomers.png,abundant,2216,2216,0,0,2216
2579,414,2217,114,Ectopolymers,"Ectopolymers are refined and crafted into components, modules and other items.",Ectopolymers.png,common,5809,0,0,5809,0
2579,415,2217,107,H2O,"H2O is refined and crafted into components, modules and other items.",H20.png,abundant,4988,0,0,4988,0
2579,884,2217,128,Tchaikovium,"Tchaikovium is refined and crafted into components, modules and other items.",Tchaikovium.png,rare,877,0,0,877,0
2579,2055,8317,114,Ectopolymers,"Ectopolymers are refined and crafted into components, modules and other items.",Ectopolymers.png,common,1197,0,0,1197,0
2579,2569,8317,110,Plutonium,"Plutonium is refined and crafted into components, modules and other items.",Plutonium.png,common,5319,0,0,5319,0
2579,2953,8317,110,Plutonium,"Plutonium is refined and crafted into components, modules and other items.",Plutonium.png,common,2688,0,0,2688,0
2584,19794,2220,120,Metamagnetic Ore,"Metamagnetic Ore is refined and crafted into components, modules and other items.",Metamagnetic_Ore.png,uncommon,1018,204,0,814,204
2584,19795,2220,107,H2O,"H2O is refined and crafted into components, modules and other items.",H20.png,abundant,2254,282,0,1972,282
2584,19796,2220,106,Elastomers,"Elastomers are refined and crafted into components, modules and other items.",Elastomers.png,abundant,4380,438,0,3942,438
2584,19797,2220,119,Novis Compounds,"Novis Compounds are refined and crafted into components, modules and other items.",Novis_Compound.png,uncommon,5900,590,0,5310,590
2584,19798,8320,118,Platinyx,"Platinyx is refined and crafted into components, modules and other items.",Platinyx.png,uncommon,1386,278,0,1108,278
2584,19799,8320,40,Polymetals,"Polymetals are refined and crafted into components, modules and other items.",Polymetals.png,common,1348,270,0,1078,270
2584,19800,8320,110,Plutonium,"Plutonium is refined and crafted into components, modules and other items.",Plutonium.png,common,2150,0,0,2150,0
2584,19801,8320,105,Silicates,"Silicates are refined and crafted into components, modules and other items.",Silicates.png,abundant,4054,0,0,4054,0
2585,18878,2221,114,Ectopolymers,"Ectopolymers are refined and crafted into components, modules and other items.",Ectopolymers.png,common,4283,429,0,3854,429
2585,19339,2221,117,Yprasium,"Yprasium is refined and crafted into components, modules and other items.",Yprasium.png,uncommon,1401,0,0,1401,0
2585,19605,2221,118,Platinyx,"Platinyx is refined and crafted into components, modules and other items.",Platinyx.png,uncommon,2385,0,0,2385,0
2588,660,2224,53,Ignis Ore,"Ignis Ore is refined and crafted into components, modules and other items.",Ignis_Ore.png,rare,661,266,0,395,266
2588,661,2224,42,Base Minerals,"Base Minerals are refined and crafted into components, modules and other items.",Base_Mineral.png,abundant,2739,0,0,2739,0
2588,910,2224,112,Amphoteric Substances,"Amphoteric Substances are refined and crafted into components, modules and other items.",Amphoteric_Substances.png,common,4415,0,0,4415,0
2591,7596,2227,107,H2O,"H2O is refined and crafted into components, modules and other items.",H20.png,abundant,5219,0,0,5219,0
2592,1196,2228,128,Tchaikovium,"Tchaikovium is refined and crafted into components, modules and other items.",Tchaikovium.png,rare,741,0,0,741,0
2592,1288,2228,106,Elastomers,"Elastomers are refined and crafted into components, modules and other items.",Elastomers.png,abundant,4153,0,0,4153,0
2592,1456,2228,110,Plutonium,"Plutonium is refined and crafted into components, modules and other items.",Plutonium.png,common,2070,0,0,2070,0
2592,1457,2228,40,Polymetals,"Polymetals are refined and crafted into components, modules and other items.",Polymetals.png,common,2984,0,0,2984,0
2593,1349,2229,123,Neolysium,"Neolysium is refined and crafted into components, modules and other items.",Neolysium.png,uncommon,1290,258,0,1032,258
2593,1652,2229,106,Elastomers,"Elastomers are refined and crafted into components, modules and other items.",Elastomers.png,abundant,4532,454,0,4078,454
2593,1692,2229,119,Novis Compounds,"Novis Compounds are refined and crafted into components, modules and other items.",Novis_Compound.png,uncommon,2426,304,0,2122,304
2593,3706,8329,114,Ectopolymers,"Ectopolymers are refined and crafted into components, modules and other items.",Ectopolymers.png,common,1161,0,0,1161,0
2593,4207,8329,112,Amphoteric Substances,"Amphoteric Substances are refined and crafted into components, modules and other items.",Amphoteric_Substances.png,common,2099,0,0,2099,0
2593,4237,8329,105,Silicates,"Silicates are refined and crafted into components, modules and other items.",Silicates.png,abundant,4907,0,0,4907,0
2594,1363,2230,110,Plutonium,"Plutonium is refined and crafted into components, modules and other items.",Plutonium.png,common,2565,0,0,2565,0
2594,2841,2230,118,Platinyx,"Platinyx is refined and crafted into components, modules and other items.",Platinyx.png,uncommon,1233,0,0,1233,0
2594,2842,2230,105,Silicates,"Silicates are refined and crafted into components, modules and other items.",Silicates.png,abundant,5202,0,0,5202,0
2596,20735,2231,105,Silicates,"Silicates are refined and crafted into components, modules and other items.",Silicates.png,abundant,4528,0,0,4528,0
2598,2999,2233,128,Tchaikovium,"Tchaikovium is refined and crafted into components, modules and other items.",Tchaikovium.png,rare,826,0,0,826,0
2598,3086,2233,41,Xensium,"Xensium is refined and crafted into components, modules and other items.",Xensium.png,uncommon,2650,0,0,2650,0
2598,3362,2233,106,Elastomers,"Elastomers are refined and crafted into components, modules and other items.",Elastomers.png,abundant,4960,0,0,4960,0
2620,2254,2245,109,Titanium,"Titanium is refined and crafted into components, modules and other items.",Titanium.png,common,1066,0,0,1066,0
2620,2255,2245,107,H2O,"H2O is refined and crafted into components, modules and other items.",H20.png,abundant,4011,0,0,4011,0
2621,2061,2246,121,Hypoatomic Substances,"Hypoatomic Substances are refined and crafted into components, modules and other items.",Hypoatomic_Substances.png,uncommon,2369,0,0,2369,0
2621,3150,2246,105,Silicates,"Silicates are refined and crafted into components, modules and other items.",Silicates.png,abundant,5218,1044,0,4174,1044
2621,7595,2246,126,Bruma Particles,"Bruma Particles are refined and crafted into components, modules and other items.",Bruma_Particle.png,rare,616,0,0,616,0
2621,7669,8346,42,Base Minerals,"Base Minerals are refined and crafted into components, modules and other items.",Base_Mineral.png,abundant,2635,0,0,2635,0
2625,2082,2249,53,Ignis Ore,"Ignis Ore is refined and crafted into components, modules and other items.",Ignis_Ore.png,rare,833,0,0,833,0
2625,2083,2249,110,Plutonium,"Plutonium is refined and crafted into components, modules and other items.",Plutonium.png,common,2683,0,0,2683,0
2625,2084,2249,42,Base Minerals,"Base Minerals are refined and crafted into components, modules and other items.",Base_Mineral.png,abundant,4545,0,0,4545,0
2626,605,2250,52,Organic Compounds,"Organic Compounds are refined and crafted into components, modules and other items.",Organic_Compound.png,common,1048,0,0,1048,0
2626,606,2250,118,Platinyx,"Platinyx is refined and crafted into components, modules and other items.",Platinyx.png,uncommon,2198,0,0,2198,0
2626,4827,2250,54,Hyperspecular Crystals,"Hyperspecular Crystals are refined and crafted into components, modules and other items.",Hyperspecular_Crystals.png,uncommon,5252,0,0,5252,0
2626,4846,8350,42,Base Minerals,"Base Minerals are refined and crafted into components, modules and other items.",Base_Mineral.png,abundant,2825,0,0,2825,0
2626,4851,8350,53,Ignis Ore,"Ignis Ore is refined and crafted into components, modules and other items.",Ignis_Ore.png,rare,702,0,0,702,0
2626,4852,8350,128,Tchaikovium,"Tchaikovium is refined and crafted into components, modules and other items.",Tchaikovium.png,rare,815,0,0,815,0
2626,4876,8350,52,Organic Compounds,"Organic Compounds are refined and crafted into components, modules and other items.",Organic_Compound.png,common,5694,0,0,5694,0
2630,101,2253,115,Nanofluids,"Nanofluids are refined and crafted into components, modules and other items.",Nanofluids.png,common,1192,0,0,1192,0
2630,1128,2253,106,Elastomers,"Elastomers are refined and crafted into components, modules and other items.",Elastomers.png,abundant,5093,0,0,5093,0
2630,1351,2253,106,Elastomers,"Elastomers are refined and crafted into components, modules and other items.",Elastomers.png,abundant,2476,0,0,2476,0
2630,1352,2253,105,Silicates,"Silicates are refined and crafted into components, modules and other items.",Silicates.png,abundant,2801,0,0,2801,0
2630,3128,8353,126,Bruma Particles,"Bruma Particles are refined and crafted into components, modules and other items.",Bruma_Particle.png,rare,664,0,0,664,0
2630,3652,8353,109,Titanium,"Titanium is refined and crafted into components, modules and other items.",Titanium.png,common,2663,0,0,2663,0
2630,4297,8353,113,Aerogens,"Aerogens are refined and crafted into components, modules and other items.",Aerogens.png,common,4265,0,0,4265,0
2634,19966,2256,106,Elastomers,"Elastomers are refined and crafted into components, modules and other items.",Elastomers.png,abundant,4688,0,0,4688,0
2650,960,2270,110,Plutonium,"Plutonium is refined and crafted into components, modules and other items.",Plutonium.png,common,4487,0,0,4487,0
2655,18572,2274,115,Nanofluids,"Nanofluids are refined and crafted into components, modules and other items.",Nanofluids.png,common,4396,0,0,4396,0
2656,2256,2275,128,Tchaikovium,"Tchaikovium is refined and crafted into components, modules and other items.",Tchaikovium.png,rare,621,0,0,621,0
2656,2257,2275,42,Base Minerals,"Base Minerals are refined and crafted into components, modules and other items.",Base_Mineral.png,abundant,5939,0,0,5939,0
2657,728,2276,126,Bruma Particles,"Bruma Particles are refined and crafted into components, modules and other items.",Bruma_Particle.png,rare,638,0,0,638,0
2657,918,2276,119,Novis Compounds,"Novis Compounds are refined and crafted into components, modules and other items.",Novis_Compound.png,uncommon,2133,0,0,2133,0
2657,1098,2276,107,H2O,"H2O is refined and crafted into components, modules and other items.",H20.png,abundant,4135,0,0,4135,0
2657,1099,2276,107,H2O,"H2O is refined and crafted into components, modules and other items.",H20.png,abundant,5591,0,0,5591,0
2657,4190,8376,127,Microorganisms,"Microorganisms are refined and crafted into components, modules and other items.",Microorganism.png,rare,738,0,0,738,0
2657,4191,8376,40,Polymetals,"Polymetals are refined and crafted into components, modules and other items.",Polymetals.png,common,2971,0,0,2971,0
2657,4276,8376,106,Elastomers,"Elastomers are refined and crafted into components, modules and other items.",Elastomers.png,abundant,4916,0,0,4916,0
2660,1700,2278,114,Ectopolymers,"Ectopolymers are refined and crafted into components, modules and other items.",Ectopolymers.png,common,1486,0,0,1486,0
2660,1701,2278,128,Tchaikovium,"Tchaikovium is refined and crafted into components, modules and other items.",Tchaikovium.png,rare,1357,0,0,1357,0
2660,1702,2278,119,Novis Compounds,"Novis Compounds are refined and crafted into components, modules and other items.",Novis_Compound.png,uncommon,4542,0,0,4542,0
2667,1584,2282,110,Plutonium,"Plutonium is refined and crafted into components, modules and other items.",Plutonium.png,common,1099,0,0,1099,0
2667,1589,2282,128,Tchaikovium,"Tchaikovium is refined and crafted into components, modules and other items.",Tchaikovium.png,rare,1384,0,0,1384,0
2667,1769,2282,42,Base Minerals,"Base Minerals are refined and crafted into components, modules and other items.",Base_Mineral.png,abundant,4337,0,0,4337,0
2667,6931,8382,120,Metamagnetic Ore,"Metamagnetic Ore is refined and crafted into components, modules and other items.",Metamagnetic_Ore.png,uncommon,1230,0,0,1230,0
2667,7096,8382,52,Organic Compounds,"Organic Compounds are refined and crafted into components, modules and other items.",Organic_Compound.png,common,2186,0,0,2186,0
2667,7360,8382,105,Silicates,"Silicates are refined and crafted into components, modules and other items.",Silicates.png,abundant,5652,0,0,5652,0
2674,17742,2287,112,Amphoteric Substances,"Amphoteric Substances are refined and crafted into components, modules and other items.",Amphoteric_Substances.png,common,2839,0,0,2839,0
2674,17743,2287,119,Novis Compounds,"Novis Compounds are refined and crafted into components, modules and other items.",Novis_Compound.png,uncommon,2171,0,0,2171,0
2674,17957,2287,123,Neolysium,"Neolysium is refined and crafted into components, modules and other items.",Neolysium.png,uncommon,1226,0,0,1226,0
2674,17746,8387,105,Silicates,"Silicates are refined and crafted into components, modules and other items.",Silicates.png,abundant,4225,0,0,4225,0
2674,18646,8387,41,Xensium,"Xensium is refined and crafted into components, modules and other items.",Xensium.png,uncommon,1320,0,0,1320,0
2675,594,2288,114,Ectopolymers,"Ectopolymers are refined and crafted into components, modules and other items.",Ectopolymers.png,common,2438,0,0,2438,0
2675,1322,2288,107,H2O,"H2O is refined and crafted into components, modules and other items.",H20.png,abundant,5017,0,0,5017,0
2675,2314,2288,41,Xensium,"Xensium is refined and crafted into components, modules and other items.",Xensium.png,uncommon,1383,0,0,1383,0
2675,3300,8388,107,H2O,"H2O is refined and crafted into components, modules and other items.",H20.png,abundant,2862,0,0,2862,0
2675,3301,8388,41,Xensium,"Xensium is refined and crafted into components, modules and other items.",Xensium.png,uncommon,2633,0,0,2633,0
2675,3381,8388,127,Microorganisms,"Microorganisms are refined and crafted into components, modules and other items.",Microorganism.png,rare,709,0,0,709,0
2675,3434,8388,106,Elastomers,"Elastomers are refined and crafted into components, modules and other items.",Elastomers.png,abundant,5762,0,0,5762,0
2681,1654,2294,54,Hyperspecular Crystals,"Hyperspecular Crystals are refined and crafted into components, modules and other items.",Hyperspecular_Crystals.png,uncommon,2572,0,0,2572,0
2681,2360,2294,112,Amphoteric Substances,"Amphoteric Substances are refined and crafted into components, modules and other items.",Amphoteric_Substances.png,common,1166,0,0,1166,0
2681,2369,2294,105,Silicates,"Silicates are refined and crafted into components, modules and other items.",Silicates.png,abundant,4540,0,0,4540,0
2681,2370,8394,119,Novis Compounds,"Novis Compounds are refined and crafted into components, modules and other items.",Novis_Compound.png,uncommon,2062,0,0,2062,0
2681,2371,8394,112,Amphoteric Substances,"Amphoteric Substances are refined and crafted into components, modules and other items.",Amphoteric_Substances.png,common,2785,0,0,2785,0
2681,3611,8394,112,Amphoteric Substances,"Amphoteric Substances are refined and crafted into components, modules and other items.",Amphoteric_Substances.png,common,5330,0,0,5330,0
2681,3788,8394,112,Amphoteric Substances,"Amphoteric Substances are refined and crafted into components, modules and other items.",Amphoteric_Substances.png,common,1255,0,0,1255,0
2684,976,2297,42,Base Minerals,"Base Minerals are refined and crafted into components, modules and other items.",Base_Mineral.png,abundant,4179,0,0,4179,0
2684,1041,2297,40,Polymetals,"Polymetals are refined and crafted into components, modules and other items.",Polymetals.png,common,2788,0,0,2788,0
2684,1042,2297,126,Bruma Particles,"Bruma Particles are refined and crafted into components, modules and other items.",Bruma_Particle.png,rare,778,0,0,778,0
2684,1043,8397,42,Base Minerals,"Base Minerals are refined and crafted into components, modules and other items.",Base_Mineral.png,abundant,4410,0,0,4410,0
2684,3140,8397,120,Metamagnetic Ore,"Metamagnetic Ore is refined and crafted into components, modules and other items.",Metamagnetic_Ore.png,uncommon,2623,0,0,2623,0
2686,787,2299,127,Microorganisms,"Microorganisms are refined and crafted into components, modules and other items.",Microorganism.png,rare,671,0,0,671,0
2686,4319,2299,52,Organic Compounds,"Organic Compounds are refined and crafted into components, modules and other items.",Organic_Compound.png,common,2579,0,0,2579,0
2686,4320,2299,52,Organic Compounds,"Organic Compounds are refined and crafted into components, modules and other items.",Organic_Compound.png,common,4358,0,0,4358,0
2686,4321,8399,54,Hyperspecular Crystals,"Hyperspecular Crystals are refined and crafted into components, modules and other items.",Hyperspecular_Crystals.png,uncommon,1108,0,0,1108,0
2686,4322,8399,105,Silicates,"Silicates are refined and crafted into components, modules and other items.",Silicates.png,abundant,2650,0,0,2650,0
2691,1653,2302,119,Novis Compounds,"Novis Compounds are refined and crafted into components, modules and other items.",Novis_Compound.png,uncommon,1235,494,0,741,494
2691,1693,2302,41,Xensium,"Xensium is refined and crafted into components, modules and other items.",Xensium.png,uncommon,2335,0,0,2335,0
2691,1707,2302,107,H2O,"H2O is refined and crafted into components, modules and other items.",H20.png,abundant,4032,0,0,4032,0
2691,4141,8402,120,Metamagnetic Ore,"Metamagnetic Ore is refined and crafted into components, modules and other items.",Metamagnetic_Ore.png,uncommon,1315,0,0,1315,0
2691,4238,8402,42,Base Minerals,"Base Minerals are refined and crafted into components, modules and other items.",Base_Mineral.png,abundant,4210,0,0,4210,0
2691,4239,8402,107,H2O,"H2O is refined and crafted into components, modules and other items.",H20.png,abundant,2310,0,0,2310,0
2692,1136,2303,105,Silicates,"Silicates are refined and crafted into components, modules and other items.",Silicates.png,abundant,5577,0,0,5577,0
2692,1304,2303,126,Bruma Particles,"Bruma Particles are refined and crafted into components, modules and other items.",Bruma_Particle.png,rare,752,0,0,752,0
2698,4592,2307,109,Titanium,"Titanium is refined and crafted into components, modules and other items.",Titanium.png,common,4229,0,0,4229,0
2698,4605,2307,114,Ectopolymers,"Ectopolymers are refined and crafted into components, modules and other items.",Ectopolymers.png,common,1280,0,0,1280,0
2698,4646,2307,53,Ignis Ore,"Ignis Ore is refined and crafted into components, modules and other items.",Ignis_Ore.png,rare,1339,0,0,1339,0
2698,7493,8407,53,Ignis Ore,"Ignis Ore is refined and crafted into components, modules and other items.",Ignis_Ore.png,rare,703,0,0,703,0
2698,9826,8407,53,Ignis Ore,"Ignis Ore is refined and crafted into components, modules and other items.",Ignis_Ore.png,rare,1657,0,0,1657,0
2698,9968,8407,123,Neolysium,"Neolysium is refined and crafted into components, modules and other items.",Neolysium.png,uncommon,4920,0,0,4920,0
2701,1364,2309,113,Aerogens,"Aerogens are refined and crafted into components, modules and other items.",Aerogens.png,common,2505,0,0,2505,0
2701,2843,2309,127,Microorganisms,"Microorganisms are refined and crafted into components, modules and other items.",Microorganism.png,rare,882,0,0,882,0
2701,2844,2309,113,Aerogens,"Aerogens are refined and crafted into components, modules and other items.",Aerogens.png,common,5111,0,0,5111,0
2703,13828,2311,115,Nanofluids,"Nanofluids are refined and crafted into components, modules and other items.",Nanofluids.png,common,2822,0,0,2822,0
2703,14059,2311,107,H2O,"H2O is refined and crafted into components, modules and other items.",H20.png,abundant,5326,0,0,5326,0
2703,15950,2311,128,Tchaikovium,"Tchaikovium is refined and crafted into components, modules and other items.",Tchaikovium.png,rare,896,0,0,896,0
2712,3365,2319,110,Plutonium,"Plutonium is refined and crafted into components, modules and other items.",Plutonium.png,common,4991,0,0,4991,0
2712,3435,2319,110,Plutonium,"Plutonium is refined and crafted into components, modules and other items.",Plutonium.png,common,2345,0,0,2345,0
2713,3323,2320,114,Ectopolymers,"Ectopolymers are refined and crafted into components, modules and other items.",Ectopolymers.png,common,2145,0,0,2145,0
2713,3469,2320,105,Silicates,"Silicates are refined and crafted into components, modules and other items.",Silicates.png,abundant,4085,0,0,4085,0
2714,253,2321,42,Base Minerals,"Base Minerals are refined and crafted into components, modules and other items.",Base_Mineral.png,abundant,2417,303,0,2114,303
2714,357,2321,114,Ectopolymers,"Ectopolymers are refined and crafted into components, modules and other items.",Ectopolymers.png,common,1335,1335,0,0,1335
2714,358,2321,105,Silicates,"Silicates are refined and crafted into components, modules and other items.",Silicates.png,abundant,4947,495,0,4452,495
2714,1983,8421,106,Elastomers,"Elastomers are refined and crafted into components, modules and other items.",Elastomers.png,abundant,5559,2224,0,3335,2224
2714,2396,8421,128,Tchaikovium,"Tchaikovium is refined and crafted into components, modules and other items.",Tchaikovium.png,rare,739,739,0,0,739
2714,2397,8421,40,Polymetals,"Polymetals are refined and crafted into components, modules and other items.",Polymetals.png,common,2653,2653,0,0,2653
2716,1606,2323,112,Amphoteric Substances,"Amphoteric Substances are refined and crafted into components, modules and other items.",Amphoteric_Substances.png,common,5893,0,0,5893,0
2716,1607,2323,105,Silicates,"Silicates are refined and crafted into components, modules and other items.",Silicates.png,abundant,5203,0,0,5203,0
2716,1814,2323,123,Neolysium,"Neolysium is refined and crafted into components, modules and other items.",Neolysium.png,uncommon,1265,0,0,1265,0
2716,1815,2323,54,Hyperspecular Crystals,"Hyperspecular Crystals are refined and crafted into components, modules and other items.",Hyperspecular_Crystals.png,uncommon,2665,0,0,2665,0
2718,1526,2325,107,H2O,"H2O is refined and crafted into components, modules and other items.",H20.png,abundant,4871,0,0,4871,0
2718,1527,2325,109,Titanium,"Titanium is refined and crafted into components, modules and other items.",Titanium.png,common,2607,0,0,2607,0
2718,4760,2325,123,Neolysium,"Neolysium is refined and crafted into components, modules and other items.",Neolysium.png,uncommon,1486,0,0,1486,0
2718,17128,8425,107,H2O,"H2O is refined and crafted into components, modules and other items.",H20.png,abundant,5172,0,0,5172,0
2718,17389,8425,54,Hyperspecular Crystals,"Hyperspecular Crystals are refined and crafted into components, modules and other items.",Hyperspecular_Crystals.png,uncommon,2459,0,0,2459,0
2718,17656,8425,109,Titanium,"Titanium is refined and crafted into components, modules and other items.",Titanium.png,common,1131,0,0,1131,0
2730,1434,2333,40,Polymetals,"Polymetals are refined and crafted into components, modules and other items.",Polymetals.png,common,1214,0,0,1214,0
2730,1561,2333,107,H2O,"H2O is refined and crafted into components, modules and other items.",H20.png,abundant,4806,0,0,4806,0
2730,1966,2333,106,Elastomers,"Elastomers are refined and crafted into components, modules and other items.",Elastomers.png,abundant,2187,0,0,2187,0
2730,1435,8433,119,Novis Compounds,"Novis Compounds are refined and crafted into components, modules and other items.",Novis_Compound.png,uncommon,1216,0,0,1216,0
2730,1967,8433,119,Novis Compounds,"Novis Compounds are refined and crafted into components, modules and other items.",Novis_Compound.png,uncommon,2812,0,0,2812,0
2730,2383,8433,106,Elastomers,"Elastomers are refined and crafted into components, modules and other items.",Elastomers.png,abundant,5284,0,0,5284,0
2732,79,2335,105,Silicates,"Silicates are refined and crafted into components, modules and other items.",Silicates.png,abundant,2998,0,0,2998,0
2732,3501,2335,117,Yprasium,"Yprasium is refined and crafted into components, modules and other items.",Yprasium.png,uncommon,4014,0,0,4014,0
2732,3502,2335,52,Organic Compounds,"Organic Compounds are refined and crafted into components, modules and other items.",Organic_Compound.png,common,5498,0,0,5498,0
2732,4452,2335,127,Microorganisms,"Microorganisms are refined and crafted into components, modules and other items.",Microorganism.png,rare,764,0,0,764,0
2732,4453,8435,109,Titanium,"Titanium is refined and crafted into components, modules and other items.",Titanium.png,common,2225,0,0,2225,0
2732,4454,8435,42,Base Minerals,"Base Minerals are refined and crafted into components, modules and other items.",Base_Mineral.png,abundant,2730,0,0,2730,0
2732,7709,8435,52,Organic Compounds,"Organic Compounds are refined and crafted into components, modules and other items.",Organic_Compound.png,common,1168,0,0,1168,0
2732,7710,8435,107,H2O,"H2O is refined and crafted into components, modules and other items.",H20.png,abundant,4291,0,0,4291,0
2734,307,2336,120,Metamagnetic Ore,"Metamagnetic Ore is refined and crafted into components, modules and other items.",Metamagnetic_Ore.png,uncommon,1195,0,0,1195,0
2734,312,2336,120,Metamagnetic Ore,"Metamagnetic Ore is refined and crafted into components, modules and other items.",Metamagnetic_Ore.png,uncommon,2141,0,0,2141,0
2734,337,2336,105,Silicates,"Silicates are refined and crafted into components, modules and other items.",Silicates.png,abundant,5707,0,0,5707,0
2734,3324,8436,112,Amphoteric Substances,"Amphoteric Substances are refined and crafted into components, modules and other items.",Amphoteric_Substances.png,common,2158,0,0,2158,0
2734,4248,8436,53,Ignis Ore,"Ignis Ore is refined and crafted into components, modules and other items.",Ignis_Ore.png,rare,753,0,0,753,0
2734,7617,8436,106,Elastomers,"Elastomers are refined and crafted into components, modules and other items.",Elastomers.png,abundant,5540,0,0,5540,0
2735,19505,8437,105,Silicates,"Silicates are refined and crafted into components, modules and other items.",Silicates.png,abundant,4899,0,0,4899,0
2738,555,2339,53,Ignis Ore,"Ignis Ore is refined and crafted into components, modules and other items.",Ignis_Ore.png,rare,724,0,0,724,0
2738,682,2339,115,Nanofluids,"Nanofluids are refined and crafted into components, modules and other items.",Nanofluids.png,common,2647,0,0,2647,0
2738,860,2339,106,Elastomers,"Elastomers are refined and crafted into components, modules and other items.",Elastomers.png,abundant,5057,0,0,5057,0
2739,876,2340,121,Hypoatomic Substances,"Hypoatomic Substances are refined and crafted into components, modules and other items.",Hypoatomic_Substances.png,uncommon,1314,0,0,1314,0
2739,2493,2340,110,Plutonium,"Plutonium is refined and crafted into components, modules and other items.",Plutonium.png,common,2338,0,0,2338,0
2739,3363,2340,106,Elastomers,"Elastomers are refined and crafted into components, modules and other items.",Elastomers.png,abundant,5360,0,0,5360,0
2739,13894,8440,121,Hypoatomic Substances,"Hypoatomic Substances are refined and crafted into components, modules and other items.",Hypoatomic_Substances.png,uncommon,2026,0,0,2026,0
2739,15356,8440,126,Bruma Particles,"Bruma Particles are refined and crafted into components, modules and other items.",Bruma_Particle.png,rare,701,0,0,701,0
2744,2998,2344,117,Yprasium,"Yprasium is refined and crafted into components, modules and other items.",Yprasium.png,uncommon,2273,0,0,2273,0
2746,1156,2346,106,Elastomers,"Elastomers are refined and crafted into components, modules and other items.",Elastomers.png,abundant,5209,0,0,5209,0
2746,1174,2346,119,Novis Compounds,"Novis Compounds are refined and crafted into components, modules and other items.",Novis_Compound.png,uncommon,1498,0,0,1498,0
2746,1175,2346,119,Novis Compounds,"Novis Compounds are refined and crafted into components, modules and other items.",Novis_Compound.png,uncommon,2628,0,0,2628,0
2746,18055,8446,128,Tchaikovium,"Tchaikovium is refined and crafted into components, modules and other items.",Tchaikovium.png,rare,667,0,0,667,0
2746,18056,8446,105,Silicates,"Silicates are refined and crafted into components, modules and other items.",Silicates.png,abundant,2717,0,0,2717,0
2746,18057,8446,106,Elastomers,"Elastomers are refined and crafted into components, modules and other items.",Elastomers.png,abundant,4251,0,0,4251,0
2746,18058,8446,106,Elastomers,"Elastomers are refined and crafted into components, modules and other items.",Elastomers.png,abundant,4825,0,0,4825,0
2751,194,2347,114,Ectopolymers,"Ectopolymers are refined and crafted into components, modules and other items.",Ectopolymers.png,common,1016,0,0,1016,0
2751,239,2347,42,Base Minerals,"Base Minerals are refined and crafted into components, modules and other items.",Base_Mineral.png,abundant,2419,0,0,2419,0
2751,240,2347,106,Elastomers,"Elastomers are refined and crafted into components, modules and other items.",Elastomers.png,abundant,2335,0,0,2335,0
2751,258,2347,42,Base Minerals,"Base Minerals are refined and crafted into components, modules and other items.",Base_Mineral.png,abundant,4416,0,0,4416,0
2751,351,8447,110,Plutonium,"Plutonium is refined and crafted into components, modules and other items.",Plutonium.png,common,1113,0,0,1113,0
2751,425,8447,110,Plutonium,"Plutonium is refined and crafted into components, modules and other items.",Plutonium.png,common,2733,0,0,2733,0
2751,932,8447,114,Ectopolymers,"Ectopolymers are refined and crafted into components, modules and other items.",Ectopolymers.png,common,4800,0,0,4800,0
2753,562,2349,126,Bruma Particles,"Bruma Particles are refined and crafted into components, modules and other items.",Bruma_Particle.png,rare,601,121,0,480,121
2753,563,2349,109,Titanium,"Titanium is refined and crafted into components, modules and other items.",Titanium.png,common,2916,0,0,2916,0
2753,564,2349,42,Base Minerals,"Base Minerals are refined and crafted into components, modules and other items.",Base_Mineral.png,abundant,2385,0,0,2385,0
2753,1543,2349,42,Base Minerals,"Base Minerals are refined and crafted into components, modules and other items.",Base_Mineral.png,abundant,5484,0,0,5484,0
2753,1544,2349,105,Silicates,"Silicates are refined and crafted into components, modules and other items.",Silicates.png,abundant,4638,0,0,4638,0
2753,1427,8449,53,Ignis Ore,"Ignis Ore is refined and crafted into components, modules and other items.",Ignis_Ore.png,rare,808,0,0,808,0
2753,1428,8449,120,Metamagnetic Ore,"Metamagnetic Ore is refined and crafted into components, modules and other items.",Metamagnetic_Ore.png,uncommon,1197,0,0,1197,0
2753,1648,8449,112,Amphoteric Substances,"Amphoteric Substances are refined and crafted into components, modules and other items.",Amphoteric_Substances.png,common,5184,0,0,5184,0
2753,2017,8449,112,Amphoteric Substances,"Amphoteric Substances are refined and crafted into components, modules and other items.",Amphoteric_Substances.png,common,2914,0,0,2914,0
2757,14637,2352,119,Novis Compounds,"Novis Compounds are refined and crafted into components, modules and other items.",Novis_Compound.png,uncommon,2173,0,0,2173,0
2771,17723,2360,126,Bruma Particles,"Bruma Particles are refined and crafted into components, modules and other items.",Bruma_Particle.png,rare,850,0,0,850,0
2771,17724,2360,117,Yprasium,"Yprasium is refined and crafted into components, modules and other items.",Yprasium.png,uncommon,2846,0,0,2846,0
2771,17725,2360,42,Base Minerals,"Base Minerals are refined and crafted into components, modules and other items.",Base_Mineral.png,abundant,4563,0,0,4563,0
2771,17726,8460,42,Base Minerals,"Base Minerals are refined and crafted into components, modules and other items.",Base_Mineral.png,abundant,2799,0,0,2799,0
2771,17727,8460,105,Silicates,"Silicates are refined and crafted into components, modules and other items.",Silicates.png,abundant,5164,0,0,5164,0
2771,17925,8460,121,Hypoatomic Substances,"Hypoatomic Substances are refined and crafted into components, modules and other items.",Hypoatomic_Substances.png,uncommon,1478,0,0,1478,0
2776,10531,2362,126,Bruma Particles,"Bruma Particles are refined and crafted into components, modules and other items.",Bruma_Particle.png,rare,625,0,0,625,0
2776,10532,2362,41,Xensium,"Xensium is refined and crafted into components, modules and other items.",Xensium.png,uncommon,2881,0,0,2881,0
2776,10533,2362,107,H2O,"H2O is refined and crafted into components, modules and other items.",H20.png,abundant,5804,0,0,5804,0
2779,928,2364,40,Polymetals,"Polymetals are refined and crafted into components, modules and other items.",Polymetals.png,common,1183,237,0,946,237
2779,2572,2364,118,Platinyx,"Platinyx is refined and crafted into components, modules and other items.",Platinyx.png,uncommon,2740,1372,0,1368,1372
2779,2573,2364,107,H2O,"H2O is refined and crafted into components, modules and other items.",H20.png,abundant,4606,0,0,4606,0
2779,17425,8464,120,Metamagnetic Ore,"Metamagnetic Ore is refined and crafted into components, modules and other items.",Metamagnetic_Ore.png,uncommon,2714,0,0,2714,0
2779,17426,8464,118,Platinyx,"Platinyx is refined and crafted into components, modules and other items.",Platinyx.png,uncommon,1314,0,0,1314,0
2784,1703,2367,117,Yprasium,"Yprasium is refined and crafted into components, modules and other items.",Yprasium.png,uncommon,4263,0,0,4263,0
2784,1704,2367,106,Elastomers,"Elastomers are refined and crafted into components, modules and other items.",Elastomers.png,abundant,5214,0,0,5214,0
2784,1717,2367,113,Aerogens,"Aerogens are refined and crafted into components, modules and other items.",Aerogens.png,common,1311,0,0,1311,0
2784,1718,2367,105,Silicates,"Silicates are refined and crafted into components, modules and other items.",Silicates.png,abundant,2434,0,0,2434,0
2785,16699,2368,127,Microorganisms,"Microorganisms are refined and crafted into components, modules and other items.",Microorganism.png,rare,899,0,0,899,0
2785,17029,2368,40,Polymetals,"Polymetals are refined and crafted into components, modules and other items.",Polymetals.png,common,2948,0,0,2948,0
2785,17492,2368,106,Elastomers,"Elastomers are refined and crafted into components, modules and other items.",Elastomers.png,abundant,5478,0,0,5478,0
2801,17760,2380,42,Base Minerals,"Base Minerals are refined and crafted into components, modules and other items.",Base_Mineral.png,abundant,4850,0,0,4850,0
2801,17887,2380,113,Aerogens,"Aerogens are refined and crafted into components, modules and other items.",Aerogens.png,common,2086,0,0,2086,0
2801,18303,2380,126,Bruma Particles,"Bruma Particles are refined and crafted into components, modules and other items.",Bruma_Particle.png,rare,649,0,0,649,0
2802,3900,2381,42,Base Minerals,"Base Minerals are refined and crafted into components, modules and other items.",Base_Mineral.png,abundant,5901,0,0,5901,0
2802,7613,2381,120,Metamagnetic Ore,"Metamagnetic Ore is refined and crafted into components, modules and other items.",Metamagnetic_Ore.png,uncommon,2449,0,0,2449,0
2802,3305,8481,109,Titanium,"Titanium is refined and crafted into components, modules and other items.",Titanium.png,common,1380,0,0,1380,0
2802,3901,8481,112,Amphoteric Substances,"Amphoteric Substances are refined and crafted into components, modules and other items.",Amphoteric_Substances.png,common,2812,0,0,2812,0
2803,103,2382,121,Hypoatomic Substances,"Hypoatomic Substances are refined and crafted into components, modules and other items.",Hypoatomic_Substances.png,uncommon,1352,0,0,1352,0
2803,1520,2382,107,H2O,"H2O is refined and crafted into components, modules and other items.",H20.png,abundant,5022,0,0,5022,0
2803,1723,2382,106,Elastomers,"Elastomers are refined and crafted into components, modules and other items.",Elastomers.png,abundant,2539,0,0,2539,0
2803,3352,8482,106,Elastomers,"Elastomers are refined and crafted into components, modules and other items.",Elastomers.png,abundant,5356,0,0,5356,0
2803,4725,8482,127,Microorganisms,"Microorganisms are refined and crafted into components, modules and other items.",Microorganism.png,rare,1746,0,0,1746,0
2803,4797,8482,53,Ignis Ore,"Ignis Ore is refined and crafted into components, modules and other items.",Ignis_Ore.png,rare,816,0,0,816,0
2811,2814,2387,126,Bruma Particles,"Bruma Particles are refined and crafted into components, modules and other items.",Bruma_Particle.png,rare,769,0,0,769,0
2811,3336,2387,113,Aerogens,"Aerogens are refined and crafted into components, modules and other items.",Aerogens.png,common,2642,0,0,2642,0
2811,5677,2387,115,Nanofluids,"Nanofluids are refined and crafted into components, modules and other items.",Nanofluids.png,common,4891,980,0,3911,980
2826,1751,2398,105,Silicates,"Silicates are refined and crafted into components, modules and other items.",Silicates.png,abundant,5247,0,0,5247,0
2826,2192,2398,118,Platinyx,"Platinyx is refined and crafted into components, modules and other items.",Platinyx.png,uncommon,2633,0,0,2633,0
2826,4398,2398,128,Tchaikovium,"Tchaikovium is refined and crafted into components, modules and other items.",Tchaikovium.png,rare,715,0,0,715,0
2826,4399,8498,128,Tchaikovium,"Tchaikovium is refined and crafted into components, modules and other items.",Tchaikovium.png,rare,1634,0,0,1634,0
2826,4691,8498,42,Base Minerals,"Base Minerals are refined and crafted into components, modules and other items.",Base_Mineral.png,abundant,5418,0,0,5418,0
2826,4692,8498,53,Ignis Ore,"Ignis Ore is refined and crafted into components, modules and other items.",Ignis_Ore.png,rare,709,0,0,709,0
2828,4700,2400,54,Hyperspecular Crystals,"Hyperspecular Crystals are refined and crafted into components, modules and other items.",Hyperspecular_Crystals.png,uncommon,2512,0,0,2512,0
2828,4722,2400,113,Aerogens,"Aerogens are refined and crafted into components, modules and other items.",Aerogens.png,common,4214,0,0,4214,0
2828,4748,2400,53,Ignis Ore,"Ignis Ore is refined and crafted into components, modules and other items.",Ignis_Ore.png,rare,655,0,0,655,0
2828,17792,8500,118,Platinyx,"Platinyx is refined and crafted into components, modules and other items.",Platinyx.png,uncommon,1062,0,0,1062,0
2828,17793,8500,106,Elastomers,"Elastomers are refined and crafted into components, modules and other items.",Elastomers.png,abundant,5273,0,0,5273,0
2828,17854,8500,54,Hyperspecular Crystals,"Hyperspecular Crystals are refined and crafted into components, modules and other items.",Hyperspecular_Crystals.png,uncommon,2933,0,0,2933,0
2840,19802,2407,123,Neolysium,"Neolysium is refined and crafted into components, modules and other items.",Neolysium.png,uncommon,1426,286,0,1140,286
2840,19803,2407,109,Titanium,"Titanium is refined and crafted into components, modules and other items.",Titanium.png,common,2336,292,0,2044,292
2840,19804,2407,107,H2O,"H2O is refined and crafted into components, modules and other items.",H20.png,abundant,5302,531,0,4771,531
2840,19805,8507,53,Ignis Ore,"Ignis Ore is refined and crafted into components, modules and other items.",Ignis_Ore.png,rare,864,173,0,691,173
2840,19806,8507,110,Plutonium,"Plutonium is refined and crafted into components, modules and other items.",Plutonium.png,common,2273,0,0,2273,0
2840,19807,8507,42,Base Minerals,"Base Minerals are refined and crafted into components, modules and other items.",Base_Mineral.png,abundant,5457,546,0,4911,546
2846,1722,2409,106,Elastomers,"Elastomers are refined and crafted into components, modules and other items.",Elastomers.png,abundant,4031,0,0,4031,0
2846,1731,2409,54,Hyperspecular Crystals,"Hyperspecular Crystals are refined and crafted into components, modules and other items.",Hyperspecular_Crystals.png,uncommon,1332,0,0,1332,0
2846,1732,2409,42,Base Minerals,"Base Minerals are refined and crafted into components, modules and other items.",Base_Mineral.png,abundant,2219,0,0,2219,0
2852,1910,2413,113,Aerogens,"Aerogens are refined and crafted into components, modules and other items.",Aerogens.png,common,2797,0,0,2797,0
2852,2703,2413,54,Hyperspecular Crystals,"Hyperspecular Crystals are refined and crafted into components, modules and other items.",Hyperspecular_Crystals.png,uncommon,5152,0,0,5152,0
2852,4400,2413,52,Organic Compounds,"Organic Compounds are refined and crafted into components, modules and other items.",Organic_Compound.png,common,1278,0,0,1278,0
2852,4693,8513,123,Neolysium,"Neolysium is refined and crafted into components, modules and other items.",Neolysium.png,uncommon,2179,0,0,2179,0
2852,4809,8513,126,Bruma Particles,"Bruma Particles are refined and crafted into components, modules and other items.",Bruma_Particle.png,rare,640,0,0,640,0
2852,4810,8513,113,Aerogens,"Aerogens are refined and crafted into components, modules and other items.",Aerogens.png,common,4821,0,0,4821,0
2857,16,2416,114,Ectopolymers,"Ectopolymers are refined and crafted into components, modules and other items.",Ectopolymers.png,common,1176,0,0,1176,0
2857,199,2416,112,Amphoteric Substances,"Amphoteric Substances are refined and crafted into components, modules and other items.",Amphoteric_Substances.png,common,2637,0,0,2637,0
2857,416,2416,107,H2O,"H2O is refined and crafted into components, modules and other items.",H20.png,abundant,5166,517,0,4649,517
2857,2101,8516,109,Titanium,"Titanium is refined and crafted into components, modules and other items.",Titanium.png,common,1480,0,0,1480,0
2857,2630,8516,106,Elastomers,"Elastomers are refined and crafted into components, modules and other items.",Elastomers.png,abundant,5949,0,0,5949,0
2857,3081,8516,41,Xensium,"Xensium is refined and crafted into components, modules and other items.",Xensium.png,uncommon,2443,0,0,2443,0
2861,1087,2418,42,Base Minerals,"Base Minerals are refined and crafted into components, modules and other items.",Base_Mineral.png,abundant,4461,0,0,4461,0
2861,1100,2418,41,Xensium,"Xensium is refined and crafted into components, modules and other items.",Xensium.png,uncommon,2542,0,0,2542,0
2861,1109,2418,52,Organic Compounds,"Organic Compounds are refined and crafted into components, modules and other items.",Organic_Compound.png,common,1207,0,0,1207,0
2861,4565,8518,120,Metamagnetic Ore,"Metamagnetic Ore is refined and crafted into components, modules and other items.",Metamagnetic_Ore.png,uncommon,1480,0,0,1480,0
2861,4660,8518,41,Xensium,"Xensium is refined and crafted into components, modules and other items.",Xensium.png,uncommon,2912,0,0,2912,0
2861,4677,8518,106,Elastomers,"Elastomers are refined and crafted into components, modules and other items.",Elastomers.png,abundant,4508,0,0,4508,0
2861,4678,8518,52,Organic Compounds,"Organic Compounds are refined and crafted into components, modules and other items.",Organic_Compound.png,common,5033,0,0,5033,0
2864,2201,2421,128,Tchaikovium,"Tchaikovium is refined and crafted into components, modules and other items.",Tchaikovium.png,rare,642,0,0,642,0
2864,2202,2421,128,Tchaikovium,"Tchaikovium is refined and crafted into components, modules and other items.",Tchaikovium.png,rare,1652,0,0,1652,0
2864,2203,2421,112,Amphoteric Substances,"Amphoteric Substances are refined and crafted into components, modules and other items.",Amphoteric_Substances.png,common,2903,0,0,2903,0
2864,2204,2421,42,Base Minerals,"Base Minerals are refined and crafted into components, modules and other items.",Base_Mineral.png,abundant,4180,0,0,4180,0
2864,2205,2421,119,Novis Compounds,"Novis Compounds are refined and crafted into components, modules and other items.",Novis_Compound.png,uncommon,5216,0,0,5216,0
2869,1737,2426,117,Yprasium,"Yprasium is refined and crafted into components, modules and other items.",Yprasium.png,uncommon,1010,0,0,1010,0
2869,1738,2426,52,Organic Compounds,"Organic Compounds are refined and crafted into components, modules and other items.",Organic_Compound.png,common,1009,0,0,1009,0
2869,1739,2426,107,H2O,"H2O is refined and crafted into components, modules and other items.",H20.png,abundant,2306,0,0,2306,0
2869,1740,2426,107,H2O,"H2O is refined and crafted into components, modules and other items.",H20.png,abundant,4041,0,0,4041,0
2872,13366,2429,120,Metamagnetic Ore,"Metamagnetic Ore is refined and crafted into components, modules and other items.",Metamagnetic_Ore.png,uncommon,2666,0,0,2666,0
2872,13367,2429,110,Plutonium,"Plutonium is refined and crafted into components, modules and other items.",Plutonium.png,common,2059,0,0,2059,0
2872,14653,2429,120,Metamagnetic Ore,"Metamagnetic Ore is refined and crafted into components, modules and other items.",Metamagnetic_Ore.png,uncommon,1013,0,0,1013,0
2872,14691,2429,105,Silicates,"Silicates are refined and crafted into components, modules and other items.",Silicates.png,abundant,4779,0,0,4779,0
2879,17788,2435,42,Base Minerals,"Base Minerals are refined and crafted into components, modules and other items.",Base_Mineral.png,abundant,4097,0,0,4097,0
2879,17789,2435,115,Nanofluids,"Nanofluids are refined and crafted into components, modules and other items.",Nanofluids.png,common,5362,0,0,5362,0
2879,17922,2435,119,Novis Compounds,"Novis Compounds are refined and crafted into components, modules and other items.",Novis_Compound.png,uncommon,2854,0,0,2854,0
2879,18316,2435,41,Xensium,"Xensium is refined and crafted into components, modules and other items.",Xensium.png,uncommon,1485,0,0,1485,0
2880,17747,2436,114,Ectopolymers,"Ectopolymers are refined and crafted into components, modules and other items.",Ectopolymers.png,common,2641,0,0,2641,0
2880,17958,2436,114,Ectopolymers,"Ectopolymers are refined and crafted into components, modules and other items.",Ectopolymers.png,common,1176,0,0,1176,0
2880,17748,8536,105,Silicates,"Silicates are refined and crafted into components, modules and other items.",Silicates.png,abundant,5760,0,0,5760,0
2881,27,2437,113,Aerogens,"Aerogens are refined and crafted into components, modules and other items.",Aerogens.png,common,2443,0,0,2443,0
2882,1719,2438,123,Neolysium,"Neolysium is refined and crafted into components, modules and other items.",Neolysium.png,uncommon,1088,0,0,1088,0
2882,1720,2438,117,Yprasium,"Yprasium is refined and crafted into components, modules and other items.",Yprasium.png,uncommon,2629,0,0,2629,0
2882,1721,2438,112,Amphoteric Substances,"Amphoteric Substances are refined and crafted into components, modules and other items.",Amphoteric_Substances.png,common,4145,0,0,4145,0
2883,4798,2439,126,Bruma Particles,"Bruma Particles are refined and crafted into components, modules and other items.",Bruma_Particle.png,rare,725,290,0,435,290
2883,7500,2439,42,Base Minerals,"Base Minerals are refined and crafted into components, modules and other items.",Base_Mineral.png,abundant,2660,0,0,2660,0
2883,7791,2439,114,Ectopolymers,"Ectopolymers are refined and crafted into components, modules and other items.",Ectopolymers.png,common,4193,0,0,4193,0
2891,2893,2444,121,Hypoatomic Substances,"Hypoatomic Substances are refined and crafted into components, modules and other items.",Hypoatomic_Substances.png,uncommon,1056,0,0,1056,0
2891,2894,2444,109,Titanium,"Titanium is refined and crafted into components, modules and other items.",Titanium.png,common,1161,0,0,1161,0
2891,2895,2444,107,H2O,"H2O is refined and crafted into components, modules and other items.",H20.png,abundant,2171,0,0,2171,0
2891,2896,2444,106,Elastomers,"Elastomers are refined and crafted into components, modules and other items.",Elastomers.png,abundant,5731,0,0,5731,0
2894,2897,2447,53,Ignis Ore,"Ignis Ore is refined and crafted into components, modules and other items.",Ignis_Ore.png,rare,725,0,0,725,0
2894,2898,2447,109,Titanium,"Titanium is refined and crafted into components, modules and other items.",Titanium.png,common,2507,0,0,2507,0
2894,2899,2447,105,Silicates,"Silicates are refined and crafted into components, modules and other items.",Silicates.png,abundant,4588,0,0,4588,0
2897,3289,2448,118,Platinyx,"Platinyx is refined and crafted into components, modules and other items.",Platinyx.png,uncommon,1400,0,0,1400,0
2897,3290,2448,40,Polymetals,"Polymetals are refined and crafted into components, modules and other items.",Polymetals.png,common,2833,0,0,2833,0
2897,3291,2448,40,Polymetals,"Polymetals are refined and crafted into components, modules and other items.",Polymetals.png,common,5647,0,0,5647,0
2902,7616,2452,114,Ectopolymers,"Ectopolymers are refined and crafted into components, modules and other items.",Ectopolymers.png,common,4486,0,0,4486,0
2908,17260,2457,112,Amphoteric Substances,"Amphoteric Substances are refined and crafted into components, modules and other items.",Amphoteric_Substances.png,common,4211,0,0,4211,0
2908,17261,2457,53,Ignis Ore,"Ignis Ore is refined and crafted into components, modules and other items.",Ignis_Ore.png,rare,653,0,0,653,0
2908,17262,2457,109,Titanium,"Titanium is refined and crafted into components, modules and other items.",Titanium.png,common,1245,0,0,1245,0
2908,17263,2457,117,Yprasium,"Yprasium is refined and crafted into components, modules and other items.",Yprasium.png,uncommon,2380,0,0,2380,0
2908,17753,8557,126,Bruma Particles,"Bruma Particles are refined and crafted into components, modules and other items.",Bruma_Particle.png,rare,770,0,0,770,0
2908,17754,8557,106,Elastomers,"Elastomers are refined and crafted into components, modules and other items.",Elastomers.png,abundant,2133,0,0,2133,0
2908,17755,8557,109,Titanium,"Titanium is refined and crafted into components, modules and other items.",Titanium.png,common,2891,0,0,2891,0
2908,17756,8557,42,Base Minerals,"Base Minerals are refined and crafted into components, modules and other items.",Base_Mineral.png,abundant,4957,0,0,4957,0
2910,17320,2459,126,Bruma Particles,"Bruma Particles are refined and crafted into components, modules and other items.",Bruma_Particle.png,rare,780,0,0,780,0
2910,17321,2459,109,Titanium,"Titanium is refined and crafted into components, modules and other items.",Titanium.png,common,2519,0,0,2519,0
2910,17322,2459,106,Elastomers,"Elastomers are refined and crafted into components, modules and other items.",Elastomers.png,abundant,4707,0,0,4707,0
2912,1579,2460,53,Ignis Ore,"Ignis Ore is refined and crafted into components, modules and other items.",Ignis_Ore.png,rare,759,0,0,759,0
2912,1580,2460,106,Elastomers,"Elastomers are refined and crafted into components, modules and other items.",Elastomers.png,abundant,4530,0,0,4530,0
2912,1619,2460,42,Base Minerals,"Base Minerals are refined and crafted into components, modules and other items.",Base_Mineral.png,abundant,2755,0,0,2755,0
2912,1813,8560,117,Yprasium,"Yprasium is refined and crafted into components, modules and other items.",Yprasium.png,uncommon,1195,0,0,1195,0
2912,1843,8560,120,Metamagnetic Ore,"Metamagnetic Ore is refined and crafted into components, modules and other items.",Metamagnetic_Ore.png,uncommon,2236,0,0,2236,0
2912,1844,8560,40,Polymetals,"Polymetals are refined and crafted into components, modules and other items.",Polymetals.png,common,2646,0,0,2646,0
2912,1845,8560,110,Plutonium,"Plutonium is refined and crafted into components, modules and other items.",Plutonium.png,common,5153,0,0,5153,0
2923,17326,2466,113,Aerogens,"Aerogens are refined and crafted into components, modules and other items.",Aerogens.png,common,1206,0,0,1206,0
2923,17327,2466,105,Silicates,"Silicates are refined and crafted into components, modules and other items.",Silicates.png,abundant,2730,0,0,2730,0
2923,17328,2466,107,H2O,"H2O is refined and crafted into components, modules and other items.",H20.png,abundant,4325,0,0,4325,0
2930,17329,2470,126,Bruma Particles,"Bruma Particles are refined and crafted into components, modules and other items.",Bruma_Particle.png,rare,707,0,0,707,0
2930,17330,2470,120,Metamagnetic Ore,"Metamagnetic Ore is refined and crafted into components, modules and other items.",Metamagnetic_Ore.png,uncommon,2970,0,0,2970,0
2930,17331,2470,105,Silicates,"Silicates are refined and crafted into components, modules and other items.",Silicates.png,abundant,5107,0,0,5107,0
2936,3292,2472,115,Nanofluids,"Nanofluids are refined and crafted into components, modules and other items.",Nanofluids.png,common,1121,0,0,1121,0
2936,3293,2472,106,Elastomers,"Elastomers are refined and crafted into components, modules and other items.",Elastomers.png,abundant,2816,0,0,2816,0
2936,3382,2472,106,Elastomers,"Elastomers are refined and crafted into components, modules and other items.",Elastomers.png,abundant,5306,0,0,5306,0
2941,442,2475,40,Polymetals,"Polymetals are refined and crafted into components, modules and other items.",Polymetals.png,common,2970,1488,0,1482,1488
2941,11650,2475,114,Ectopolymers,"Ectopolymers are refined and crafted into components, modules and other items.",Ectopolymers.png,common,1234,0,0,1234,0
2941,11651,2475,127,Microorganisms,"Microorganisms are refined and crafted into components, modules and other items.",Microorganism.png,rare,833,0,0,833,0
2941,11652,2475,42,Base Minerals,"Base Minerals are refined and crafted into components, modules and other items.",Base_Mineral.png,abundant,5505,0,0,5505,0
2941,219,8575,40,Polymetals,"Polymetals are refined and crafted into components, modules and other items.",Polymetals.png,common,4887,2934,0,1953,2934
2941,443,8575,113,Aerogens,"Aerogens are refined and crafted into components, modules and other items.",Aerogens.png,common,2167,542,0,1625,542
2941,514,8575,109,Titanium,"Titanium is refined and crafted into components, modules and other items.",Titanium.png,common,1053,1053,0,0,1053
2943,166,2477,42,Base Minerals,"Base Minerals are refined and crafted into components, modules and other items.",Base_Mineral.png,abundant,2907,0,0,2907,0
2943,170,2477,42,Base Minerals,"Base Minerals are refined and crafted into components, modules and other items.",Base_Mineral.png,abundant,4288,0,0,4288,0
2943,344,2477,110,Plutonium,"Plutonium is refined and crafted into components, modules and other items.",Plutonium.png,common,1197,0,0,1197,0
2943,167,8577,40,Polymetals,"Polymetals are refined and crafted into components, modules and other items.",Polymetals.png,common,2718,0,0,2718,0
2943,348,8577,42,Base Minerals,"Base Minerals are refined and crafted into components, modules and other items.",Base_Mineral.png,abundant,4879,0,0,4879,0
2946,17332,2480,118,Platinyx,"Platinyx is refined and crafted into components, modules and other items.",Platinyx.png,uncommon,1145,0,0,1145,0
2946,17333,2480,118,Platinyx,"Platinyx is refined and crafted into components, modules and other items.",Platinyx.png,uncommon,2762,0,0,2762,0
2946,17334,2480,107,H2O,"H2O is refined and crafted into components, modules and other items.",H20.png,abundant,4649,0,0,4649,0
2963,2091,2491,127,Microorganisms,"Microorganisms are refined and crafted into components, modules and other items.",Microorganism.png,rare,645,0,0,645,0
2963,2092,2491,112,Amphoteric Substances,"Amphoteric Substances are refined and crafted into components, modules and other items.",Amphoteric_Substances.png,common,2463,0,0,2463,0
2963,2093,2491,107,H2O,"H2O is refined and crafted into components, modules and other items.",H20.png,abundant,4129,0,0,4129,0
2965,3513,2493,105,Silicates,"Silicates are refined and crafted into components, modules and other items.",Silicates.png,abundant,5198,0,0,5198,0
2971,113,2497,40,Polymetals,"Polymetals are refined and crafted into components, modules and other items.",Polymetals.png,common,1401,0,0,1401,0
2971,420,2497,105,Silicates,"Silicates are refined and crafted into components, modules and other items.",Silicates.png,abundant,2800,2800,0,0,2800
2971,475,2497,105,Silicates,"Silicates are refined and crafted into components, modules and other items.",Silicates.png,abundant,5467,2735,0,2732,2735
2971,2105,8597,114,Ectopolymers,"Ectopolymers are refined and crafted into components, modules and other items.",Ectopolymers.png,common,1321,0,0,1321,0
2971,2632,8597,106,Elastomers,"Elastomers are refined and crafted into components, modules and other items.",Elastomers.png,abundant,5623,0,0,5623,0
2971,2633,8597,115,Nanofluids,"Nanofluids are refined and crafted into components, modules and other items.",Nanofluids.png,common,4261,0,0,4261,0
2971,3082,8597,106,Elastomers,"Elastomers are refined and crafted into components, modules and other items.",Elastomers.png,abundant,2334,0,0,2334,0
2971,3083,8597,117,Yprasium,"Yprasium is refined and crafted into components, modules and other items.",Yprasium.png,uncommon,2922,0,0,2922,0
2972,111,2498,54,Hyperspecular Crystals,"Hyperspecular Crystals are refined and crafted into components, modules and other items.",Hyperspecular_Crystals.png,uncommon,2255,0,0,2255,0
2973,293,2499,117,Yprasium,"Yprasium is refined and crafted into components, modules and other items.",Yprasium.png,uncommon,2635,2635,0,0,2635
2973,359,2499,117,Yprasium,"Yprasium is refined and crafted into components, modules and other items.",Yprasium.png,uncommon,1343,1343,0,0,1343
2973,874,2499,42,Base Minerals,"Base Minerals are refined and crafted into components, modules and other items.",Base_Mineral.png,abundant,5386,539,0,4847,539
2973,1984,8599,107,H2O,"H2O is refined and crafted into components, modules and other items.",H20.png,abundant,5505,5505,0,0,5505
2973,2398,8599,53,Ignis Ore,"Ignis Ore is refined and crafted into components, modules and other items.",Ignis_Ore.png,rare,754,754,0,0,754
2973,2399,8599,118,Platinyx,"Platinyx is refined and crafted into components, modules and other items.",Platinyx.png,uncommon,2956,2956,0,0,2956
2975,137,2500,41,Xensium,"Xensium is refined and crafted into components, modules and other items.",Xensium.png,uncommon,1455,0,0,1455,0
2975,476,2500,115,Nanofluids,"Nanofluids are refined and crafted into components, modules and other items.",Nanofluids.png,common,2242,0,0,2242,0
2975,485,2500,42,Base Minerals,"Base Minerals are refined and crafted into components, modules and other items.",Base_Mineral.png,abundant,4568,0,0,4568,0
2975,2110,8600,118,Platinyx,"Platinyx is refined and crafted into components, modules and other items.",Platinyx.png,uncommon,1320,0,0,1320,0
2975,2683,8600,105,Silicates,"Silicates are refined and crafted into components, modules and other items.",Silicates.png,abundant,4270,0,0,4270,0
2975,3340,8600,115,Nanofluids,"Nanofluids are refined and crafted into components, modules and other items.",Nanofluids.png,common,2008,0,0,2008,0
2983,1581,2506,123,Neolysium,"Neolysium is refined and crafted into components, modules and other items.",Neolysium.png,uncommon,1297,0,0,1297,0
2983,1678,2506,110,Plutonium,"Plutonium is refined and crafted into components, modules and other items.",Plutonium.png,common,2289,0,0,2289,0
2983,1679,2506,110,Plutonium,"Plutonium is refined and crafted into components, modules and other items.",Plutonium.png,common,4191,0,0,4191,0
2983,1846,8606,119,Novis Compounds,"Novis Compounds are refined and crafted into components, modules and other items.",Novis_Compound.png,uncommon,1279,0,0,1279,0
2983,1850,8606,110,Plutonium,"Plutonium is refined and crafted into components, modules and other items.",Plutonium.png,common,2327,0,0,2327,0
2983,1896,8606,106,Elastomers,"Elastomers are refined and crafted into components, modules and other items.",Elastomers.png,abundant,4949,0,0,4949,0
2991,10660,8612,112,Amphoteric Substances,"Amphoteric Substances are refined and crafted into components, modules and other items.",Amphoteric_Substances.png,common,1439,0,0,1439,0
2991,10661,8612,112,Amphoteric Substances,"Amphoteric Substances are refined and crafted into components, modules and other items.",Amphoteric_Substances.png,common,2754,0,0,2754,0
2991,10662,8612,113,Aerogens,"Aerogens are refined and crafted into components, modules and other items.",Aerogens.png,common,2155,0,0,2155,0
2991,10664,8612,40,Polymetals,"Polymetals are refined and crafted into components, modules and other items.",Polymetals.png,common,5979,0,0,5979,0
3013,3012,2529,127,Microorganisms,"Microorganisms are refined and crafted into components, modules and other items.",Microorganism.png,rare,808,486,0,322,486
3013,3349,2529,107,H2O,"H2O is refined and crafted into components, modules and other items.",H20.png,abundant,2324,0,0,2324,0
3013,5908,2529,106,Elastomers,"Elastomers are refined and crafted into components, modules and other items.",Elastomers.png,abundant,4583,0,0,4583,0
3026,18575,2537,52,Organic Compounds,"Organic Compounds are refined and crafted into components, modules and other items.",Organic_Compound.png,common,1283,0,0,1283,0
3026,18576,2537,115,Nanofluids,"Nanofluids are refined and crafted into components, modules and other items.",Nanofluids.png,common,5008,0,0,5008,0
3026,18579,2537,121,Hypoatomic Substances,"Hypoatomic Substances are refined and crafted into components, modules and other items.",Hypoatomic_Substances.png,uncommon,2063,0,0,2063,0
3027,10825,2538,114,Ectopolymers,"Ectopolymers are refined and crafted into components, modules and other items.",Ectopolymers.png,common,1083,0,0,1083,0
3027,10891,2538,114,Ectopolymers,"Ectopolymers are refined and crafted into components, modules and other items.",Ectopolymers.png,common,2780,0,0,2780,0
3027,10990,2538,42,Base Minerals,"Base Minerals are refined and crafted into components, modules and other items.",Base_Mineral.png,abundant,5321,0,0,5321,0
3028,1576,2539,117,Yprasium,"Yprasium is refined and crafted into components, modules and other items.",Yprasium.png,uncommon,1060,0,0,1060,0
3028,1577,2539,42,Base Minerals,"Base Minerals are refined and crafted into components, modules and other items.",Base_Mineral.png,abundant,5093,0,0,5093,0
3028,1617,2539,42,Base Minerals,"Base Minerals are refined and crafted into components, modules and other items.",Base_Mineral.png,abundant,2175,0,0,2175,0
3028,1578,8639,123,Neolysium,"Neolysium is refined and crafted into components, modules and other items.",Neolysium.png,uncommon,1490,0,0,1490,0
3028,1618,8639,113,Aerogens,"Aerogens are refined and crafted into components, modules and other items.",Aerogens.png,common,5823,0,0,5823,0
3028,1811,8639,54,Hyperspecular Crystals,"Hyperspecular Crystals are refined and crafted into components, modules and other items.",Hyperspecular_Crystals.png,uncommon,2765,0,0,2765,0
3033,17928,2543,105,Silicates,"Silicates are refined and crafted into components, modules and other items.",Silicates.png,abundant,2534,0,0,2534,0
3033,18118,2543,105,Silicates,"Silicates are refined and crafted into components, modules and other items.",Silicates.png,abundant,4081,0,0,4081,0
3033,18355,2543,40,Polymetals,"Polymetals are refined and crafted into components, modules and other items.",Polymetals.png,common,1201,0,0,1201,0
3036,2900,2546,121,Hypoatomic Substances,"Hypoatomic Substances are refined and crafted into components, modules and other items.",Hypoatomic_Substances.png,uncommon,1296,0,0,1296,0
3036,2901,2546,107,H2O,"H2O is refined and crafted into components, modules and other items.",H20.png,abundant,2627,0,0,2627,0
3036,2902,2546,115,Nanofluids,"Nanofluids are refined and crafted into components, modules and other items.",Nanofluids.png,common,5966,0,0,5966,0
3039,1493,2547,121,Hypoatomic Substances,"Hypoatomic Substances are refined and crafted into components, modules and other items.",Hypoatomic_Substances.png,uncommon,1326,0,0,1326,0
3039,1494,2547,115,Nanofluids,"Nanofluids are refined and crafted into components, modules and other items.",Nanofluids.png,common,4787,2874,0,1913,2874
3039,1635,2547,115,Nanofluids,"Nanofluids are refined and crafted into components, modules and other items.",Nanofluids.png,common,2357,0,0,2357,0
3039,1637,8647,41,Xensium,"Xensium is refined and crafted into components, modules and other items.",Xensium.png,uncommon,1424,0,0,1424,0
3039,3122,8647,115,Nanofluids,"Nanofluids are refined and crafted into components, modules and other items.",Nanofluids.png,common,2785,0,0,2785,0
3039,7658,8647,106,Elastomers,"Elastomers are refined and crafted into components, modules and other items.",Elastomers.png,abundant,4891,0,0,4891,0
3040,11155,2548,107,H2O,"H2O is refined and crafted into components, modules and other items.",H20.png,abundant,5875,0,0,5875,0
3040,11156,2548,107,H2O,"H2O is refined and crafted into components, modules and other items.",H20.png,abundant,5296,0,0,5296,0
3040,3787,8648,107,H2O,"H2O is refined and crafted into components, modules and other items.",H20.png,abundant,2889,0,0,2889,0
3040,3929,8648,128,Tchaikovium,"Tchaikovium is refined and crafted into components, modules and other items.",Tchaikovium.png,rare,842,169,0,673,169
3040,4145,8648,106,Elastomers,"Elastomers are refined and crafted into components, modules and other items.",Elastomers.png,abundant,5701,0,0,5701,0
3050,2206,2553,118,Platinyx,"Platinyx is refined and crafted into components, modules and other items.",Platinyx.png,uncommon,1095,0,0,1095,0
3050,2207,2553,107,H2O,"H2O is refined and crafted into components, modules and other items.",H20.png,abundant,2911,0,0,2911,0
3050,2208,2553,52,Organic Compounds,"Organic Compounds are refined and crafted into components, modules and other items.",Organic_Compound.png,common,2601,0,0,2601,0
3050,2209,2553,105,Silicates,"Silicates are refined and crafted into components, modules and other items.",Silicates.png,abundant,4429,0,0,4429,0
3060,4680,2560,121,Hypoatomic Substances,"Hypoatomic Substances are refined and crafted into components, modules and other items.",Hypoatomic_Substances.png,uncommon,2293,0,0,2293,0
3060,6172,2560,117,Yprasium,"Yprasium is refined and crafted into components, modules and other items.",Yprasium.png,uncommon,1217,0,0,1217,0
3060,11261,2560,105,Silicates,"Silicates are refined and crafted into components, modules and other items.",Silicates.png,abundant,4903,4903,0,0,4903
3063,12707,2563,119,Novis Compounds,"Novis Compounds are refined and crafted into components, modules and other items.",Novis_Compound.png,uncommon,1275,0,0,1275,0
3063,12708,2563,117,Yprasium,"Yprasium is refined and crafted into components, modules and other items.",Yprasium.png,uncommon,2033,0,0,2033,0
3063,12709,2563,109,Titanium,"Titanium is refined and crafted into components, modules and other items.",Titanium.png,common,4818,0,0,4818,0
3063,18422,8663,118,Platinyx,"Platinyx is refined and crafted into components, modules and other items.",Platinyx.png,uncommon,1128,0,0,1128,0
3063,18423,8663,106,Elastomers,"Elastomers are refined and crafted into components, modules and other items.",Elastomers.png,abundant,2868,0,0,2868,0
3063,18424,8663,106,Elastomers,"Elastomers are refined and crafted into components, modules and other items.",Elastomers.png,abundant,4060,0,0,4060,0
3069,13531,2568,118,Platinyx,"Platinyx is refined and crafted into components, modules and other items.",Platinyx.png,uncommon,2267,0,0,2267,0
3069,13696,2568,117,Yprasium,"Yprasium is refined and crafted into components, modules and other items.",Yprasium.png,uncommon,1490,0,0,1490,0
3069,17751,2568,106,Elastomers,"Elastomers are refined and crafted into components, modules and other items.",Elastomers.png,abundant,5199,0,0,5199,0
3069,16105,8668,107,H2O,"H2O is refined and crafted into components, modules and other items.",H20.png,abundant,5052,0,0,5052,0
3073,1129,2571,117,Yprasium,"Yprasium is refined and crafted into components, modules and other items.",Yprasium.png,uncommon,2789,0,0,2789,0
3073,1130,2571,105,Silicates,"Silicates are refined and crafted into components, modules and other items.",Silicates.png,abundant,5776,0,0,5776,0
3073,1551,2571,53,Ignis Ore,"Ignis Ore is refined and crafted into components, modules and other items.",Ignis_Ore.png,rare,660,0,0,660,0
3073,3879,8671,106,Elastomers,"Elastomers are refined and crafted into components, modules and other items.",Elastomers.png,abundant,2630,0,0,2630,0
3078,2832,2575,121,Hypoatomic Substances,"Hypoatomic Substances are refined and crafted into components, modules and other items.",Hypoatomic_Substances.png,uncommon,1464,0,0,1464,0
3078,3350,2575,105,Silicates,"Silicates are refined and crafted into components, modules and other items.",Silicates.png,abundant,2324,0,0,2324,0
3078,5974,2575,105,Silicates,"Silicates are refined and crafted into components, modules and other items.",Silicates.png,abundant,5767,1154,0,4613,1154
3084,792,2578,41,Xensium,"Xensium is refined and crafted into components, modules and other items.",Xensium.png,uncommon,1326,0,0,1326,0
3084,1509,2578,115,Nanofluids,"Nanofluids are refined and crafted into components, modules and other items.",Nanofluids.png,common,4261,0,0,4261,0
3084,1590,2578,113,Aerogens,"Aerogens are refined and crafted into components, modules and other items.",Aerogens.png,common,2946,0,0,2946,0
3084,1510,8678,113,Aerogens,"Aerogens are refined and crafted into components, modules and other items.",Aerogens.png,common,2622,0,0,2622,0
3084,2359,8678,105,Silicates,"Silicates are refined and crafted into components, modules and other items.",Silicates.png,abundant,5481,0,0,5481,0
3084,5281,8678,113,Aerogens,"Aerogens are refined and crafted into components, modules and other items.",Aerogens.png,common,1480,0,0,1480,0
3084,5282,8678,121,Hypoatomic Substances,"Hypoatomic Substances are refined and crafted into components, modules and other items.",Hypoatomic_Substances.png,uncommon,1112,0,0,1112,0
3091,2903,2584,115,Nanofluids,"Nanofluids are refined and crafted into components, modules and other items.",Nanofluids.png,common,1270,0,0,1270,0
3091,2904,2584,121,Hypoatomic Substances,"Hypoatomic Substances are refined and crafted into components, modules and other items.",Hypoatomic_Substances.png,uncommon,2890,0,0,2890,0
3091,2905,2584,105,Silicates,"Silicates are refined and crafted into components, modules and other items.",Silicates.png,abundant,4658,0,0,4658,0
3093,17366,2586,120,Metamagnetic Ore,"Metamagnetic Ore is refined and crafted into components, modules and other items.",Metamagnetic_Ore.png,uncommon,1200,0,0,1200,0
3093,17367,2586,113,Aerogens,"Aerogens are refined and crafted into components, modules and other items.",Aerogens.png,common,2981,0,0,2981,0
3093,17368,2586,106,Elastomers,"Elastomers are refined and crafted into components, modules and other items.",Elastomers.png,abundant,5660,0,0,5660,0
3094,2079,2587,120,Metamagnetic Ore,"Metamagnetic Ore is refined and crafted into components, modules and other items.",Metamagnetic_Ore.png,uncommon,1001,0,0,1001,0
3094,2080,2587,107,H2O,"H2O is refined and crafted into components, modules and other items.",H20.png,abundant,2051,0,0,2051,0
3094,2081,2587,106,Elastomers,"Elastomers are refined and crafted into components, modules and other items.",Elastomers.png,abundant,5285,0,0,5285,0
3095,675,2588,109,Titanium,"Titanium is refined and crafted into components, modules and other items.",Titanium.png,common,2071,0,0,2071,0
3095,1131,2588,107,H2O,"H2O is refined and crafted into components, modules and other items.",H20.png,abundant,4638,0,0,4638,0
3095,2373,2588,53,Ignis Ore,"Ignis Ore is refined and crafted into components, modules and other items.",Ignis_Ore.png,rare,806,0,0,806,0
3095,3925,8688,123,Neolysium,"Neolysium is refined and crafted into components, modules and other items.",Neolysium.png,uncommon,2680,0,0,2680,0
3109,17369,2595,115,Nanofluids,"Nanofluids are refined and crafted into components, modules and other items.",Nanofluids.png,common,1128,0,0,1128,0
3109,17370,2595,110,Plutonium,"Plutonium is refined and crafted into components, modules and other items.",Plutonium.png,common,1090,0,0,1090,0
3109,17371,2595,40,Polymetals,"Polymetals are refined and crafted into components, modules and other items.",Polymetals.png,common,2650,0,0,2650,0
3109,17372,2595,42,Base Minerals,"Base Minerals are refined and crafted into components, modules and other items.",Base_Mineral.png,abundant,4309,0,0,4309,0
3109,17373,2595,118,Platinyx,"Platinyx is refined and crafted into components, modules and other items.",Platinyx.png,uncommon,5008,0,0,5008,0
3119,3052,2605,107,H2O,"H2O is refined and crafted into components, modules and other items.",H20.png,abundant,4961,0,0,4961,0
3119,3053,2605,121,Hypoatomic Substances,"Hypoatomic Substances are refined and crafted into components, modules and other items.",Hypoatomic_Substances.png,uncommon,2146,0,0,2146,0
3119,3054,2605,126,Bruma Particles,"Bruma Particles are refined and crafted into components, modules and other items.",Bruma_Particle.png,rare,1440,0,0,1440,0
3119,3055,2605,53,Ignis Ore,"Ignis Ore is refined and crafted into components, modules and other items.",Ignis_Ore.png,rare,667,0,0,667,0
3120,958,2606,53,Ignis Ore,"Ignis Ore is refined and crafted into components, modules and other items.",Ignis_Ore.png,rare,768,768,0,0,768
3120,1036,2606,109,Titanium,"Titanium is refined and crafted into components, modules and other items.",Titanium.png,common,2926,366,0,2560,366
3120,1051,2606,115,Nanofluids,"Nanofluids are refined and crafted into components, modules and other items.",Nanofluids.png,common,4691,0,0,4691,0
3120,4464,8706,53,Ignis Ore,"Ignis Ore is refined and crafted into components, modules and other items.",Ignis_Ore.png,rare,733,441,0,292,441
3120,4475,8706,109,Titanium,"Titanium is refined and crafted into components, modules and other items.",Titanium.png,common,2847,0,0,2847,0
3120,4479,8706,42,Base Minerals,"Base Minerals are refined and crafted into components, modules and other items.",Base_Mineral.png,abundant,4637,0,0,4637,0
3123,2027,2608,52,Organic Compounds,"Organic Compounds are refined and crafted into components, modules and other items.",Organic_Compound.png,common,2864,0,0,2864,0
3123,2260,2608,42,Base Minerals,"Base Minerals are refined and crafted into components, modules and other items.",Base_Mineral.png,abundant,5847,0,0,5847,0
3123,2986,2608,126,Bruma Particles,"Bruma Particles are refined and crafted into components, modules and other items.",Bruma_Particle.png,rare,717,717,0,0,717
3123,3924,8708,106,Elastomers,"Elastomers are refined and crafted into components, modules and other items.",Elastomers.png,abundant,2458,0,0,2458,0
3123,4419,8708,115,Nanofluids,"Nanofluids are refined and crafted into components, modules and other items.",Nanofluids.png,common,1180,0,0,1180,0
3123,4484,8708,105,Silicates,"Silicates are refined and crafted into components, modules and other items.",Silicates.png,abundant,5682,0,0,5682,0
3129,17323,2613,127,Microorganisms,"Microorganisms are refined and crafted into components, modules and other items.",Microorganism.png,rare,817,0,0,817,0
3129,17324,2613,117,Yprasium,"Yprasium is refined and crafted into components, modules and other items.",Yprasium.png,uncommon,2885,0,0,2885,0
3129,17325,2613,118,Platinyx,"Platinyx is refined and crafted into components, modules and other items.",Platinyx.png,uncommon,4065,0,0,4065,0
3132,3383,2616,53,Ignis Ore,"Ignis Ore is refined and crafted into components, modules and other items.",Ignis_Ore.png,rare,810,0,0,810,0
3132,3384,2616,112,Amphoteric Substances,"Amphoteric Substances are refined and crafted into components, modules and other items.",Amphoteric_Substances.png,common,2192,0,0,2192,0
3132,3385,2616,42,Base Minerals,"Base Minerals are refined and crafted into components, modules and other items.",Base_Mineral.png,abundant,5143,0,0,5143,0
3137,6010,2618,110,Plutonium,"Plutonium is refined and crafted into components, modules and other items.",Plutonium.png,common,1188,0,0,1188,0
3137,12746,2618,42,Base Minerals,"Base Minerals are refined and crafted into components, modules and other items.",Base_Mineral.png,abundant,4102,0,0,4102,0
3137,12747,2618,42,Base Minerals,"Base Minerals are refined and crafted into components, modules and other items.",Base_Mineral.png,abundant,4156,0,0,4156,0
3137,14093,2618,110,Plutonium,"Plutonium is refined and crafted into components, modules and other items.",Plutonium.png,common,2250,0,0,2250,0
3137,14094,2618,105,Silicates,"Silicates are refined and crafted into components, modules and other items.",Silicates.png,abundant,2445,0,0,2445,0
3146,2906,2625,119,Novis Compounds,"Novis Compounds are refined and crafted into components, modules and other items.",Novis_Compound.png,uncommon,1457,0,0,1457,0
3146,2907,2625,112,Amphoteric Substances,"Amphoteric Substances are refined and crafted into components, modules and other items.",Amphoteric_Substances.png,common,2226,0,0,2226,0
3146,2908,2625,106,Elastomers,"Elastomers are refined and crafted into components, modules and other items.",Elastomers.png,abundant,5270,0,0,5270,0
3150,308,2628,40,Polymetals,"Polymetals are refined and crafted into components, modules and other items.",Polymetals.png,common,1275,0,0,1275,0
3150,1608,2628,42,Base Minerals,"Base Minerals are refined and crafted into components, modules and other items.",Base_Mineral.png,abundant,4975,0,0,4975,0
3150,2577,2628,113,Aerogens,"Aerogens are refined and crafted into components, modules and other items.",Aerogens.png,common,2795,0,0,2795,0
3150,4230,8728,123,Neolysium,"Neolysium is refined and crafted into components, modules and other items.",Neolysium.png,uncommon,2177,0,0,2177,0
3150,6304,8728,113,Aerogens,"Aerogens are refined and crafted into components, modules and other items.",Aerogens.png,common,1276,0,0,1276,0
3150,7527,8728,106,Elastomers,"Elastomers are refined and crafted into components, modules and other items.",Elastomers.png,abundant,5667,0,0,5667,0
3152,880,2630,53,Ignis Ore,"Ignis Ore is refined and crafted into components, modules and other items.",Ignis_Ore.png,rare,603,0,0,603,0
3152,1987,2630,120,Metamagnetic Ore,"Metamagnetic Ore is refined and crafted into components, modules and other items.",Metamagnetic_Ore.png,uncommon,2642,0,0,2642,0
3152,4439,2630,107,H2O,"H2O is refined and crafted into components, modules and other items.",H20.png,abundant,5321,0,0,5321,0
3152,10167,8730,54,Hyperspecular Crystals,"Hyperspecular Crystals are refined and crafted into components, modules and other items.",Hyperspecular_Crystals.png,uncommon,2596,0,0,2596,0
3152,10168,8730,107,H2O,"H2O is refined and crafted into components, modules and other items.",H20.png,abundant,5730,0,0,5730,0
3152,12640,8730,120,Metamagnetic Ore,"Metamagnetic Ore is refined and crafted into components, modules and other items.",Metamagnetic_Ore.png,uncommon,1383,0,0,1383,0
3166,4235,2640,127,Microorganisms,"Microorganisms are refined and crafted into components, modules and other items.",Microorganism.png,rare,853,0,0,853,0
3166,4381,2640,106,Elastomers,"Elastomers are refined and crafted into components, modules and other items.",Elastomers.png,abundant,4047,0,0,4047,0
3166,9637,2640,121,Hypoatomic Substances,"Hypoatomic Substances are refined and crafted into components, modules and other items.",Hypoatomic_Substances.png,uncommon,2280,0,0,2280,0
3166,9505,8740,107,H2O,"H2O is refined and crafted into components, modules and other items.",H20.png,abundant,4123,0,0,4123,0
3166,9638,8740,52,Organic Compounds,"Organic Compounds are refined and crafted into components, modules and other items.",Organic_Compound.png,common,2887,0,0,2887,0
3168,254,2642,52,Organic Compounds,"Organic Compounds are refined and crafted into components, modules and other items.",Organic_Compound.png,common,2888,0,0,2888,0
3168,584,2642,107,H2O,"H2O is refined and crafted into components, modules and other items.",H20.png,abundant,5670,0,0,5670,0
3168,2181,2642,53,Ignis Ore,"Ignis Ore is refined and crafted into components, modules and other items.",Ignis_Ore.png,rare,688,0,0,688,0
3168,255,8742,118,Platinyx,"Platinyx is refined and crafted into components, modules and other items.",Platinyx.png,uncommon,2087,0,0,2087,0
3168,19242,8742,42,Base Minerals,"Base Minerals are refined and crafted into components, modules and other items.",Base_Mineral.png,abundant,5690,0,0,5690,0
3171,1903,2644,105,Silicates,"Silicates are refined and crafted into components, modules and other items.",Silicates.png,abundant,2898,0,0,2898,0
3171,1973,2644,128,Tchaikovium,"Tchaikovium is refined and crafted into components, modules and other items.",Tchaikovium.png,rare,699,0,0,699,0
3171,1974,2644,42,Base Minerals,"Base Minerals are refined and crafted into components, modules and other items.",Base_Mineral.png,abundant,5596,0,0,5596,0
3174,1132,2647,110,Plutonium,"Plutonium is refined and crafted into components, modules and other items.",Plutonium.png,common,2909,0,0,2909,0
3174,2374,2647,40,Polymetals,"Polymetals are refined and crafted into components, modules and other items.",Polymetals.png,common,4159,0,0,4159,0
3174,2988,2647,126,Bruma Particles,"Bruma Particles are refined and crafted into components, modules and other items.",Bruma_Particle.png,rare,608,608,0,0,608
3174,2989,2647,118,Platinyx,"Platinyx is refined and crafted into components, modules and other items.",Platinyx.png,uncommon,1080,0,0,1080,0
3174,2182,8747,119,Novis Compounds,"Novis Compounds are refined and crafted into components, modules and other items.",Novis_Compound.png,uncommon,2085,0,0,2085,0
3174,2183,8747,113,Aerogens,"Aerogens are refined and crafted into components, modules and other items.",Aerogens.png,common,2322,0,0,2322,0
3174,4378,8747,42,Base Minerals,"Base Minerals are refined and crafted into components, modules and other items.",Base_Mineral.png,abundant,5840,0,0,5840,0
3174,4425,8747,128,Tchaikovium,"Tchaikovium is refined and crafted into components, modules and other items.",Tchaikovium.png,rare,706,706,0,0,706
3177,18256,2650,127,Microorganisms,"Microorganisms are refined and crafted into components, modules and other items.",Microorganism.png,rare,740,0,0,740,0
3177,18257,8750,128,Tchaikovium,"Tchaikovium is refined and crafted into components, modules and other items.",Tchaikovium.png,rare,785,0,0,785,0
3183,17821,2653,41,Xensium,"Xensium is refined and crafted into components, modules and other items.",Xensium.png,uncommon,1384,277,0,1107,277
3183,17822,2653,107,H2O,"H2O is refined and crafted into components, modules and other items.",H20.png,abundant,2984,0,0,2984,0
3183,18117,2653,106,Elastomers,"Elastomers are refined and crafted into components, modules and other items.",Elastomers.png,abundant,4551,0,0,4551,0
3183,19472,8753,41,Xensium,"Xensium is refined and crafted into components, modules and other items.",Xensium.png,uncommon,2595,0,0,2595,0
3185,702,2654,107,H2O,"H2O is refined and crafted into components, modules and other items.",H20.png,abundant,4343,0,0,4343,0
3185,703,2654,42,Base Minerals,"Base Minerals are refined and crafted into components, modules and other items.",Base_Mineral.png,abundant,5450,0,0,5450,0
3185,704,2654,107,H2O,"H2O is refined and crafted into components, modules and other items.",H20.png,abundant,2960,0,0,2960,0
3185,705,2654,126,Bruma Particles,"Bruma Particles are refined and crafted into components, modules and other items.",Bruma_Particle.png,rare,850,0,0,850,0
3187,6601,2655,53,Ignis Ore,"Ignis Ore is refined and crafted into components, modules and other items.",Ignis_Ore.png,rare,662,0,0,662,0
3187,7327,2655,42,Base Minerals,"Base Minerals are refined and crafted into components, modules and other items.",Base_Mineral.png,abundant,2612,0,0,2612,0
3187,8074,2655,105,Silicates,"Silicates are refined and crafted into components, modules and other items.",Silicates.png,abundant,5421,0,0,5421,0
3191,2909,2659,115,Nanofluids,"Nanofluids are refined and crafted into components, modules and other items.",Nanofluids.png,common,1399,0,0,1399,0
3191,2910,2659,127,Microorganisms,"Microorganisms are refined and crafted into components, modules and other items.",Microorganism.png,rare,869,0,0,869,0
3191,2911,2659,115,Nanofluids,"Nanofluids are refined and crafted into components, modules and other items.",Nanofluids.png,common,2804,0,0,2804,0
3191,2912,2659,42,Base Minerals,"Base Minerals are refined and crafted into components, modules and other items.",Base_Mineral.png,abundant,4778,0,0,4778,0
3193,729,2661,53,Ignis Ore,"Ignis Ore is refined and crafted into components, modules and other items.",Ignis_Ore.png,rare,613,0,0,613,0
3193,919,2661,112,Amphoteric Substances,"Amphoteric Substances are refined and crafted into components, modules and other items.",Amphoteric_Substances.png,common,2322,0,0,2322,0
3193,1186,2661,112,Amphoteric Substances,"Amphoteric Substances are refined and crafted into components, modules and other items.",Amphoteric_Substances.png,common,4072,0,0,4072,0
3193,3747,8761,112,Amphoteric Substances,"Amphoteric Substances are refined and crafted into components, modules and other items.",Amphoteric_Substances.png,common,1389,0,0,1389,0
3193,3748,8761,112,Amphoteric Substances,"Amphoteric Substances are refined and crafted into components, modules and other items.",Amphoteric_Substances.png,common,2938,0,0,2938,0
3193,3749,8761,107,H2O,"H2O is refined and crafted into components, modules and other items.",H20.png,abundant,4469,0,0,4469,0
3196,3840,2662,127,Microorganisms,"Microorganisms are refined and crafted into components, modules and other items.",Microorganism.png,rare,796,0,0,796,0
3196,3841,2662,42,Base Minerals,"Base Minerals are refined and crafted into components, modules and other items.",Base_Mineral.png,abundant,2330,0,0,2330,0
3196,3842,2662,105,Silicates,"Silicates are refined and crafted into components, modules and other items.",Silicates.png,abundant,5893,0,0,5893,0
3199,662,2664,115,Nanofluids,"Nanofluids are refined and crafted into components, modules and other items.",Nanofluids.png,common,2843,0,0,2843,0
3202,16735,2665,127,Microorganisms,"Microorganisms are refined and crafted into components, modules and other items.",Microorganism.png,rare,647,0,0,647,0
3209,55,2670,127,Microorganisms,"Microorganisms are refined and crafted into components, modules and other items.",Microorganism.png,rare,857,0,0,857,0
3209,340,2670,109,Titanium,"Titanium is refined and crafted into components, modules and other items.",Titanium.png,common,5503,0,0,5503,0
3209,438,2670,117,Yprasium,"Yprasium is refined and crafted into components, modules and other items.",Yprasium.png,uncommon,2309,0,0,2309,0
3209,799,8770,123,Neolysium,"Neolysium is refined and crafted into components, modules and other items.",Neolysium.png,uncommon,2968,0,0,2968,0
3209,3530,8770,112,Amphoteric Substances,"Amphoteric Substances are refined and crafted into components, modules and other items.",Amphoteric_Substances.png,common,1066,0,0,1066,0
3209,3531,8770,109,Titanium,"Titanium is refined and crafted into components, modules and other items.",Titanium.png,common,4473,0,0,4473,0
3214,2913,2674,53,Ignis Ore,"Ignis Ore is refined and crafted into components, modules and other items.",Ignis_Ore.png,rare,628,0,0,628,0
3214,2914,2674,52,Organic Compounds,"Organic Compounds are refined and crafted into components, modules and other items.",Organic_Compound.png,common,2072,0,0,2072,0
3214,2915,2674,105,Silicates,"Silicates are refined and crafted into components, modules and other items.",Silicates.png,abundant,4852,0,0,4852,0
3216,2028,2676,40,Polymetals,"Polymetals are refined and crafted into components, modules and other items.",Polymetals.png,common,2465,0,0,2465,0
3216,2259,2676,42,Base Minerals,"Base Minerals are refined and crafted into components, modules and other items.",Base_Mineral.png,abundant,4363,0,0,4363,0
3216,2428,2676,128,Tchaikovium,"Tchaikovium is refined and crafted into components, modules and other items.",Tchaikovium.png,rare,741,741,0,0,741
3216,2987,8776,40,Polymetals,"Polymetals are refined and crafted into components, modules and other items.",Polymetals.png,common,1442,0,0,1442,0
3216,4327,8776,109,Titanium,"Titanium is refined and crafted into components, modules and other items.",Titanium.png,common,2683,0,0,2683,0
3216,4404,8776,42,Base Minerals,"Base Minerals are refined and crafted into components, modules and other items.",Base_Mineral.png,abundant,4114,0,0,4114,0
3218,2533,2678,121,Hypoatomic Substances,"Hypoatomic Substances are refined and crafted into components, modules and other items.",Hypoatomic_Substances.png,uncommon,1359,0,0,1359,0
3218,2534,2678,121,Hypoatomic Substances,"Hypoatomic Substances are refined and crafted into components, modules and other items.",Hypoatomic_Substances.png,uncommon,1035,0,0,1035,0
3218,3034,2678,121,Hypoatomic Substances,"Hypoatomic Substances are refined and crafted into components, modules and other items.",Hypoatomic_Substances.png,uncommon,2602,0,0,2602,0
3218,3914,2678,113,Aerogens,"Aerogens are refined and crafted into components, modules and other items.",Aerogens.png,common,5824,0,0,5824,0
3218,2721,8778,121,Hypoatomic Substances,"Hypoatomic Substances are refined and crafted into components, modules and other items.",Hypoatomic_Substances.png,uncommon,1043,0,0,1043,0
3218,2722,8778,113,Aerogens,"Aerogens are refined and crafted into components, modules and other items.",Aerogens.png,common,5152,0,0,5152,0
3218,3035,8778,115,Nanofluids,"Nanofluids are refined and crafted into components, modules and other items.",Nanofluids.png,common,2878,0,0,2878,0
3226,3579,2683,53,Ignis Ore,"Ignis Ore is refined and crafted into components, modules and other items.",Ignis_Ore.png,rare,824,0,0,824,0
3226,3610,2683,109,Titanium,"Titanium is refined and crafted into components, modules and other items.",Titanium.png,common,2335,0,0,2335,0
3228,18350,2685,109,Titanium,"Titanium is refined and crafted into components, modules and other items.",Titanium.png,common,2269,0,0,2269,0
3228,18415,2685,53,Ignis Ore,"Ignis Ore is refined and crafted into components, modules and other items.",Ignis_Ore.png,rare,772,0,0,772,0
3228,18428,2685,105,Silicates,"Silicates are refined and crafted into components, modules and other items.",Silicates.png,abundant,5092,0,0,5092,0
3248,1834,2699,118,Platinyx,"Platinyx is refined and crafted into components, modules and other items.",Platinyx.png,uncommon,1151,0,0,1151,0
3248,1835,2699,42,Base Minerals,"Base Minerals are refined and crafted into components, modules and other items.",Base_Mineral.png,abundant,2311,0,0,2311,0
3248,1836,2699,107,H2O,"H2O is refined and crafted into components, modules and other items.",H20.png,abundant,4481,0,0,4481,0
3249,1669,2700,127,Microorganisms,"Microorganisms are refined and crafted into components, modules and other items.",Microorganism.png,rare,733,0,0,733,0
3249,1670,2700,52,Organic Compounds,"Organic Compounds are refined and crafted into components, modules and other items.",Organic_Compound.png,common,2219,0,0,2219,0
3249,1671,2700,106,Elastomers,"Elastomers are refined and crafted into components, modules and other items.",Elastomers.png,abundant,5889,0,0,5889,0
3249,1672,8800,127,Microorganisms,"Microorganisms are refined and crafted into components, modules and other items.",Microorganism.png,rare,756,0,0,756,0
3249,1673,8800,105,Silicates,"Silicates are refined and crafted into components, modules and other items.",Silicates.png,abundant,2587,0,0,2587,0
3249,1812,8800,105,Silicates,"Silicates are refined and crafted into components, modules and other items.",Silicates.png,abundant,4074,0,0,4074,0
3255,2261,2705,109,Titanium,"Titanium is refined and crafted into components, modules and other items.",Titanium.png,common,2997,0,0,2997,0
3255,2375,2705,105,Silicates,"Silicates are refined and crafted into components, modules and other items.",Silicates.png,abundant,4243,0,0,4243,0
3255,2427,2705,53,Ignis Ore,"Ignis Ore is refined and crafted into components, modules and other items.",Ignis_Ore.png,rare,657,657,0,0,657
3255,2429,8805,112,Amphoteric Substances,"Amphoteric Substances are refined and crafted into components, modules and other items.",Amphoteric_Substances.png,common,2419,0,0,2419,0
3255,4403,8805,112,Amphoteric Substances,"Amphoteric Substances are refined and crafted into components, modules and other items.",Amphoteric_Substances.png,common,5606,0,0,5606,0
3255,4424,8805,54,Hyperspecular Crystals,"Hyperspecular Crystals are refined and crafted into components, modules and other items.",Hyperspecular_Crystals.png,uncommon,1235,0,0,1235,0
3256,1694,2706,126,Bruma Particles,"Bruma Particles are refined and crafted into components, modules and other items.",Bruma_Particle.png,rare,830,0,0,830,0
3256,1708,2706,107,H2O,"H2O is refined and crafted into components, modules and other items.",H20.png,abundant,2190,0,0,2190,0
3256,1714,2706,42,Base Minerals,"Base Minerals are refined and crafted into components, modules and other items.",Base_Mineral.png,abundant,5982,0,0,5982,0
3256,4246,8806,126,Bruma Particles,"Bruma Particles are refined and crafted into components, modules and other items.",Bruma_Particle.png,rare,683,0,0,683,0
3256,4253,8806,107,H2O,"H2O is refined and crafted into components, modules and other items.",H20.png,abundant,2532,0,0,2532,0
3256,4258,8806,105,Silicates,"Silicates are refined and crafted into components, modules and other items.",Silicates.png,abundant,4481,0,0,4481,0
3265,3515,2711,53,Ignis Ore,"Ignis Ore is refined and crafted into components, modules and other items.",Ignis_Ore.png,rare,603,0,0,603,0
3269,2085,2714,53,Ignis Ore,"Ignis Ore is refined and crafted into components, modules and other items.",Ignis_Ore.png,rare,896,0,0,896,0
3269,2086,2714,118,Platinyx,"Platinyx is refined and crafted into components, modules and other items.",Platinyx.png,uncommon,2980,0,0,2980,0
3269,2087,2714,105,Silicates,"Silicates are refined and crafted into components, modules and other items.",Silicates.png,abundant,5101,0,0,5101,0
3271,1213,2715,109,Titanium,"Titanium is refined and crafted into components, modules and other items.",Titanium.png,common,4141,415,0,3726,415
3271,1309,2715,105,Silicates,"Silicates are refined and crafted into components, modules and other items.",Silicates.png,abundant,2118,0,0,2118,0
3271,1350,2715,120,Metamagnetic Ore,"Metamagnetic Ore is refined and crafted into components, modules and other items.",Metamagnetic_Ore.png,uncommon,1204,0,0,1204,0
3271,1118,8815,40,Polymetals,"Polymetals are refined and crafted into components, modules and other items.",Polymetals.png,common,2799,0,0,2799,0
3271,1119,8815,112,Amphoteric Substances,"Amphoteric Substances are refined and crafted into components, modules and other items.",Amphoteric_Substances.png,common,2665,0,0,2665,0
3271,1200,8815,106,Elastomers,"Elastomers are refined and crafted into components, modules and other items.",Elastomers.png,abundant,5475,0,0,5475,0
3271,1306,8815,112,Amphoteric Substances,"Amphoteric Substances are refined and crafted into components, modules and other items.",Amphoteric_Substances.png,common,1412,0,0,1412,0
3276,3843,2719,41,Xensium,"Xensium is refined and crafted into components, modules and other items.",Xensium.png,uncommon,1323,0,0,1323,0
3276,3844,2719,52,Organic Compounds,"Organic Compounds are refined and crafted into components, modules and other items.",Organic_Compound.png,common,2569,0,0,2569,0
3276,3845,2719,52,Organic Compounds,"Organic Compounds are refined and crafted into components, modules and other items.",Organic_Compound.png,common,5784,0,0,5784,0
3280,12246,2721,126,Bruma Particles,"Bruma Particles are refined and crafted into components, modules and other items.",Bruma_Particle.png,rare,621,0,0,621,0
3280,13634,2721,106,Elastomers,"Elastomers are refined and crafted into components, modules and other items.",Elastomers.png,abundant,5859,0,0,5859,0
3280,14095,2721,115,Nanofluids,"Nanofluids are refined and crafted into components, modules and other items.",Nanofluids.png,common,2507,0,0,2507,0
3280,14096,2721,115,Nanofluids,"Nanofluids are refined and crafted into components, modules and other items.",Nanofluids.png,common,2580,0,0,2580,0
3281,12674,2722,121,Hypoatomic Substances,"Hypoatomic Substances are refined and crafted into components, modules and other items.",Hypoatomic_Substances.png,uncommon,1473,0,0,1473,0
3281,12675,2722,117,Yprasium,"Yprasium is refined and crafted into components, modules and other items.",Yprasium.png,uncommon,1466,0,0,1466,0
3281,12676,2722,113,Aerogens,"Aerogens are refined and crafted into components, modules and other items.",Aerogens.png,common,2567,0,0,2567,0
3281,12677,2722,106,Elastomers,"Elastomers are refined and crafted into components, modules and other items.",Elastomers.png,abundant,4742,0,0,4742,0
3281,12678,8822,115,Nanofluids,"Nanofluids are refined and crafted into components, modules and other items.",Nanofluids.png,common,1356,0,0,1356,0
3281,12679,8822,113,Aerogens,"Aerogens are refined and crafted into components, modules and other items.",Aerogens.png,common,2031,0,0,2031,0
3281,12680,8822,107,H2O,"H2O is refined and crafted into components, modules and other items.",H20.png,abundant,5201,0,0,5201,0
3299,19273,2734,53,Ignis Ore,"Ignis Ore is refined and crafted into components, modules and other items.",Ignis_Ore.png,rare,809,0,0,809,0
3299,19274,2734,107,H2O,"H2O is refined and crafted into components, modules and other items.",H20.png,abundant,2032,0,0,2032,0
3301,2500,2736,127,Microorganisms,"Microorganisms are refined and crafted into components, modules and other items.",Microorganism.png,rare,879,0,0,879,0
3301,2501,2736,121,Hypoatomic Substances,"Hypoatomic Substances are refined and crafted into components, modules and other items.",Hypoatomic_Substances.png,uncommon,1408,0,0,1408,0
3301,2502,2736,42,Base Minerals,"Base Minerals are refined and crafted into components, modules and other items.",Base_Mineral.png,abundant,2741,0,0,2741,0
3301,5020,2736,109,Titanium,"Titanium is refined and crafted into components, modules and other items.",Titanium.png,common,4339,0,0,4339,0
3304,2094,2737,119,Novis Compounds,"Novis Compounds are refined and crafted into components, modules and other items.",Novis_Compound.png,uncommon,1299,0,0,1299,0
3304,2095,2737,121,Hypoatomic Substances,"Hypoatomic Substances are refined and crafted into components, modules and other items.",Hypoatomic_Substances.png,uncommon,2068,0,0,2068,0
3304,2096,2737,105,Silicates,"Silicates are refined and crafted into components, modules and other items.",Silicates.png,abundant,4579,0,0,4579,0
3307,10676,8840,127,Microorganisms,"Microorganisms are refined and crafted into components, modules and other items.",Microorganism.png,rare,888,0,0,888,0
3307,10677,8840,54,Hyperspecular Crystals,"Hyperspecular Crystals are refined and crafted into components, modules and other items.",Hyperspecular_Crystals.png,uncommon,2954,0,0,2954,0
3307,10679,8840,105,Silicates,"Silicates are refined and crafted into components, modules and other items.",Silicates.png,abundant,4094,0,0,4094,0
3309,4508,2742,105,Silicates,"Silicates are refined and crafted into components, modules and other items.",Silicates.png,abundant,5019,1506,0,3513,1506
3309,4509,2742,128,Tchaikovium,"Tchaikovium is refined and crafted into components, modules and other items.",Tchaikovium.png,rare,623,0,0,623,0
3309,4511,2742,117,Yprasium,"Yprasium is refined and crafted into components, modules and other items.",Yprasium.png,uncommon,2723,0,0,2723,0
3309,4512,8842,127,Microorganisms,"Microorganisms are refined and crafted into components, modules and other items.",Microorganism.png,rare,635,0,0,635,0
3327,2456,2758,126,Bruma Particles,"Bruma Particles are refined and crafted into components, modules and other items.",Bruma_Particle.png,rare,750,450,0,300,450
3327,3351,2758,121,Hypoatomic Substances,"Hypoatomic Substances are refined and crafted into components, modules and other items.",Hypoatomic_Substances.png,uncommon,2340,586,0,1754,586
3327,6502,2758,105,Silicates,"Silicates are refined and crafted into components, modules and other items.",Silicates.png,abundant,5580,558,0,5022,558
3341,1365,2767,115,Nanofluids,"Nanofluids are refined and crafted into components, modules and other items.",Nanofluids.png,common,2220,0,0,2220,0
3341,1366,2767,41,Xensium,"Xensium is refined and crafted into components, modules and other items.",Xensium.png,uncommon,2187,0,0,2187,0
3341,2845,2767,127,Microorganisms,"Microorganisms are refined and crafted into components, modules and other items.",Microorganism.png,rare,751,0,0,751,0
3341,2846,2767,106,Elastomers,"Elastomers are refined and crafted into components, modules and other items.",Elastomers.png,abundant,5215,0,0,5215,0
3342,2097,2768,126,Bruma Particles,"Bruma Particles are refined and crafted into components, modules and other items.",Bruma_Particle.png,rare,783,0,0,783,0
3342,2098,2768,126,Bruma Particles,"Bruma Particles are refined and crafted into components, modules and other items.",Bruma_Particle.png,rare,1893,0,0,1893,0
3342,2099,2768,112,Amphoteric Substances,"Amphoteric Substances are refined and crafted into components, modules and other items.",Amphoteric_Substances.png,common,4560,0,0,4560,0
3345,1697,2771,113,Aerogens,"Aerogens are refined and crafted into components, modules and other items.",Aerogens.png,common,1460,0,0,1460,0
3345,1715,2771,42,Base Minerals,"Base Minerals are refined and crafted into components, modules and other items.",Base_Mineral.png,abundant,5626,0,0,5626,0
3345,1849,2771,126,Bruma Particles,"Bruma Particles are refined and crafted into components, modules and other items.",Bruma_Particle.png,rare,1298,0,0,1298,0
3345,4259,8871,126,Bruma Particles,"Bruma Particles are refined and crafted into components, modules and other items.",Bruma_Particle.png,rare,602,0,0,602,0
3345,4260,8871,113,Aerogens,"Aerogens are refined and crafted into components, modules and other items.",Aerogens.png,common,2206,0,0,2206,0
3345,4280,8871,109,Titanium,"Titanium is refined and crafted into components, modules and other items.",Titanium.png,common,4598,0,0,4598,0
3346,3503,2772,123,Neolysium,"Neolysium is refined and crafted into components, modules and other items.",Neolysium.png,uncommon,2986,0,0,2986,0
3346,3504,2772,109,Titanium,"Titanium is refined and crafted into components, modules and other items.",Titanium.png,common,2399,0,0,2399,0
3346,3505,2772,42,Base Minerals,"Base Minerals are refined and crafted into components, modules and other items.",Base_Mineral.png,abundant,5063,0,0,5063,0
3346,4450,2772,53,Ignis Ore,"Ignis Ore is refined and crafted into components, modules and other items.",Ignis_Ore.png,rare,828,0,0,828,0
3346,3791,8872,126,Bruma Particles,"Bruma Particles are refined and crafted into components, modules and other items.",Bruma_Particle.png,rare,764,0,0,764,0
3346,3792,8872,105,Silicates,"Silicates are refined and crafted into components, modules and other items.",Silicates.png,abundant,4720,0,0,4720,0
3346,4451,8872,105,Silicates,"Silicates are refined and crafted into components, modules and other items.",Silicates.png,abundant,2146,0,0,2146,0
3348,9109,2773,53,Ignis Ore,"Ignis Ore is refined and crafted into components, modules and other items.",Ignis_Ore.png,rare,884,0,0,884,0
3348,9110,2773,105,Silicates,"Silicates are refined and crafted into components, modules and other items.",Silicates.png,abundant,2289,1148,0,1141,1148
3348,9111,2773,118,Platinyx,"Platinyx is refined and crafted into components, modules and other items.",Platinyx.png,uncommon,2538,318,0,2220,318
3348,9112,2773,114,Ectopolymers,"Ectopolymers are refined and crafted into components, modules and other items.",Ectopolymers.png,common,5876,0,0,5876,0
3348,9113,8873,53,Ignis Ore,"Ignis Ore is refined and crafted into components, modules and other items.",Ignis_Ore.png,rare,665,0,0,665,0
3348,9114,8873,53,Ignis Ore,"Ignis Ore is refined and crafted into components, modules and other items.",Ignis_Ore.png,rare,1765,0,0,1765,0
3348,9115,8873,105,Silicates,"Silicates are refined and crafted into components, modules and other items.",Silicates.png,abundant,4524,0,0,4524,0
3353,2409,2778,112,Amphoteric Substances,"Amphoteric Substances are refined and crafted into components, modules and other items.",Amphoteric_Substances.png,common,1003,0,0,1003,0
3353,3431,2778,120,Metamagnetic Ore,"Metamagnetic Ore is refined and crafted into components, modules and other items.",Metamagnetic_Ore.png,uncommon,2025,0,0,2025,0
3353,4355,2778,42,Base Minerals,"Base Minerals are refined and crafted into components, modules and other items.",Base_Mineral.png,abundant,4498,0,0,4498,0
3358,1698,2781,114,Ectopolymers,"Ectopolymers are refined and crafted into components, modules and other items.",Ectopolymers.png,common,1035,0,0,1035,0
3358,1735,2781,40,Polymetals,"Polymetals are refined and crafted into components, modules and other items.",Polymetals.png,common,4006,0,0,4006,0
3358,1881,2781,118,Platinyx,"Platinyx is refined and crafted into components, modules and other items.",Platinyx.png,uncommon,2107,264,0,1843,264
3358,4290,8881,110,Plutonium,"Plutonium is refined and crafted into components, modules and other items.",Plutonium.png,common,1312,0,0,1312,0
3358,4299,8881,128,Tchaikovium,"Tchaikovium is refined and crafted into components, modules and other items.",Tchaikovium.png,rare,1659,0,0,1659,0
3358,4307,8881,105,Silicates,"Silicates are refined and crafted into components, modules and other items.",Silicates.png,abundant,4174,0,0,4174,0
3359,83,2782,121,Hypoatomic Substances,"Hypoatomic Substances are refined and crafted into components, modules and other items.",Hypoatomic_Substances.png,uncommon,2421,0,0,2421,0
3359,84,2782,121,Hypoatomic Substances,"Hypoatomic Substances are refined and crafted into components, modules and other items.",Hypoatomic_Substances.png,uncommon,2646,0,0,2646,0
3359,85,2782,105,Silicates,"Silicates are refined and crafted into components, modules and other items.",Silicates.png,abundant,5476,0,0,5476,0
3359,224,2782,127,Microorganisms,"Microorganisms are refined and crafted into components, modules and other items.",Microorganism.png,rare,822,0,0,822,0
3359,225,2782,121,Hypoatomic Substances,"Hypoatomic Substances are refined and crafted into components, modules and other items.",Hypoatomic_Substances.png,uncommon,1368,0,0,1368,0
3359,148,8882,41,Xensium,"Xensium is refined and crafted into components, modules and other items.",Xensium.png,uncommon,2470,0,0,2470,0
3359,628,8882,127,Microorganisms,"Microorganisms are refined and crafted into components, modules and other items.",Microorganism.png,rare,708,0,0,708,0
3359,967,8882,106,Elastomers,"Elastomers are refined and crafted into components, modules and other items.",Elastomers.png,abundant,5917,0,0,5917,0
3359,968,8882,106,Elastomers,"Elastomers are refined and crafted into components, modules and other items.",Elastomers.png,abundant,4553,0,0,4553,0
3361,9060,2783,113,Aerogens,"Aerogens are refined and crafted into components, modules and other items.",Aerogens.png,common,2940,0,0,2940,0
3361,9061,2783,115,Nanofluids,"Nanofluids are refined and crafted into components, modules and other items.",Nanofluids.png,common,5543,0,0,5543,0
3376,2916,2793,127,Microorganisms,"Microorganisms are refined and crafted into components, modules and other items.",Microorganism.png,rare,703,0,0,703,0
3376,2917,2793,106,Elastomers,"Elastomers are refined and crafted into components, modules and other items.",Elastomers.png,abundant,2395,0,0,2395,0
3376,2918,2793,40,Polymetals,"Polymetals are refined and crafted into components, modules and other items.",Polymetals.png,common,5243,0,0,5243,0
3377,3003,2794,107,H2O,"H2O is refined and crafted into components, modules and other items.",H20.png,abundant,5089,0,0,5089,0
3377,3524,2794,107,H2O,"H2O is refined and crafted into components, modules and other items.",H20.png,abundant,2588,0,0,2588,0
3377,4225,2794,109,Titanium,"Titanium is refined and crafted into components, modules and other items.",Titanium.png,common,1007,0,0,1007,0
3377,7855,8894,126,Bruma Particles,"Bruma Particles are refined and crafted into components, modules and other items.",Bruma_Particle.png,rare,1473,0,0,1473,0
3377,7856,8894,106,Elastomers,"Elastomers are refined and crafted into components, modules and other items.",Elastomers.png,abundant,2337,0,0,2337,0
3377,14488,8894,107,H2O,"H2O is refined and crafted into components, modules and other items.",H20.png,abundant,5041,0,0,5041,0
3378,13433,2795,109,Titanium,"Titanium is refined and crafted into components, modules and other items.",Titanium.png,common,2593,0,0,2593,0
3378,14818,2795,42,Base Minerals,"Base Minerals are refined and crafted into components, modules and other items.",Base_Mineral.png,abundant,5963,0,0,5963,0
3378,15016,2795,127,Microorganisms,"Microorganisms are refined and crafted into components, modules and other items.",Microorganism.png,rare,680,0,0,680,0
3380,139,2797,115,Nanofluids,"Nanofluids are refined and crafted into components, modules and other items.",Nanofluids.png,common,2481,0,0,2481,0
3380,173,2797,117,Yprasium,"Yprasium is refined and crafted into components, modules and other items.",Yprasium.png,uncommon,1403,0,0,1403,0
3380,174,2797,117,Yprasium,"Yprasium is refined and crafted into components, modules and other items.",Yprasium.png,uncommon,1329,0,0,1329,0
3380,1785,2797,105,Silicates,"Silicates are refined and crafted into components, modules and other items.",Silicates.png,abundant,4101,822,0,3279,822
3380,1786,2797,115,Nanofluids,"Nanofluids are refined and crafted into components, modules and other items.",Nanofluids.png,common,4353,0,0,4353,0
3380,4806,8897,126,Bruma Particles,"Bruma Particles are refined and crafted into components, modules and other items.",Bruma_Particle.png,rare,677,0,0,677,0
3380,4807,8897,105,Silicates,"Silicates are refined and crafted into components, modules and other items.",Silicates.png,abundant,2676,0,0,2676,0
3380,4808,8897,113,Aerogens,"Aerogens are refined and crafted into components, modules and other items.",Aerogens.png,common,5826,0,0,5826,0
3389,147,2803,126,Bruma Particles,"Bruma Particles are refined and crafted into components, modules and other items.",Bruma_Particle.png,rare,750,750,0,0,750
3389,477,2803,121,Hypoatomic Substances,"Hypoatomic Substances are refined and crafted into components, modules and other items.",Hypoatomic_Substances.png,uncommon,2971,0,0,2971,0
3389,698,2803,42,Base Minerals,"Base Minerals are refined and crafted into components, modules and other items.",Base_Mineral.png,abundant,5325,0,0,5325,0
3389,2293,8903,126,Bruma Particles,"Bruma Particles are refined and crafted into components, modules and other items.",Bruma_Particle.png,rare,735,0,0,735,0
3389,2817,8903,106,Elastomers,"Elastomers are refined and crafted into components, modules and other items.",Elastomers.png,abundant,5328,0,0,5328,0
3389,2818,8903,105,Silicates,"Silicates are refined and crafted into components, modules and other items.",Silicates.png,abundant,5890,0,0,5890,0
3389,4562,8903,113,Aerogens,"Aerogens are refined and crafted into components, modules and other items.",Aerogens.png,common,2770,0,0,2770,0
3392,19606,2805,52,Organic Compounds,"Organic Compounds are refined and crafted into components, modules and other items.",Organic_Compound.png,common,1420,0,0,1420,0
3392,19607,2805,53,Ignis Ore,"Ignis Ore is refined and crafted into components, modules and other items.",Ignis_Ore.png,rare,661,0,0,661,0
3392,19608,2805,52,Organic Compounds,"Organic Compounds are refined and crafted into components, modules and other items.",Organic_Compound.png,common,2732,0,0,2732,0
3392,20000,2805,52,Organic Compounds,"Organic Compounds are refined and crafted into components, modules and other items.",Organic_Compound.png,common,5607,0,0,5607,0
3395,15346,2808,53,Ignis Ore,"Ignis Ore is refined and crafted into components, modules and other items.",Ignis_Ore.png,rare,746,0,0,746,0
3395,15347,2808,40,Polymetals,"Polymetals are refined and crafted into components, modules and other items.",Polymetals.png,common,1257,0,0,1257,0
3395,15348,2808,110,Plutonium,"Plutonium is refined and crafted into components, modules and other items.",Plutonium.png,common,2716,0,0,2716,0
3395,15349,2808,112,Amphoteric Substances,"Amphoteric Substances are refined and crafted into components, modules and other items.",Amphoteric_Substances.png,common,4119,0,0,4119,0
3401,1495,2813,40,Polymetals,"Polymetals are refined and crafted into components, modules and other items.",Polymetals.png,common,1259,0,0,1259,0
3401,1496,2813,105,Silicates,"Silicates are refined and crafted into components, modules and other items.",Silicates.png,abundant,4471,0,0,4471,0
3401,3123,2813,113,Aerogens,"Aerogens are refined and crafted into components, modules and other items.",Aerogens.png,common,2291,0,0,2291,0
3401,3145,8913,119,Novis Compounds,"Novis Compounds are refined and crafted into components, modules and other items.",Novis_Compound.png,uncommon,2994,0,0,2994,0
3401,3355,8913,119,Novis Compounds,"Novis Compounds are refined and crafted into components, modules and other items.",Novis_Compound.png,uncommon,1197,0,0,1197,0
3401,7659,8913,41,Xensium,"Xensium is refined and crafted into components, modules and other items.",Xensium.png,uncommon,4914,0,0,4914,0
3403,15362,2815,106,Elastomers,"Elastomers are refined and crafted into components, modules and other items.",Elastomers.png,abundant,2447,0,0,2447,0
3403,15363,2815,106,Elastomers,"Elastomers are refined and crafted into components, modules and other items.",Elastomers.png,abundant,4802,0,0,4802,0
3403,15808,2815,127,Microorganisms,"Microorganisms are refined and crafted into components, modules and other items.",Microorganism.png,rare,771,0,0,771,0
3403,17796,8915,52,Organic Compounds,"Organic Compounds are refined and crafted into components, modules and other items.",Organic_Compound.png,common,2106,0,0,2106,0
3404,17379,2816,52,Organic Compounds,"Organic Compounds are refined and crafted into components, modules and other items.",Organic_Compound.png,common,1326,0,0,1326,0
3404,17381,2816,107,H2O,"H2O is refined and crafted into components, modules and other items.",H20.png,abundant,2506,0,0,2506,0
3404,17382,2816,106,Elastomers,"Elastomers are refined and crafted into components, modules and other items.",Elastomers.png,abundant,5083,0,0,5083,0
3407,2235,2817,127,Microorganisms,"Microorganisms are refined and crafted into components, modules and other items.",Microorganism.png,rare,830,498,0,332,498
3407,2329,2817,110,Plutonium,"Plutonium is refined and crafted into components, modules and other items.",Plutonium.png,common,2762,0,0,2762,0
3407,2345,2817,40,Polymetals,"Polymetals are refined and crafted into components, modules and other items.",Polymetals.png,common,5889,1178,0,4711,1178
3410,1167,2818,42,Base Minerals,"Base Minerals are refined and crafted into components, modules and other items.",Base_Mineral.png,abundant,4926,0,0,4926,0
3410,1225,2818,114,Ectopolymers,"Ectopolymers are refined and crafted into components, modules and other items.",Ectopolymers.png,common,1266,0,0,1266,0
3410,1226,2818,119,Novis Compounds,"Novis Compounds are refined and crafted into components, modules and other items.",Novis_Compound.png,uncommon,2156,0,0,2156,0
3410,18059,8918,54,Hyperspecular Crystals,"Hyperspecular Crystals are refined and crafted into components, modules and other items.",Hyperspecular_Crystals.png,uncommon,1232,0,0,1232,0
3410,18060,8918,114,Ectopolymers,"Ectopolymers are refined and crafted into components, modules and other items.",Ectopolymers.png,common,2513,0,0,2513,0
3410,18061,8918,115,Nanofluids,"Nanofluids are refined and crafted into components, modules and other items.",Nanofluids.png,common,4898,0,0,4898,0
3411,13442,2819,121,Hypoatomic Substances,"Hypoatomic Substances are refined and crafted into components, modules and other items.",Hypoatomic_Substances.png,uncommon,4078,0,0,4078,0
3414,3846,2821,54,Hyperspecular Crystals,"Hyperspecular Crystals are refined and crafted into components, modules and other items.",Hyperspecular_Crystals.png,uncommon,1487,0,0,1487,0
3414,3847,2821,114,Ectopolymers,"Ectopolymers are refined and crafted into components, modules and other items.",Ectopolymers.png,common,2132,0,0,2132,0
3414,3848,2821,106,Elastomers,"Elastomers are refined and crafted into components, modules and other items.",Elastomers.png,abundant,4489,0,0,4489,0
3414,3849,2821,110,Plutonium,"Plutonium is refined and crafted into components, modules and other items.",Plutonium.png,common,5729,0,0,5729,0
3415,467,2822,118,Platinyx,"Platinyx is refined and crafted into components, modules and other items.",Platinyx.png,uncommon,2253,282,0,1971,282
3415,558,2822,53,Ignis Ore,"Ignis Ore is refined and crafted into components, modules and other items.",Ignis_Ore.png,rare,732,0,0,732,0
3415,559,2822,120,Metamagnetic Ore,"Metamagnetic Ore is refined and crafted into components, modules and other items.",Metamagnetic_Ore.png,uncommon,1301,261,0,1040,261
3415,1736,2822,42,Base Minerals,"Base Minerals are refined and crafted into components, modules and other items.",Base_Mineral.png,abundant,5546,555,0,4991,555
3415,670,8922,110,Plutonium,"Plutonium is refined and crafted into components, modules and other items.",Plutonium.png,common,1365,0,0,1365,0
3415,1861,8922,106,Elastomers,"Elastomers are refined and crafted into components, modules and other items.",Elastomers.png,abundant,4874,488,0,4386,488
3415,1862,8922,105,Silicates,"Silicates are refined and crafted into components, modules and other items.",Silicates.png,abundant,4514,0,0,4514,0
3415,1904,8922,110,Plutonium,"Plutonium is refined and crafted into components, modules and other items.",Plutonium.png,common,2887,0,0,2887,0
3417,180,2823,112,Amphoteric Substances,"Amphoteric Substances are refined and crafted into components, modules and other items.",Amphoteric_Substances.png,common,1427,0,0,1427,0
3417,181,2823,112,Amphoteric Substances,"Amphoteric Substances are refined and crafted into components, modules and other items.",Amphoteric_Substances.png,common,2876,0,0,2876,0
3417,182,2823,112,Amphoteric Substances,"Amphoteric Substances are refined and crafted into components, modules and other items.",Amphoteric_Substances.png,common,4674,0,0,4674,0
3417,381,8923,109,Titanium,"Titanium is refined and crafted into components, modules and other items.",Titanium.png,common,4471,0,0,4471,0
3417,382,8923,105,Silicates,"Silicates are refined and crafted into components, modules and other items.",Silicates.png,abundant,5526,0,0,5526,0
3421,730,2826,41,Xensium,"Xensium is refined and crafted into components, modules and other items.",Xensium.png,uncommon,1187,0,0,1187,0
3421,920,2826,112,Amphoteric Substances,"Amphoteric Substances are refined and crafted into components, modules and other items.",Amphoteric_Substances.png,common,2139,0,0,2139,0
3421,1187,2826,110,Plutonium,"Plutonium is refined and crafted into components, modules and other items.",Plutonium.png,common,4522,0,0,4522,0
3421,3760,8926,127,Microorganisms,"Microorganisms are refined and crafted into components, modules and other items.",Microorganism.png,rare,701,0,0,701,0
3421,3761,8926,107,H2O,"H2O is refined and crafted into components, modules and other items.",H20.png,abundant,2600,0,0,2600,0
3421,3762,8926,42,Base Minerals,"Base Minerals are refined and crafted into components, modules and other items.",Base_Mineral.png,abundant,5983,0,0,5983,0
3423,330,2828,117,Yprasium,"Yprasium is refined and crafted into components, modules and other items.",Yprasium.png,uncommon,1305,0,0,1305,0
3423,722,2828,113,Aerogens,"Aerogens are refined and crafted into components, modules and other items.",Aerogens.png,common,2329,0,0,2329,0
3423,885,2828,106,Elastomers,"Elastomers are refined and crafted into components, modules and other items.",Elastomers.png,abundant,5764,2885,0,2879,2885
3423,2313,8928,40,Polymetals,"Polymetals are refined and crafted into components, modules and other items.",Polymetals.png,common,1343,0,0,1343,0
3423,3015,8928,106,Elastomers,"Elastomers are refined and crafted into components, modules and other items.",Elastomers.png,abundant,5479,0,0,5479,0
3423,4583,8928,109,Titanium,"Titanium is refined and crafted into components, modules and other items.",Titanium.png,common,2708,0,0,2708,0
3424,905,2829,53,Ignis Ore,"Ignis Ore is refined and crafted into components, modules and other items.",Ignis_Ore.png,rare,798,0,0,798,0
3424,1501,2829,119,Novis Compounds,"Novis Compounds are refined and crafted into components, modules and other items.",Novis_Compound.png,uncommon,4767,0,0,4767,0
3424,3651,2829,120,Metamagnetic Ore,"Metamagnetic Ore is refined and crafted into components, modules and other items.",Metamagnetic_Ore.png,uncommon,2316,0,0,2316,0
3439,86,2838,106,Elastomers,"Elastomers are refined and crafted into components, modules and other items.",Elastomers.png,abundant,5277,1584,0,3693,1584
3439,87,2838,107,H2O,"H2O is refined and crafted into components, modules and other items.",H20.png,abundant,2121,2121,0,0,2121
3439,850,2838,126,Bruma Particles,"Bruma Particles are refined and crafted into components, modules and other items.",Bruma_Particle.png,rare,637,637,0,0,637
3439,266,8938,113,Aerogens,"Aerogens are refined and crafted into components, modules and other items.",Aerogens.png,common,2797,0,0,2797,0
3439,636,8938,126,Bruma Particles,"Bruma Particles are refined and crafted into components, modules and other items.",Bruma_Particle.png,rare,757,757,0,0,757
3439,4219,8938,113,Aerogens,"Aerogens are refined and crafted into components, modules and other items.",Aerogens.png,common,4338,0,0,4338,0
3440,1900,2839,118,Platinyx,"Platinyx is refined and crafted into components, modules and other items.",Platinyx.png,uncommon,1000,0,0,1000,0
3440,1901,2839,118,Platinyx,"Platinyx is refined and crafted into components, modules and other items.",Platinyx.png,uncommon,2056,0,0,2056,0
3440,1902,2839,109,Titanium,"Titanium is refined and crafted into components, modules and other items.",Titanium.png,common,5824,0,0,5824,0
3446,18648,2844,123,Neolysium,"Neolysium is refined and crafted into components, modules and other items.",Neolysium.png,uncommon,1090,0,0,1090,0
3446,18649,2844,40,Polymetals,"Polymetals are refined and crafted into components, modules and other items.",Polymetals.png,common,1178,0,0,1178,0
3456,2213,2850,119,Novis Compounds,"Novis Compounds are refined and crafted into components, modules and other items.",Novis_Compound.png,uncommon,1104,0,0,1104,0
3456,2214,2850,41,Xensium,"Xensium is refined and crafted into components, modules and other items.",Xensium.png,uncommon,2526,0,0,2526,0
3456,2215,2850,106,Elastomers,"Elastomers are refined and crafted into components, modules and other items.",Elastomers.png,abundant,5614,0,0,5614,0
3456,15874,8950,40,Polymetals,"Polymetals are refined and crafted into components, modules and other items.",Polymetals.png,common,1378,0,0,1378,0
3456,15875,8950,127,Microorganisms,"Microorganisms are refined and crafted into components, modules and other items.",Microorganism.png,rare,684,0,0,684,0
3456,19867,8950,40,Polymetals,"Polymetals are refined and crafted into components, modules and other items.",Polymetals.png,common,5479,0,0,5479,0
3456,20263,8950,40,Polymetals,"Polymetals are refined and crafted into components, modules and other items.",Polymetals.png,common,2631,0,0,2631,0
3457,17383,2851,53,Ignis Ore,"Ignis Ore is refined and crafted into components, modules and other items.",Ignis_Ore.png,rare,771,0,0,771,0
3457,17384,2851,41,Xensium,"Xensium is refined and crafted into components, modules and other items.",Xensium.png,uncommon,2518,0,0,2518,0
3457,17385,2851,105,Silicates,"Silicates are refined and crafted into components, modules and other items.",Silicates.png,abundant,4569,0,0,4569,0
3457,17386,2851,105,Silicates,"Silicates are refined and crafted into components, modules and other items.",Silicates.png,abundant,5004,0,0,5004,0
3459,1028,2853,127,Microorganisms,"Microorganisms are refined and crafted into components, modules and other items.",Microorganism.png,rare,810,0,0,810,0
3459,1111,2853,112,Amphoteric Substances,"Amphoteric Substances are refined and crafted into components, modules and other items.",Amphoteric_Substances.png,common,2959,0,0,2959,0
3459,1297,2853,106,Elastomers,"Elastomers are refined and crafted into components, modules and other items.",Elastomers.png,abundant,5505,0,0,5505,0
3459,1885,8953,112,Amphoteric Substances,"Amphoteric Substances are refined and crafted into components, modules and other items.",Amphoteric_Substances.png,common,2030,0,0,2030,0
3459,2379,8953,127,Microorganisms,"Microorganisms are refined and crafted into components, modules and other items.",Microorganism.png,rare,646,0,0,646,0
3459,2433,8953,42,Base Minerals,"Base Minerals are refined and crafted into components, modules and other items.",Base_Mineral.png,abundant,4420,0,0,4420,0
3475,2475,2865,107,H2O,"H2O is refined and crafted into components, modules and other items.",H20.png,abundant,2207,0,0,2207,0
3475,2476,2865,120,Metamagnetic Ore,"Metamagnetic Ore is refined and crafted into components, modules and other items.",Metamagnetic_Ore.png,uncommon,2053,0,0,2053,0
3475,2555,2865,127,Microorganisms,"Microorganisms are refined and crafted into components, modules and other items.",Microorganism.png,rare,642,0,0,642,0
3475,2556,2865,117,Yprasium,"Yprasium is refined and crafted into components, modules and other items.",Yprasium.png,uncommon,1028,0,0,1028,0
3475,2687,2865,52,Organic Compounds,"Organic Compounds are refined and crafted into components, modules and other items.",Organic_Compound.png,common,5110,0,0,5110,0
3475,2688,2865,107,H2O,"H2O is refined and crafted into components, modules and other items.",H20.png,abundant,5228,0,0,5228,0
3481,89,2871,107,H2O,"H2O is refined and crafted into components, modules and other items.",H20.png,abundant,2076,0,0,2076,0
3481,90,2871,42,Base Minerals,"Base Minerals are refined and crafted into components, modules and other items.",Base_Mineral.png,abundant,5661,0,0,5661,0
3481,226,2871,126,Bruma Particles,"Bruma Particles are refined and crafted into components, modules and other items.",Bruma_Particle.png,rare,879,0,0,879,0
3481,227,2871,118,Platinyx,"Platinyx is refined and crafted into components, modules and other items.",Platinyx.png,uncommon,1095,0,0,1095,0
3481,776,8971,126,Bruma Particles,"Bruma Particles are refined and crafted into components, modules and other items.",Bruma_Particle.png,rare,1685,0,0,1685,0
3481,1524,8971,128,Tchaikovium,"Tchaikovium is refined and crafted into components, modules and other items.",Tchaikovium.png,rare,624,0,0,624,0
3481,3917,8971,113,Aerogens,"Aerogens are refined and crafted into components, modules and other items.",Aerogens.png,common,5129,0,0,5129,0
3483,13664,2873,107,H2O,"H2O is refined and crafted into components, modules and other items.",H20.png,abundant,5297,0,0,5297,0
3488,3850,2876,128,Tchaikovium,"Tchaikovium is refined and crafted into components, modules and other items.",Tchaikovium.png,rare,833,0,0,833,0
3488,3851,2876,118,Platinyx,"Platinyx is refined and crafted into components, modules and other items.",Platinyx.png,uncommon,2890,0,0,2890,0
3488,3852,2876,42,Base Minerals,"Base Minerals are refined and crafted into components, modules and other items.",Base_Mineral.png,abundant,4817,0,0,4817,0
3489,13441,2877,112,Amphoteric Substances,"Amphoteric Substances are refined and crafted into components, modules and other items.",Amphoteric_Substances.png,common,2635,0,0,2635,0
3489,15049,2877,41,Xensium,"Xensium is refined and crafted into components, modules and other items.",Xensium.png,uncommon,1184,0,0,1184,0
3489,15082,2877,112,Amphoteric Substances,"Amphoteric Substances are refined and crafted into components, modules and other items.",Amphoteric_Substances.png,common,4104,0,0,4104,0
3489,15083,2877,117,Yprasium,"Yprasium is refined and crafted into components, modules and other items.",Yprasium.png,uncommon,5270,0,0,5270,0
3491,7665,2878,41,Xensium,"Xensium is refined and crafted into components, modules and other items.",Xensium.png,uncommon,2269,0,0,2269,0
3491,7666,2878,105,Silicates,"Silicates are refined and crafted into components, modules and other items.",Silicates.png,abundant,5212,0,0,5212,0
3491,7761,2878,115,Nanofluids,"Nanofluids are refined and crafted into components, modules and other items.",Nanofluids.png,common,1117,0,0,1117,0
3491,7667,8978,127,Microorganisms,"Microorganisms are refined and crafted into components, modules and other items.",Microorganism.png,rare,822,0,0,822,0
3491,7668,8978,115,Nanofluids,"Nanofluids are refined and crafted into components, modules and other items.",Nanofluids.png,common,4997,0,0,4997,0
3491,7792,8978,107,H2O,"H2O is refined and crafted into components, modules and other items.",H20.png,abundant,2366,0,0,2366,0
3494,1709,2880,109,Titanium,"Titanium is refined and crafted into components, modules and other items.",Titanium.png,common,1047,0,0,1047,0
3494,2354,2880,107,H2O,"H2O is refined and crafted into components, modules and other items.",H20.png,abundant,4752,0,0,4752,0
3494,2453,2880,127,Microorganisms,"Microorganisms are refined and crafted into components, modules and other items.",Microorganism.png,rare,1905,0,0,1905,0
3494,4383,8980,54,Hyperspecular Crystals,"Hyperspecular Crystals are refined and crafted into components, modules and other items.",Hyperspecular_Crystals.png,uncommon,1315,0,0,1315,0
3494,4384,8980,107,H2O,"H2O is refined and crafted into components, modules and other items.",H20.png,abundant,2034,0,0,2034,0
3494,4385,8980,109,Titanium,"Titanium is refined and crafted into components, modules and other items.",Titanium.png,common,4981,0,0,4981,0
3495,5383,2881,121,Hypoatomic Substances,"Hypoatomic Substances are refined and crafted into components, modules and other items.",Hypoatomic_Substances.png,uncommon,2036,0,0,2036,0
3495,7988,2881,115,Nanofluids,"Nanofluids are refined and crafted into components, modules and other items.",Nanofluids.png,common,1473,0,0,1473,0
3495,7990,2881,121,Hypoatomic Substances,"Hypoatomic Substances are refined and crafted into components, modules and other items.",Hypoatomic_Substances.png,uncommon,4516,0,0,4516,0
3497,1262,2883,106,Elastomers,"Elastomers are refined and crafted into components, modules and other items.",Elastomers.png,abundant,5828,0,0,5828,0
3497,1344,2883,113,Aerogens,"Aerogens are refined and crafted into components, modules and other items.",Aerogens.png,common,2028,0,0,2028,0
3497,1455,2883,113,Aerogens,"Aerogens are refined and crafted into components, modules and other items.",Aerogens.png,common,1205,241,0,964,241
3497,1214,8983,114,Ectopolymers,"Ectopolymers are refined and crafted into components, modules and other items.",Ectopolymers.png,common,2844,0,0,2844,0
3497,1308,8983,117,Yprasium,"Yprasium is refined and crafted into components, modules and other items.",Yprasium.png,uncommon,1258,0,0,1258,0
3497,1310,8983,105,Silicates,"Silicates are refined and crafted into components, modules and other items.",Silicates.png,abundant,5382,0,0,5382,0
3502,2112,2886,121,Hypoatomic Substances,"Hypoatomic Substances are refined and crafted into components, modules and other items.",Hypoatomic_Substances.png,uncommon,1217,0,0,1217,0
3502,2794,2886,52,Organic Compounds,"Organic Compounds are refined and crafted into components, modules and other items.",Organic_Compound.png,common,2251,0,0,2251,0
3502,4356,2886,106,Elastomers,"Elastomers are refined and crafted into components, modules and other items.",Elastomers.png,abundant,4513,0,0,4513,0
3504,1741,2887,107,H2O,"H2O is refined and crafted into components, modules and other items.",H20.png,abundant,4944,0,0,4944,0
3504,1791,2887,127,Microorganisms,"Microorganisms are refined and crafted into components, modules and other items.",Microorganism.png,rare,766,0,0,766,0
3504,1792,2887,112,Amphoteric Substances,"Amphoteric Substances are refined and crafted into components, modules and other items.",Amphoteric_Substances.png,common,2930,0,0,2930,0
3509,3716,2891,40,Polymetals,"Polymetals are refined and crafted into components, modules and other items.",Polymetals.png,common,5691,0,0,5691,0
3509,4401,2891,120,Metamagnetic Ore,"Metamagnetic Ore is refined and crafted into components, modules and other items.",Metamagnetic_Ore.png,uncommon,1445,0,0,1445,0
3509,4694,2891,120,Metamagnetic Ore,"Metamagnetic Ore is refined and crafted into components, modules and other items.",Metamagnetic_Ore.png,uncommon,2433,0,0,2433,0
3509,4811,8991,118,Platinyx,"Platinyx is refined and crafted into components, modules and other items.",Platinyx.png,uncommon,1355,0,0,1355,0
3509,4812,8991,105,Silicates,"Silicates are refined and crafted into components, modules and other items.",Silicates.png,abundant,2054,0,0,2054,0
3509,4813,8991,42,Base Minerals,"Base Minerals are refined and crafted into components, modules and other items.",Base_Mineral.png,abundant,2120,0,0,2120,0
3509,7597,8991,106,Elastomers,"Elastomers are refined and crafted into components, modules and other items.",Elastomers.png,abundant,4626,0,0,4626,0
3517,3853,2896,114,Ectopolymers,"Ectopolymers are refined and crafted into components, modules and other items.",Ectopolymers.png,common,1324,0,0,1324,0
3517,3854,2896,113,Aerogens,"Aerogens are refined and crafted into components, modules and other items.",Aerogens.png,common,2790,0,0,2790,0
3517,3855,2896,114,Ectopolymers,"Ectopolymers are refined and crafted into components, modules and other items.",Ectopolymers.png,common,4535,0,0,4535,0
3525,3856,2898,109,Titanium,"Titanium is refined and crafted into components, modules and other items.",Titanium.png,common,1020,0,0,1020,0
3525,3857,2898,54,Hyperspecular Crystals,"Hyperspecular Crystals are refined and crafted into components, modules and other items.",Hyperspecular_Crystals.png,uncommon,2295,0,0,2295,0
3525,3858,2898,42,Base Minerals,"Base Minerals are refined and crafted into components, modules and other items.",Base_Mineral.png,abundant,5462,0,0,5462,0
3532,3859,2902,54,Hyperspecular Crystals,"Hyperspecular Crystals are refined and crafted into components, modules and other items.",Hyperspecular_Crystals.png,uncommon,1033,0,0,1033,0
3532,3860,2902,113,Aerogens,"Aerogens are refined and crafted into components, modules and other items.",Aerogens.png,common,1216,0,0,1216,0
3532,3861,2902,109,Titanium,"Titanium is refined and crafted into components, modules and other items.",Titanium.png,common,2419,0,0,2419,0
3532,3862,2902,105,Silicates,"Silicates are refined and crafted into components, modules and other items.",Silicates.png,abundant,4033,0,0,4033,0
3535,612,2905,121,Hypoatomic Substances,"Hypoatomic Substances are refined and crafted into components, modules and other items.",Hypoatomic_Substances.png,uncommon,1106,0,0,1106,0
3535,613,2905,126,Bruma Particles,"Bruma Particles are refined and crafted into components, modules and other items.",Bruma_Particle.png,rare,725,725,0,0,725
3535,614,2905,106,Elastomers,"Elastomers are refined and crafted into components, modules and other items.",Elastomers.png,abundant,5007,0,0,5007,0
3535,1480,2905,121,Hypoatomic Substances,"Hypoatomic Substances are refined and crafted into components, modules and other items.",Hypoatomic_Substances.png,uncommon,2300,0,0,2300,0
3535,1481,9005,115,Nanofluids,"Nanofluids are refined and crafted into components, modules and other items.",Nanofluids.png,common,1371,0,0,1371,0
3535,1482,9005,117,Yprasium,"Yprasium is refined and crafted into components, modules and other items.",Yprasium.png,uncommon,2609,0,0,2609,0
3535,1631,9005,105,Silicates,"Silicates are refined and crafted into components, modules and other items.",Silicates.png,abundant,5846,0,0,5846,0
3537,347,2907,128,Tchaikovium,"Tchaikovium is refined and crafted into components, modules and other items.",Tchaikovium.png,rare,644,0,0,644,0
3537,723,2907,40,Polymetals,"Polymetals are refined and crafted into components, modules and other items.",Polymetals.png,common,2977,0,0,2977,0
3537,907,2907,107,H2O,"H2O is refined and crafted into components, modules and other items.",H20.png,abundant,5319,0,0,5319,0
3537,2321,9007,119,Novis Compounds,"Novis Compounds are refined and crafted into components, modules and other items.",Novis_Compound.png,uncommon,1035,0,0,1035,0
3537,3031,9007,42,Base Minerals,"Base Minerals are refined and crafted into components, modules and other items.",Base_Mineral.png,abundant,4603,0,0,4603,0
3537,4590,9007,40,Polymetals,"Polymetals are refined and crafted into components, modules and other items.",Polymetals.png,common,2699,0,0,2699,0
3541,2100,2910,112,Amphoteric Substances,"Amphoteric Substances are refined and crafted into components, modules and other items.",Amphoteric_Substances.png,common,2818,0,0,2818,0
3541,2143,2910,53,Ignis Ore,"Ignis Ore is refined and crafted into components, modules and other items.",Ignis_Ore.png,rare,716,0,0,716,0
3541,2198,2910,105,Silicates,"Silicates are refined and crafted into components, modules and other items.",Silicates.png,abundant,4654,0,0,4654,0
3548,294,2915,40,Polymetals,"Polymetals are refined and crafted into components, modules and other items.",Polymetals.png,common,2742,343,0,2399,343
3548,445,2915,121,Hypoatomic Substances,"Hypoatomic Substances are refined and crafted into components, modules and other items.",Hypoatomic_Substances.png,uncommon,1130,1130,0,0,1130
3548,990,2915,106,Elastomers,"Elastomers are refined and crafted into components, modules and other items.",Elastomers.png,abundant,4600,460,0,4140,460
3548,1985,9015,115,Nanofluids,"Nanofluids are refined and crafted into components, modules and other items.",Nanofluids.png,common,4995,1500,0,3495,1500
3548,2400,9015,126,Bruma Particles,"Bruma Particles are refined and crafted into components, modules and other items.",Bruma_Particle.png,rare,719,719,0,0,719
3548,2401,9015,115,Nanofluids,"Nanofluids are refined and crafted into components, modules and other items.",Nanofluids.png,common,2653,0,0,2653,0
3548,2402,9015,117,Yprasium,"Yprasium is refined and crafted into components, modules and other items.",Yprasium.png,uncommon,2703,338,0,2365,338
3560,4791,2921,106,Elastomers,"Elastomers are refined and crafted into components, modules and other items.",Elastomers.png,abundant,5169,0,0,5169,0
3560,4792,2921,107,H2O,"H2O is refined and crafted into components, modules and other items.",H20.png,abundant,5208,0,0,5208,0
3560,4203,9021,41,Xensium,"Xensium is refined and crafted into components, modules and other items.",Xensium.png,uncommon,1183,0,0,1183,0
3560,4302,9021,112,Amphoteric Substances,"Amphoteric Substances are refined and crafted into components, modules and other items.",Amphoteric_Substances.png,common,2824,0,0,2824,0
3560,4303,9021,119,Novis Compounds,"Novis Compounds are refined and crafted into components, modules and other items.",Novis_Compound.png,uncommon,2485,0,0,2485,0
3560,7523,9021,107,H2O,"H2O is refined and crafted into components, modules and other items.",H20.png,abundant,5987,0,0,5987,0
3567,2825,2925,42,Base Minerals,"Base Minerals are refined and crafted into components, modules and other items.",Base_Mineral.png,abundant,5317,0,0,5317,0
3572,2262,2929,106,Elastomers,"Elastomers are refined and crafted into components, modules and other items.",Elastomers.png,abundant,2725,0,0,2725,0
3572,3110,2929,127,Microorganisms,"Microorganisms are refined and crafted into components, modules and other items.",Microorganism.png,rare,834,834,0,0,834
3572,3113,2929,106,Elastomers,"Elastomers are refined and crafted into components, modules and other items.",Elastomers.png,abundant,4250,0,0,4250,0
3572,3114,2929,107,H2O,"H2O is refined and crafted into components, modules and other items.",H20.png,abundant,5398,0,0,5398,0
3572,4136,9029,119,Novis Compounds,"Novis Compounds are refined and crafted into components, modules and other items.",Novis_Compound.png,uncommon,1191,0,0,1191,0
3572,4262,9029,112,Amphoteric Substances,"Amphoteric Substances are refined and crafted into components, modules and other items.",Amphoteric_Substances.png,common,2995,0,0,2995,0
3572,4402,9029,110,Plutonium,"Plutonium is refined and crafted into components, modules and other items.",Plutonium.png,common,5786,0,0,5786,0
3575,1367,2932,115,Nanofluids,"Nanofluids are refined and crafted into components, modules and other items.",Nanofluids.png,common,2222,0,0,2222,0
3575,2847,2932,113,Aerogens,"Aerogens are refined and crafted into components, modules and other items.",Aerogens.png,common,1016,0,0,1016,0
3575,2848,2932,105,Silicates,"Silicates are refined and crafted into components, modules and other items.",Silicates.png,abundant,4541,0,0,4541,0
3579,1851,2935,128,Tchaikovium,"Tchaikovium is refined and crafted into components, modules and other items.",Tchaikovium.png,rare,738,738,0,0,738
3579,1852,2935,40,Polymetals,"Polymetals are refined and crafted into components, modules and other items.",Polymetals.png,common,2084,2084,0,0,2084
3579,1853,2935,110,Plutonium,"Plutonium is refined and crafted into components, modules and other items.",Plutonium.png,common,5071,5071,0,0,5071
3588,366,2941,113,Aerogens,"Aerogens are refined and crafted into components, modules and other items.",Aerogens.png,common,1326,0,0,1326,0
3588,724,2941,121,Hypoatomic Substances,"Hypoatomic Substances are refined and crafted into components, modules and other items.",Hypoatomic_Substances.png,uncommon,2779,0,0,2779,0
3588,925,2941,115,Nanofluids,"Nanofluids are refined and crafted into components, modules and other items.",Nanofluids.png,common,4291,0,0,4291,0
3588,2331,9041,113,Aerogens,"Aerogens are refined and crafted into components, modules and other items.",Aerogens.png,common,1390,0,0,1390,0
3588,3041,9041,115,Nanofluids,"Nanofluids are refined and crafted into components, modules and other items.",Nanofluids.png,common,4040,0,0,4040,0
3588,4647,9041,113,Aerogens,"Aerogens are refined and crafted into components, modules and other items.",Aerogens.png,common,2353,0,0,2353,0
3591,19108,2944,114,Ectopolymers,"Ectopolymers are refined and crafted into components, modules and other items.",Ectopolymers.png,common,4996,0,0,4996,0
3591,19702,2944,106,Elastomers,"Elastomers are refined and crafted into components, modules and other items.",Elastomers.png,abundant,2225,0,0,2225,0
3591,19736,2944,123,Neolysium,"Neolysium is refined and crafted into components, modules and other items.",Neolysium.png,uncommon,1434,0,0,1434,0
3599,921,2950,42,Base Minerals,"Base Minerals are refined and crafted into components, modules and other items.",Base_Mineral.png,abundant,2963,0,0,2963,0
3599,1031,2950,110,Plutonium,"Plutonium is refined and crafted into components, modules and other items.",Plutonium.png,common,1027,0,0,1027,0
3599,1032,2950,127,Microorganisms,"Microorganisms are refined and crafted into components, modules and other items.",Microorganism.png,rare,618,0,0,618,0
3599,1188,2950,42,Base Minerals,"Base Minerals are refined and crafted into components, modules and other items.",Base_Mineral.png,abundant,5523,0,0,5523,0
3599,3757,9050,119,Novis Compounds,"Novis Compounds are refined and crafted into components, modules and other items.",Novis_Compound.png,uncommon,1074,0,0,1074,0
3599,3758,9050,54,Hyperspecular Crystals,"Hyperspecular Crystals are refined and crafted into components, modules and other items.",Hyperspecular_Crystals.png,uncommon,2029,0,0,2029,0
3599,3759,9050,110,Plutonium,"Plutonium is refined and crafted into components, modules and other items.",Plutonium.png,common,5714,0,0,5714,0
3601,922,2952,123,Neolysium,"Neolysium is refined and crafted into components, modules and other items.",Neolysium.png,uncommon,2475,620,0,1855,620
3601,1033,2952,112,Amphoteric Substances,"Amphoteric Substances are refined and crafted into components, modules and other items.",Amphoteric_Substances.png,common,1246,0,0,1246,0
3601,1252,2952,107,H2O,"H2O is refined and crafted into components, modules and other items.",H20.png,abundant,4959,1488,0,3471,1488
3601,4165,9052,126,Bruma Particles,"Bruma Particles are refined and crafted into components, modules and other items.",Bruma_Particle.png,rare,834,0,0,834,0
3601,4166,9052,109,Titanium,"Titanium is refined and crafted into components, modules and other items.",Titanium.png,common,2483,0,0,2483,0
3601,4167,9052,42,Base Minerals,"Base Minerals are refined and crafted into components, modules and other items.",Base_Mineral.png,abundant,4605,0,0,4605,0
3604,2107,2955,105,Silicates,"Silicates are refined and crafted into components, modules and other items.",Silicates.png,abundant,4164,0,0,4164,0
3604,2108,2955,42,Base Minerals,"Base Minerals are refined and crafted into components, modules and other items.",Base_Mineral.png,abundant,4100,0,0,4100,0
3604,4344,2955,112,Amphoteric Substances,"Amphoteric Substances are refined and crafted into components, modules and other items.",Amphoteric_Substances.png,common,2548,0,0,2548,0
3604,4642,2955,53,Ignis Ore,"Ignis Ore is refined and crafted into components, modules and other items.",Ignis_Ore.png,rare,780,0,0,780,0
3604,5842,9055,109,Titanium,"Titanium is refined and crafted into components, modules and other items.",Titanium.png,common,2091,0,0,2091,0
3604,6603,9055,123,Neolysium,"Neolysium is refined and crafted into components, modules and other items.",Neolysium.png,uncommon,1218,0,0,1218,0
3604,6604,9055,112,Amphoteric Substances,"Amphoteric Substances are refined and crafted into components, modules and other items.",Amphoteric_Substances.png,common,5450,0,0,5450,0
3612,609,2959,113,Aerogens,"Aerogens are refined and crafted into components, modules and other items.",Aerogens.png,common,1041,0,0,1041,0
3612,886,2959,126,Bruma Particles,"Bruma Particles are refined and crafted into components, modules and other items.",Bruma_Particle.png,rare,1527,0,0,1527,0
3612,887,2959,123,Neolysium,"Neolysium is refined and crafted into components, modules and other items.",Neolysium.png,uncommon,2334,0,0,2334,0
3612,977,2959,54,Hyperspecular Crystals,"Hyperspecular Crystals are refined and crafted into components, modules and other items.",Hyperspecular_Crystals.png,uncommon,5734,0,0,5734,0
3612,2350,9059,52,Organic Compounds,"Organic Compounds are refined and crafted into components, modules and other items.",Organic_Compound.png,common,1085,0,0,1085,0
3612,3326,9059,109,Titanium,"Titanium is refined and crafted into components, modules and other items.",Titanium.png,common,4742,0,0,4742,0
3612,4661,9059,107,H2O,"H2O is refined and crafted into components, modules and other items.",H20.png,abundant,2340,0,0,2340,0
3616,8191,2962,119,Novis Compounds,"Novis Compounds are refined and crafted into components, modules and other items.",Novis_Compound.png,uncommon,1059,0,0,1059,0
3616,8194,2962,115,Nanofluids,"Nanofluids are refined and crafted into components, modules and other items.",Nanofluids.png,common,2183,0,0,2183,0
3616,8195,2962,105,Silicates,"Silicates are refined and crafted into components, modules and other items.",Silicates.png,abundant,5380,0,0,5380,0
3616,8271,9062,128,Tchaikovium,"Tchaikovium is refined and crafted into components, modules and other items.",Tchaikovium.png,rare,661,0,0,661,0
3616,8273,9062,117,Yprasium,"Yprasium is refined and crafted into components, modules and other items.",Yprasium.png,uncommon,2078,0,0,2078,0
3616,8284,9062,106,Elastomers,"Elastomers are refined and crafted into components, modules and other items.",Elastomers.png,abundant,4869,0,0,4869,0
3618,3863,2963,126,Bruma Particles,"Bruma Particles are refined and crafted into components, modules and other items.",Bruma_Particle.png,rare,803,0,0,803,0
3618,3864,2963,126,Bruma Particles,"Bruma Particles are refined and crafted into components, modules and other items.",Bruma_Particle.png,rare,1648,0,0,1648,0
3618,3865,2963,105,Silicates,"Silicates are refined and crafted into components, modules and other items.",Silicates.png,abundant,4014,0,0,4014,0
3625,1368,2968,119,Novis Compounds,"Novis Compounds are refined and crafted into components, modules and other items.",Novis_Compound.png,uncommon,2836,0,0,2836,0
3625,2849,2968,114,Ectopolymers,"Ectopolymers are refined and crafted into components, modules and other items.",Ectopolymers.png,common,1248,0,0,1248,0
3625,2850,2968,42,Base Minerals,"Base Minerals are refined and crafted into components, modules and other items.",Base_Mineral.png,abundant,5581,0,0,5581,0
3626,56,2969,119,Novis Compounds,"Novis Compounds are refined and crafted into components, modules and other items.",Novis_Compound.png,uncommon,1177,0,0,1177,0
3626,494,2969,112,Amphoteric Substances,"Amphoteric Substances are refined and crafted into components, modules and other items.",Amphoteric_Substances.png,common,2274,0,0,2274,0
3626,495,2969,107,H2O,"H2O is refined and crafted into components, modules and other items.",H20.png,abundant,2777,0,0,2777,0
3626,543,2969,40,Polymetals,"Polymetals are refined and crafted into components, modules and other items.",Polymetals.png,common,4805,0,0,4805,0
3626,827,9069,107,H2O,"H2O is refined and crafted into components, modules and other items.",H20.png,abundant,2709,0,0,2709,0
3626,3794,9069,112,Amphoteric Substances,"Amphoteric Substances are refined and crafted into components, modules and other items.",Amphoteric_Substances.png,common,1121,0,0,1121,0
3626,3795,9069,42,Base Minerals,"Base Minerals are refined and crafted into components, modules and other items.",Base_Mineral.png,abundant,5745,0,0,5745,0
3631,3866,2974,113,Aerogens,"Aerogens are refined and crafted into components, modules and other items.",Aerogens.png,common,1176,0,0,1176,0
3631,3867,2974,110,Plutonium,"Plutonium is refined and crafted into components, modules and other items.",Plutonium.png,common,2660,0,0,2660,0
3631,3868,2974,107,H2O,"H2O is refined and crafted into components, modules and other items.",H20.png,abundant,5506,0,0,5506,0
3639,1883,2980,127,Microorganisms,"Microorganisms are refined and crafted into components, modules and other items.",Microorganism.png,rare,706,0,0,706,0
3639,3314,2980,40,Polymetals,"Polymetals are refined and crafted into components, modules and other items.",Polymetals.png,common,5852,0,0,5852,0
3639,3612,2980,112,Amphoteric Substances,"Amphoteric Substances are refined and crafted into components, modules and other items.",Amphoteric_Substances.png,common,2927,0,0,2927,0
3639,3613,2980,110,Plutonium,"Plutonium is refined and crafted into components, modules and other items.",Plutonium.png,common,2670,0,0,2670,0
3639,3666,9080,40,Polymetals,"Polymetals are refined and crafted into components, modules and other items.",Polymetals.png,common,4772,0,0,4772,0
3639,9407,9080,112,Amphoteric Substances,"Amphoteric Substances are refined and crafted into components, modules and other items.",Amphoteric_Substances.png,common,2153,0,0,2153,0
3639,9816,9080,41,Xensium,"Xensium is refined and crafted into components, modules and other items.",Xensium.png,uncommon,1492,0,0,1492,0
3648,15316,2987,128,Tchaikovium,"Tchaikovium is refined and crafted into components, modules and other items.",Tchaikovium.png,rare,645,0,0,645,0
3648,16039,2987,119,Novis Compounds,"Novis Compounds are refined and crafted into components, modules and other items.",Novis_Compound.png,uncommon,2442,0,0,2442,0
3648,18353,2987,114,Ectopolymers,"Ectopolymers are refined and crafted into components, modules and other items.",Ectopolymers.png,common,4154,0,0,4154,0
3649,532,2988,110,Plutonium,"Plutonium is refined and crafted into components, modules and other items.",Plutonium.png,common,1389,0,0,1389,0
3649,533,2988,112,Amphoteric Substances,"Amphoteric Substances are refined and crafted into components, modules and other items.",Amphoteric_Substances.png,common,1123,0,0,1123,0
3649,853,2988,118,Platinyx,"Platinyx is refined and crafted into components, modules and other items.",Platinyx.png,uncommon,2882,0,0,2882,0
3649,854,2988,40,Polymetals,"Polymetals are refined and crafted into components, modules and other items.",Polymetals.png,common,4041,0,0,4041,0
3655,2111,2991,128,Tchaikovium,"Tchaikovium is refined and crafted into components, modules and other items.",Tchaikovium.png,rare,619,0,0,619,0
3655,2189,2991,110,Plutonium,"Plutonium is refined and crafted into components, modules and other items.",Plutonium.png,common,5131,0,0,5131,0
3655,2681,2991,119,Novis Compounds,"Novis Compounds are refined and crafted into components, modules and other items.",Novis_Compound.png,uncommon,2395,0,0,2395,0
3659,923,2995,40,Polymetals,"Polymetals are refined and crafted into components, modules and other items.",Polymetals.png,common,2901,0,0,2901,0
3659,1082,2995,41,Xensium,"Xensium is refined and crafted into components, modules and other items.",Xensium.png,uncommon,1137,0,0,1137,0
3659,1083,2995,127,Microorganisms,"Microorganisms are refined and crafted into components, modules and other items.",Microorganism.png,rare,685,0,0,685,0
3659,1253,2995,107,H2O,"H2O is refined and crafted into components, modules and other items.",H20.png,abundant,5622,0,0,5622,0
3659,4168,9095,110,Plutonium,"Plutonium is refined and crafted into components, modules and other items.",Plutonium.png,common,1097,0,0,1097,0
3659,4169,9095,107,H2O,"H2O is refined and crafted into components, modules and other items.",H20.png,abundant,2513,0,0,2513,0
3659,4170,9095,109,Titanium,"Titanium is refined and crafted into components, modules and other items.",Titanium.png,common,5888,0,0,5888,0
3661,4382,2997,127,Microorganisms,"Microorganisms are refined and crafted into components, modules and other items.",Microorganism.png,rare,639,256,0,383,256
3661,13861,2997,106,Elastomers,"Elastomers are refined and crafted into components, modules and other items.",Elastomers.png,abundant,5095,0,0,5095,0
3661,14686,2997,118,Platinyx,"Platinyx is refined and crafted into components, modules and other items.",Platinyx.png,uncommon,2172,0,0,2172,0
3661,14690,9097,121,Hypoatomic Substances,"Hypoatomic Substances are refined and crafted into components, modules and other items.",Hypoatomic_Substances.png,uncommon,1108,0,0,1108,0
3661,15115,9097,107,H2O,"H2O is refined and crafted into components, modules and other items.",H20.png,abundant,2614,327,0,2287,327
3661,15116,9097,53,Ignis Ore,"Ignis Ore is refined and crafted into components, modules and other items.",Ignis_Ore.png,rare,2713,272,0,2441,272
3668,1369,3003,114,Ectopolymers,"Ectopolymers are refined and crafted into components, modules and other items.",Ectopolymers.png,common,2049,0,0,2049,0
3668,2851,3003,53,Ignis Ore,"Ignis Ore is refined and crafted into components, modules and other items.",Ignis_Ore.png,rare,816,0,0,816,0
3668,2852,3003,107,H2O,"H2O is refined and crafted into components, modules and other items.",H20.png,abundant,4200,0,0,4200,0
3677,2410,3007,114,Ectopolymers,"Ectopolymers are refined and crafted into components, modules and other items.",Ectopolymers.png,common,1201,0,0,1201,0
3677,4365,3007,114,Ectopolymers,"Ectopolymers are refined and crafted into components, modules and other items.",Ectopolymers.png,common,2219,0,0,2219,0
3677,4500,3007,105,Silicates,"Silicates are refined and crafted into components, modules and other items.",Silicates.png,abundant,5123,0,0,5123,0
3678,3000,3008,126,Bruma Particles,"Bruma Particles are refined and crafted into components, modules and other items.",Bruma_Particle.png,rare,827,0,0,827,0
3678,3047,3008,106,Elastomers,"Elastomers are refined and crafted into components, modules and other items.",Elastomers.png,abundant,2867,0,0,2867,0
3678,5586,3008,113,Aerogens,"Aerogens are refined and crafted into components, modules and other items.",Aerogens.png,common,4007,0,0,4007,0
3684,856,3012,40,Polymetals,"Polymetals are refined and crafted into components, modules and other items.",Polymetals.png,common,2870,0,0,2870,0
3684,858,3012,117,Yprasium,"Yprasium is refined and crafted into components, modules and other items.",Yprasium.png,uncommon,1413,0,0,1413,0
3684,4415,3012,106,Elastomers,"Elastomers are refined and crafted into components, modules and other items.",Elastomers.png,abundant,5190,0,0,5190,0
3688,4091,3014,54,Hyperspecular Crystals,"Hyperspecular Crystals are refined and crafted into components, modules and other items.",Hyperspecular_Crystals.png,uncommon,1254,0,0,1254,0
3688,4092,3014,54,Hyperspecular Crystals,"Hyperspecular Crystals are refined and crafted into components, modules and other items.",Hyperspecular_Crystals.png,uncommon,2320,0,0,2320,0
3688,4093,3014,106,Elastomers,"Elastomers are refined and crafted into components, modules and other items.",Elastomers.png,abundant,4769,0,0,4769,0
3693,721,3017,106,Elastomers,"Elastomers are refined and crafted into components, modules and other items.",Elastomers.png,abundant,2228,279,0,1949,279
3693,768,3017,117,Yprasium,"Yprasium is refined and crafted into components, modules and other items.",Yprasium.png,uncommon,1383,0,0,1383,0
3693,769,3017,127,Microorganisms,"Microorganisms are refined and crafted into components, modules and other items.",Microorganism.png,rare,834,501,0,333,501
3693,3710,3017,114,Ectopolymers,"Ectopolymers are refined and crafted into components, modules and other items.",Ectopolymers.png,common,4962,0,0,4962,0
3693,13432,9117,54,Hyperspecular Crystals,"Hyperspecular Crystals are refined and crafted into components, modules and other items.",Hyperspecular_Crystals.png,uncommon,2301,0,0,2301,0
3694,2784,3018,126,Bruma Particles,"Bruma Particles are refined and crafted into components, modules and other items.",Bruma_Particle.png,rare,635,0,0,635,0
3694,2785,3018,110,Plutonium,"Plutonium is refined and crafted into components, modules and other items.",Plutonium.png,common,2117,0,0,2117,0
3694,2786,3018,106,Elastomers,"Elastomers are refined and crafted into components, modules and other items.",Elastomers.png,abundant,5074,0,0,5074,0
3696,3002,3019,107,H2O,"H2O is refined and crafted into components, modules and other items.",H20.png,abundant,5365,0,0,5365,0
3696,3947,3019,109,Titanium,"Titanium is refined and crafted into components, modules and other items.",Titanium.png,common,2648,0,0,2648,0
3696,8274,3019,127,Microorganisms,"Microorganisms are refined and crafted into components, modules and other items.",Microorganism.png,rare,604,0,0,604,0
3696,18976,9119,127,Microorganisms,"Microorganisms are refined and crafted into components, modules and other items.",Microorganism.png,rare,737,0,0,737,0
3696,19211,9119,117,Yprasium,"Yprasium is refined and crafted into components, modules and other items.",Yprasium.png,uncommon,4039,0,0,4039,0
3696,19537,9119,107,H2O,"H2O is refined and crafted into components, modules and other items.",H20.png,abundant,2601,0,0,2601,0
3699,2144,3022,127,Microorganisms,"Microorganisms are refined and crafted into components, modules and other items.",Microorganism.png,rare,819,0,0,819,0
3699,2145,3022,127,Microorganisms,"Microorganisms are refined and crafted into components, modules and other items.",Microorganism.png,rare,835,0,0,835,0
3699,2199,3022,115,Nanofluids,"Nanofluids are refined and crafted into components, modules and other items.",Nanofluids.png,common,2600,0,0,2600,0
3699,2200,3022,106,Elastomers,"Elastomers are refined and crafted into components, modules and other items.",Elastomers.png,abundant,4508,0,0,4508,0
3700,2919,3023,118,Platinyx,"Platinyx is refined and crafted into components, modules and other items.",Platinyx.png,uncommon,1240,0,0,1240,0
3700,2920,3023,119,Novis Compounds,"Novis Compounds are refined and crafted into components, modules and other items.",Novis_Compound.png,uncommon,2673,0,0,2673,0
3700,2921,3023,42,Base Minerals,"Base Minerals are refined and crafted into components, modules and other items.",Base_Mineral.png,abundant,5598,0,0,5598,0
3702,2922,3025,126,Bruma Particles,"Bruma Particles are refined and crafted into components, modules and other items.",Bruma_Particle.png,rare,700,0,0,700,0
3702,2923,3025,113,Aerogens,"Aerogens are refined and crafted into components, modules and other items.",Aerogens.png,common,2093,0,0,2093,0
3702,2924,3025,105,Silicates,"Silicates are refined and crafted into components, modules and other items.",Silicates.png,abundant,4575,0,0,4575,0
3703,1854,3026,119,Novis Compounds,"Novis Compounds are refined and crafted into components, modules and other items.",Novis_Compound.png,uncommon,1340,0,0,1340,0
3703,1855,3026,40,Polymetals,"Polymetals are refined and crafted into components, modules and other items.",Polymetals.png,common,2962,0,0,2962,0
3703,1856,3026,106,Elastomers,"Elastomers are refined and crafted into components, modules and other items.",Elastomers.png,abundant,5898,0,0,5898,0
3705,12277,3027,120,Metamagnetic Ore,"Metamagnetic Ore is refined and crafted into components, modules and other items.",Metamagnetic_Ore.png,uncommon,1083,0,0,1083,0
3709,574,3030,42,Base Minerals,"Base Minerals are refined and crafted into components, modules and other items.",Base_Mineral.png,abundant,2411,0,0,2411,0
3709,7520,3030,107,H2O,"H2O is refined and crafted into components, modules and other items.",H20.png,abundant,5986,0,0,5986,0
3709,16774,3030,120,Metamagnetic Ore,"Metamagnetic Ore is refined and crafted into components, modules and other items.",Metamagnetic_Ore.png,uncommon,1017,0,0,1017,0
3715,1346,3035,106,Elastomers,"Elastomers are refined and crafted into components, modules and other items.",Elastomers.png,abundant,5455,0,0,5455,0
3715,3311,3035,120,Metamagnetic Ore,"Metamagnetic Ore is refined and crafted into components, modules and other items.",Metamagnetic_Ore.png,uncommon,2761,0,0,2761,0
3715,1347,9135,115,Nanofluids,"Nanofluids are refined and crafted into components, modules and other items.",Nanofluids.png,common,2401,301,0,2100,301
3715,1348,9135,41,Xensium,"Xensium is refined and crafted into components, modules and other items.",Xensium.png,uncommon,2805,0,0,2805,0
3715,1866,9135,106,Elastomers,"Elastomers are refined and crafted into components, modules and other items.",Elastomers.png,abundant,5725,0,0,5725,0
3715,2460,9135,41,Xensium,"Xensium is refined and crafted into components, modules and other items.",Xensium.png,uncommon,1447,0,0,1447,0
3716,4094,3036,128,Tchaikovium,"Tchaikovium is refined and crafted into components, modules and other items.",Tchaikovium.png,rare,714,0,0,714,0
3716,4095,3036,106,Elastomers,"Elastomers are refined and crafted into components, modules and other items.",Elastomers.png,abundant,2342,0,0,2342,0
3716,4096,3036,110,Plutonium,"Plutonium is refined and crafted into components, modules and other items.",Plutonium.png,common,5339,0,0,5339,0
3717,363,3037,106,Elastomers,"Elastomers are refined and crafted into components, modules and other items.",Elastomers.png,abundant,4710,471,0,4239,471
3717,551,3037,112,Amphoteric Substances,"Amphoteric Substances are refined and crafted into components, modules and other items.",Amphoteric_Substances.png,common,1008,0,0,1008,0
3717,3697,3037,112,Amphoteric Substances,"Amphoteric Substances are refined and crafted into components, modules and other items.",Amphoteric_Substances.png,common,2289,0,0,2289,0
3717,3698,9137,107,H2O,"H2O is refined and crafted into components, modules and other items.",H20.png,abundant,5947,0,0,5947,0
3717,3699,9137,41,Xensium,"Xensium is refined and crafted into components, modules and other items.",Xensium.png,uncommon,1242,0,0,1242,0
3717,3700,9137,40,Polymetals,"Polymetals are refined and crafted into components, modules and other items.",Polymetals.png,common,2341,0,0,2341,0
3718,2925,3038,126,Bruma Particles,"Bruma Particles are refined and crafted into components, modules and other items.",Bruma_Particle.png,rare,604,0,0,604,0
3718,2926,3038,123,Neolysium,"Neolysium is refined and crafted into components, modules and other items.",Neolysium.png,uncommon,2353,0,0,2353,0
3718,2927,3038,40,Polymetals,"Polymetals are refined and crafted into components, modules and other items.",Polymetals.png,common,5669,0,0,5669,0
3721,644,3040,109,Titanium,"Titanium is refined and crafted into components, modules and other items.",Titanium.png,common,1118,0,0,1118,0
3721,908,3040,42,Base Minerals,"Base Minerals are refined and crafted into components, modules and other items.",Base_Mineral.png,abundant,2942,0,0,2942,0
3721,978,3040,107,H2O,"H2O is refined and crafted into components, modules and other items.",H20.png,abundant,4707,0,0,4707,0
3721,979,3040,106,Elastomers,"Elastomers are refined and crafted into components, modules and other items.",Elastomers.png,abundant,5046,0,0,5046,0
3721,2562,9140,52,Organic Compounds,"Organic Compounds are refined and crafted into components, modules and other items.",Organic_Compound.png,common,1160,0,0,1160,0
3721,3341,9140,52,Organic Compounds,"Organic Compounds are refined and crafted into components, modules and other items.",Organic_Compound.png,common,5196,0,0,5196,0
3721,4705,9140,41,Xensium,"Xensium is refined and crafted into components, modules and other items.",Xensium.png,uncommon,2126,0,0,2126,0
3729,66,3044,118,Platinyx,"Platinyx is refined and crafted into components, modules and other items.",Platinyx.png,uncommon,1056,0,0,1056,0
3729,496,3044,42,Base Minerals,"Base Minerals are refined and crafted into components, modules and other items.",Base_Mineral.png,abundant,2400,0,0,2400,0
3729,497,3044,118,Platinyx,"Platinyx is refined and crafted into components, modules and other items.",Platinyx.png,uncommon,2415,0,0,2415,0
3729,1278,3044,42,Base Minerals,"Base Minerals are refined and crafted into components, modules and other items.",Base_Mineral.png,abundant,5253,0,0,5253,0
3729,917,9144,119,Novis Compounds,"Novis Compounds are refined and crafted into components, modules and other items.",Novis_Compound.png,uncommon,2209,0,0,2209,0
3729,3768,9144,120,Metamagnetic Ore,"Metamagnetic Ore is refined and crafted into components, modules and other items.",Metamagnetic_Ore.png,uncommon,1308,0,0,1308,0
3729,3769,9144,42,Base Minerals,"Base Minerals are refined and crafted into components, modules and other items.",Base_Mineral.png,abundant,5014,0,0,5014,0
3747,10680,9154,41,Xensium,"Xensium is refined and crafted into components, modules and other items.",Xensium.png,uncommon,1259,0,0,1259,0
3747,10681,9154,123,Neolysium,"Neolysium is refined and crafted into components, modules and other items.",Neolysium.png,uncommon,1093,0,0,1093,0
3747,10682,9154,120,Metamagnetic Ore,"Metamagnetic Ore is refined and crafted into components, modules and other items.",Metamagnetic_Ore.png,uncommon,2279,0,0,2279,0
3747,10683,9154,112,Amphoteric Substances,"Amphoteric Substances are refined and crafted into components, modules and other items.",Amphoteric_Substances.png,common,5352,0,0,5352,0
3750,17387,3057,121,Hypoatomic Substances,"Hypoatomic Substances are refined and crafted into components, modules and other items.",Hypoatomic_Substances.png,uncommon,1110,0,0,1110,0
3750,17388,3057,114,Ectopolymers,"Ectopolymers are refined and crafted into components, modules and other items.",Ectopolymers.png,common,2490,0,0,2490,0
3750,17390,3057,105,Silicates,"Silicates are refined and crafted into components, modules and other items.",Silicates.png,abundant,5193,0,0,5193,0
3752,2481,3059,127,Microorganisms,"Microorganisms are refined and crafted into components, modules and other items.",Microorganism.png,rare,802,0,0,802,0
3752,4501,3059,106,Elastomers,"Elastomers are refined and crafted into components, modules and other items.",Elastomers.png,abundant,4769,0,0,4769,0
3752,12147,3059,123,Neolysium,"Neolysium is refined and crafted into components, modules and other items.",Neolysium.png,uncommon,2703,0,0,2703,0
3752,12148,3059,41,Xensium,"Xensium is refined and crafted into components, modules and other items.",Xensium.png,uncommon,2719,0,0,2719,0
3765,2928,3068,119,Novis Compounds,"Novis Compounds are refined and crafted into components, modules and other items.",Novis_Compound.png,uncommon,1128,0,0,1128,0
3765,2929,3068,119,Novis Compounds,"Novis Compounds are refined and crafted into components, modules and other items.",Novis_Compound.png,uncommon,2023,0,0,2023,0
3765,2930,3068,115,Nanofluids,"Nanofluids are refined and crafted into components, modules and other items.",Nanofluids.png,common,2144,0,0,2144,0
3765,2931,3068,42,Base Minerals,"Base Minerals are refined and crafted into components, modules and other items.",Base_Mineral.png,abundant,5369,0,0,5369,0
3769,3869,3071,115,Nanofluids,"Nanofluids are refined and crafted into components, modules and other items.",Nanofluids.png,common,1485,0,0,1485,0
3769,3870,3071,115,Nanofluids,"Nanofluids are refined and crafted into components, modules and other items.",Nanofluids.png,common,2406,0,0,2406,0
3769,3871,3071,106,Elastomers,"Elastomers are refined and crafted into components, modules and other items.",Elastomers.png,abundant,5923,0,0,5923,0
3775,4097,3076,126,Bruma Particles,"Bruma Particles are refined and crafted into components, modules and other items.",Bruma_Particle.png,rare,899,0,0,899,0
3775,4098,3076,105,Silicates,"Silicates are refined and crafted into components, modules and other items.",Silicates.png,abundant,2976,0,0,2976,0
3775,4099,3076,115,Nanofluids,"Nanofluids are refined and crafted into components, modules and other items.",Nanofluids.png,common,4711,0,0,4711,0
3778,17391,3078,119,Novis Compounds,"Novis Compounds are refined and crafted into components, modules and other items.",Novis_Compound.png,uncommon,1100,0,0,1100,0
3778,17392,3078,42,Base Minerals,"Base Minerals are refined and crafted into components, modules and other items.",Base_Mineral.png,abundant,2052,0,0,2052,0
3778,17393,3078,105,Silicates,"Silicates are refined and crafted into components, modules and other items.",Silicates.png,abundant,5072,0,0,5072,0
3779,13399,3079,118,Platinyx,"Platinyx is refined and crafted into components, modules and other items.",Platinyx.png,uncommon,1487,0,0,1487,0
3779,13564,3079,106,Elastomers,"Elastomers are refined and crafted into components, modules and other items.",Elastomers.png,abundant,2405,0,0,2405,0
3779,17800,3079,42,Base Minerals,"Base Minerals are refined and crafted into components, modules and other items.",Base_Mineral.png,abundant,4212,0,0,4212,0
3779,17736,9179,115,Nanofluids,"Nanofluids are refined and crafted into components, modules and other items.",Nanofluids.png,common,4148,0,0,4148,0
3784,18880,3082,105,Silicates,"Silicates are refined and crafted into components, modules and other items.",Silicates.png,abundant,4680,0,0,4680,0
3784,19609,3082,127,Microorganisms,"Microorganisms are refined and crafted into components, modules and other items.",Microorganism.png,rare,878,0,0,878,0
3784,19999,3082,42,Base Minerals,"Base Minerals are refined and crafted into components, modules and other items.",Base_Mineral.png,abundant,2184,0,0,2184,0
3785,4323,3083,113,Aerogens,"Aerogens are refined and crafted into components, modules and other items.",Aerogens.png,common,2724,0,0,2724,0
3785,4324,3083,42,Base Minerals,"Base Minerals are refined and crafted into components, modules and other items.",Base_Mineral.png,abundant,5128,0,0,5128,0
3785,12872,3083,118,Platinyx,"Platinyx is refined and crafted into components, modules and other items.",Platinyx.png,uncommon,1174,0,0,1174,0
3785,17733,9183,105,Silicates,"Silicates are refined and crafted into components, modules and other items.",Silicates.png,abundant,2484,0,0,2484,0
3791,195,3086,126,Bruma Particles,"Bruma Particles are refined and crafted into components, modules and other items.",Bruma_Particle.png,rare,895,0,0,895,0
3791,498,3086,105,Silicates,"Silicates are refined and crafted into components, modules and other items.",Silicates.png,abundant,2551,0,0,2551,0
3791,1279,3086,105,Silicates,"Silicates are refined and crafted into components, modules and other items.",Silicates.png,abundant,5042,0,0,5042,0
3791,962,9186,114,Ectopolymers,"Ectopolymers are refined and crafted into components, modules and other items.",Ectopolymers.png,common,2110,0,0,2110,0
3791,3532,9186,126,Bruma Particles,"Bruma Particles are refined and crafted into components, modules and other items.",Bruma_Particle.png,rare,857,0,0,857,0
3791,3533,9186,42,Base Minerals,"Base Minerals are refined and crafted into components, modules and other items.",Base_Mineral.png,abundant,4413,0,0,4413,0
3791,3534,9186,106,Elastomers,"Elastomers are refined and crafted into components, modules and other items.",Elastomers.png,abundant,4970,0,0,4970,0
3796,5382,3088,42,Base Minerals,"Base Minerals are refined and crafted into components, modules and other items.",Base_Mineral.png,abundant,4186,0,0,4186,0
3796,7989,3088,114,Ectopolymers,"Ectopolymers are refined and crafted into components, modules and other items.",Ectopolymers.png,common,1380,0,0,1380,0
3801,3144,3091,41,Xensium,"Xensium is refined and crafted into components, modules and other items.",Xensium.png,uncommon,1179,236,0,943,236
3801,14258,3091,42,Base Minerals,"Base Minerals are refined and crafted into components, modules and other items.",Base_Mineral.png,abundant,2589,648,0,1941,648
3801,14259,3091,107,H2O,"H2O is refined and crafted into components, modules and other items.",H20.png,abundant,5266,0,0,5266,0
3802,1195,3092,106,Elastomers,"Elastomers are refined and crafted into components, modules and other items.",Elastomers.png,abundant,5210,0,0,5210,0
3802,1227,3092,128,Tchaikovium,"Tchaikovium is refined and crafted into components, modules and other items.",Tchaikovium.png,rare,714,0,0,714,0
3802,1228,3092,114,Ectopolymers,"Ectopolymers are refined and crafted into components, modules and other items.",Ectopolymers.png,common,2825,0,0,2825,0
3802,18062,9192,110,Plutonium,"Plutonium is refined and crafted into components, modules and other items.",Plutonium.png,common,1110,0,0,1110,0
3802,18063,9192,54,Hyperspecular Crystals,"Hyperspecular Crystals are refined and crafted into components, modules and other items.",Hyperspecular_Crystals.png,uncommon,2838,0,0,2838,0
3802,18064,9192,105,Silicates,"Silicates are refined and crafted into components, modules and other items.",Silicates.png,abundant,4484,0,0,4484,0
3807,3872,3095,115,Nanofluids,"Nanofluids are refined and crafted into components, modules and other items.",Nanofluids.png,common,1157,0,0,1157,0
3807,3873,3095,106,Elastomers,"Elastomers are refined and crafted into components, modules and other items.",Elastomers.png,abundant,2912,0,0,2912,0
3807,3874,3095,106,Elastomers,"Elastomers are refined and crafted into components, modules and other items.",Elastomers.png,abundant,4464,0,0,4464,0
3811,4143,3097,54,Hyperspecular Crystals,"Hyperspecular Crystals are refined and crafted into components, modules and other items.",Hyperspecular_Crystals.png,uncommon,1042,0,0,1042,0
3828,14638,3110,112,Amphoteric Substances,"Amphoteric Substances are refined and crafted into components, modules and other items.",Amphoteric_Substances.png,common,2105,0,0,2105,0
3851,550,3127,112,Amphoteric Substances,"Amphoteric Substances are refined and crafted into components, modules and other items.",Amphoteric_Substances.png,common,1376,0,0,1376,0
3851,578,3127,107,H2O,"H2O is refined and crafted into components, modules and other items.",H20.png,abundant,2418,0,0,2418,0
3851,579,3127,105,Silicates,"Silicates are refined and crafted into components, modules and other items.",Silicates.png,abundant,2282,0,0,2282,0
3855,963,3131,54,Hyperspecular Crystals,"Hyperspecular Crystals are refined and crafted into components, modules and other items.",Hyperspecular_Crystals.png,uncommon,2419,0,0,2419,0
3855,1084,3131,112,Amphoteric Substances,"Amphoteric Substances are refined and crafted into components, modules and other items.",Amphoteric_Substances.png,common,1238,0,0,1238,0
3855,1280,3131,105,Silicates,"Silicates are refined and crafted into components, modules and other items.",Silicates.png,abundant,5050,0,0,5050,0
3855,1281,3131,42,Base Minerals,"Base Minerals are refined and crafted into components, modules and other items.",Base_Mineral.png,abundant,5217,0,0,5217,0
3855,3802,9231,117,Yprasium,"Yprasium is refined and crafted into components, modules and other items.",Yprasium.png,uncommon,1120,0,0,1120,0
3855,3803,9231,115,Nanofluids,"Nanofluids are refined and crafted into components, modules and other items.",Nanofluids.png,common,2185,0,0,2185,0
3855,4146,9231,105,Silicates,"Silicates are refined and crafted into components, modules and other items.",Silicates.png,abundant,4934,0,0,4934,0
3861,3233,3136,115,Nanofluids,"Nanofluids are refined and crafted into components, modules and other items.",Nanofluids.png,common,1359,0,0,1359,0
3861,3234,3136,115,Nanofluids,"Nanofluids are refined and crafted into components, modules and other items.",Nanofluids.png,common,2704,0,0,2704,0
3861,3235,3136,115,Nanofluids,"Nanofluids are refined and crafted into components, modules and other items.",Nanofluids.png,common,5616,0,0,5616,0
3870,1716,3144,126,Bruma Particles,"Bruma Particles are refined and crafted into components, modules and other items.",Bruma_Particle.png,rare,784,0,0,784,0
3870,2380,3144,105,Silicates,"Silicates are refined and crafted into components, modules and other items.",Silicates.png,abundant,4605,0,0,4605,0
3870,2454,3144,106,Elastomers,"Elastomers are refined and crafted into components, modules and other items.",Elastomers.png,abundant,2592,0,0,2592,0
3870,4386,9244,121,Hypoatomic Substances,"Hypoatomic Substances are refined and crafted into components, modules and other items.",Hypoatomic_Substances.png,uncommon,1008,0,0,1008,0
3870,4387,9244,105,Silicates,"Silicates are refined and crafted into components, modules and other items.",Silicates.png,abundant,2003,0,0,2003,0
3870,4388,9244,106,Elastomers,"Elastomers are refined and crafted into components, modules and other items.",Elastomers.png,abundant,2426,0,0,2426,0
3870,4389,9244,105,Silicates,"Silicates are refined and crafted into components, modules and other items.",Silicates.png,abundant,5296,0,0,5296,0
3873,2010,3146,126,Bruma Particles,"Bruma Particles are refined and crafted into components, modules and other items.",Bruma_Particle.png,rare,765,0,0,765,0
3873,2011,3146,123,Neolysium,"Neolysium is refined and crafted into components, modules and other items.",Neolysium.png,uncommon,1477,0,0,1477,0
3873,2190,3146,106,Elastomers,"Elastomers are refined and crafted into components, modules and other items.",Elastomers.png,abundant,5222,0,0,5222,0
3873,2682,3146,113,Aerogens,"Aerogens are refined and crafted into components, modules and other items.",Aerogens.png,common,2075,0,0,2075,0
3882,18593,3152,112,Amphoteric Substances,"Amphoteric Substances are refined and crafted into components, modules and other items.",Amphoteric_Substances.png,common,1266,0,0,1266,0
3882,18879,3152,112,Amphoteric Substances,"Amphoteric Substances are refined and crafted into components, modules and other items.",Amphoteric_Substances.png,common,4196,0,0,4196,0
3892,8202,3159,117,Yprasium,"Yprasium is refined and crafted into components, modules and other items.",Yprasium.png,uncommon,4122,0,0,4122,0
3892,8204,3159,118,Platinyx,"Platinyx is refined and crafted into components, modules and other items.",Platinyx.png,uncommon,1052,0,0,1052,0
3898,16768,3163,118,Platinyx,"Platinyx is refined and crafted into components, modules and other items.",Platinyx.png,uncommon,1101,0,0,1101,0
3898,16769,3163,40,Polymetals,"Polymetals are refined and crafted into components, modules and other items.",Polymetals.png,common,2477,0,0,2477,0
3898,16770,3163,40,Polymetals,"Polymetals are refined and crafted into components, modules and other items.",Polymetals.png,common,5159,0,0,5159,0
3902,3151,3166,105,Silicates,"Silicates are refined and crafted into components, modules and other items.",Silicates.png,abundant,5586,0,0,5586,0
3902,3152,3166,106,Elastomers,"Elastomers are refined and crafted into components, modules and other items.",Elastomers.png,abundant,2315,0,0,2315,0
3902,3153,3166,123,Neolysium,"Neolysium is refined and crafted into components, modules and other items.",Neolysium.png,uncommon,1062,0,0,1062,0
3905,706,3168,105,Silicates,"Silicates are refined and crafted into components, modules and other items.",Silicates.png,abundant,5580,0,0,5580,0
3905,707,3168,53,Ignis Ore,"Ignis Ore is refined and crafted into components, modules and other items.",Ignis_Ore.png,rare,892,0,0,892,0
3905,708,3168,121,Hypoatomic Substances,"Hypoatomic Substances are refined and crafted into components, modules and other items.",Hypoatomic_Substances.png,uncommon,2460,0,0,2460,0
3906,2062,3169,109,Titanium,"Titanium is refined and crafted into components, modules and other items.",Titanium.png,common,2491,0,0,2491,0
3909,10632,9272,54,Hyperspecular Crystals,"Hyperspecular Crystals are refined and crafted into components, modules and other items.",Hyperspecular_Crystals.png,uncommon,1012,0,0,1012,0
3909,10633,9272,54,Hyperspecular Crystals,"Hyperspecular Crystals are refined and crafted into components, modules and other items.",Hyperspecular_Crystals.png,uncommon,2519,0,0,2519,0
3909,10634,9272,54,Hyperspecular Crystals,"Hyperspecular Crystals are refined and crafted into components, modules and other items.",Hyperspecular_Crystals.png,uncommon,2010,0,0,2010,0
3909,10635,9272,54,Hyperspecular Crystals,"Hyperspecular Crystals are refined and crafted into components, modules and other items.",Hyperspecular_Crystals.png,uncommon,5353,0,0,5353,0
3912,3875,3175,53,Ignis Ore,"Ignis Ore is refined and crafted into components, modules and other items.",Ignis_Ore.png,rare,723,0,0,723,0
3912,3876,3175,112,Amphoteric Substances,"Amphoteric Substances are refined and crafted into components, modules and other items.",Amphoteric_Substances.png,common,2189,0,0,2189,0
3912,4087,3175,42,Base Minerals,"Base Minerals are refined and crafted into components, modules and other items.",Base_Mineral.png,abundant,5062,0,0,5062,0
3916,3740,3179,119,Novis Compounds,"Novis Compounds are refined and crafted into components, modules and other items.",Novis_Compound.png,uncommon,1184,0,0,1184,0
3916,3741,3179,118,Platinyx,"Platinyx is refined and crafted into components, modules and other items.",Platinyx.png,uncommon,2138,0,0,2138,0
3916,3805,3179,110,Plutonium,"Plutonium is refined and crafted into components, modules and other items.",Plutonium.png,common,4055,0,0,4055,0
3932,5847,3188,121,Hypoatomic Substances,"Hypoatomic Substances are refined and crafted into components, modules and other items.",Hypoatomic_Substances.png,uncommon,2305,0,0,2305,0
3932,5848,3188,106,Elastomers,"Elastomers are refined and crafted into components, modules and other items.",Elastomers.png,abundant,4197,0,0,4197,0
3932,6173,3188,52,Organic Compounds,"Organic Compounds are refined and crafted into components, modules and other items.",Organic_Compound.png,common,1317,0,0,1317,0
3932,17764,9288,107,H2O,"H2O is refined and crafted into components, modules and other items.",H20.png,abundant,5386,0,0,5386,0
3932,17765,9288,127,Microorganisms,"Microorganisms are refined and crafted into components, modules and other items.",Microorganism.png,rare,1691,0,0,1691,0
3932,18029,9288,40,Polymetals,"Polymetals are refined and crafted into components, modules and other items.",Polymetals.png,common,1323,0,0,1323,0
3937,11816,3193,118,Platinyx,"Platinyx is refined and crafted into components, modules and other items.",Platinyx.png,uncommon,1377,0,0,1377,0
3937,13003,3193,40,Polymetals,"Polymetals are refined and crafted into components, modules and other items.",Polymetals.png,common,4069,0,0,4069,0
3937,16369,3193,53,Ignis Ore,"Ignis Ore is refined and crafted into components, modules and other items.",Ignis_Ore.png,rare,1688,0,0,1688,0
3937,9307,9293,128,Tchaikovium,"Tchaikovium is refined and crafted into components, modules and other items.",Tchaikovium.png,rare,776,0,0,776,0
3939,1008,3195,52,Organic Compounds,"Organic Compounds are refined and crafted into components, modules and other items.",Organic_Compound.png,common,2587,0,0,2587,0
3939,1009,3195,107,H2O,"H2O is refined and crafted into components, modules and other items.",H20.png,abundant,2864,0,0,2864,0
3939,7614,3195,106,Elastomers,"Elastomers are refined and crafted into components, modules and other items.",Elastomers.png,abundant,5014,0,0,5014,0
3939,7615,3195,107,H2O,"H2O is refined and crafted into components, modules and other items.",H20.png,abundant,4786,0,0,4786,0
3943,3236,3199,128,Tchaikovium,"Tchaikovium is refined and crafted into components, modules and other items.",Tchaikovium.png,rare,805,0,0,805,0
3943,3237,3199,118,Platinyx,"Platinyx is refined and crafted into components, modules and other items.",Platinyx.png,uncommon,2309,0,0,2309,0
3943,3238,3199,106,Elastomers,"Elastomers are refined and crafted into components, modules and other items.",Elastomers.png,abundant,5718,0,0,5718,0
3946,116,3201,118,Platinyx,"Platinyx is refined and crafted into components, modules and other items.",Platinyx.png,uncommon,1110,0,0,1110,0
3946,117,3201,126,Bruma Particles,"Bruma Particles are refined and crafted into components, modules and other items.",Bruma_Particle.png,rare,3555,0,0,3555,0
3946,118,3201,112,Amphoteric Substances,"Amphoteric Substances are refined and crafted into components, modules and other items.",Amphoteric_Substances.png,common,5157,0,0,5157,0
3946,119,3201,40,Polymetals,"Polymetals are refined and crafted into components, modules and other items.",Polymetals.png,common,2717,0,0,2717,0
3946,120,3201,110,Plutonium,"Plutonium is refined and crafted into components, modules and other items.",Plutonium.png,common,2715,0,0,2715,0
3946,265,9301,105,Silicates,"Silicates are refined and crafted into components, modules and other items.",Silicates.png,abundant,5336,0,0,5336,0
3954,7129,3205,54,Hyperspecular Crystals,"Hyperspecular Crystals are refined and crafted into components, modules and other items.",Hyperspecular_Crystals.png,uncommon,2200,0,0,2200,0
3954,7627,3205,54,Hyperspecular Crystals,"Hyperspecular Crystals are refined and crafted into components, modules and other items.",Hyperspecular_Crystals.png,uncommon,1460,0,0,1460,0
3954,7805,3205,115,Nanofluids,"Nanofluids are refined and crafted into components, modules and other items.",Nanofluids.png,common,4231,0,0,4231,0
3955,3806,3206,53,Ignis Ore,"Ignis Ore is refined and crafted into components, modules and other items.",Ignis_Ore.png,rare,701,0,0,701,0
3955,3807,3206,120,Metamagnetic Ore,"Metamagnetic Ore is refined and crafted into components, modules and other items.",Metamagnetic_Ore.png,uncommon,2282,0,0,2282,0
3955,3808,3206,112,Amphoteric Substances,"Amphoteric Substances are refined and crafted into components, modules and other items.",Amphoteric_Substances.png,common,5178,0,0,5178,0
3957,15350,3208,53,Ignis Ore,"Ignis Ore is refined and crafted into components, modules and other items.",Ignis_Ore.png,rare,824,0,0,824,0
3957,16303,3208,120,Metamagnetic Ore,"Metamagnetic Ore is refined and crafted into components, modules and other items.",Metamagnetic_Ore.png,uncommon,2091,0,0,2091,0
3957,18481,3208,42,Base Minerals,"Base Minerals are refined and crafted into components, modules and other items.",Base_Mineral.png,abundant,5752,0,0,5752,0
3960,12748,3210,110,Plutonium,"Plutonium is refined and crafted into components, modules and other items.",Plutonium.png,common,1446,0,0,1446,0
3960,13635,3210,107,H2O,"H2O is refined and crafted into components, modules and other items.",H20.png,abundant,4491,0,0,4491,0
3960,14097,3210,106,Elastomers,"Elastomers are refined and crafted into components, modules and other items.",Elastomers.png,abundant,2408,0,0,2408,0
3974,15351,3216,107,H2O,"H2O is refined and crafted into components, modules and other items.",H20.png,abundant,4503,0,0,4503,0
3974,15352,3216,107,H2O,"H2O is refined and crafted into components, modules and other items.",H20.png,abundant,4303,0,0,4303,0
3974,15353,3216,113,Aerogens,"Aerogens are refined and crafted into components, modules and other items.",Aerogens.png,common,2841,0,0,2841,0
3976,1345,3217,113,Aerogens,"Aerogens are refined and crafted into components, modules and other items.",Aerogens.png,common,4636,0,0,4636,0
3976,16345,3217,117,Yprasium,"Yprasium is refined and crafted into components, modules and other items.",Yprasium.png,uncommon,1455,0,0,1455,0
3976,16346,3217,126,Bruma Particles,"Bruma Particles are refined and crafted into components, modules and other items.",Bruma_Particle.png,rare,677,0,0,677,0
3976,1311,9317,121,Hypoatomic Substances,"Hypoatomic Substances are refined and crafted into components, modules and other items.",Hypoatomic_Substances.png,uncommon,2785,0,0,2785,0
3976,1431,9317,127,Microorganisms,"Microorganisms are refined and crafted into components, modules and other items.",Microorganism.png,rare,622,125,0,497,125
3976,3786,9317,115,Nanofluids,"Nanofluids are refined and crafted into components, modules and other items.",Nanofluids.png,common,4136,0,0,4136,0
3977,2237,3218,54,Hyperspecular Crystals,"Hyperspecular Crystals are refined and crafted into components, modules and other items.",Hyperspecular_Crystals.png,uncommon,1460,0,0,1460,0
3977,2238,3218,42,Base Minerals,"Base Minerals are refined and crafted into components, modules and other items.",Base_Mineral.png,abundant,4523,0,0,4523,0
3978,3809,3219,119,Novis Compounds,"Novis Compounds are refined and crafted into components, modules and other items.",Novis_Compound.png,uncommon,1178,0,0,1178,0
3978,3810,3219,41,Xensium,"Xensium is refined and crafted into components, modules and other items.",Xensium.png,uncommon,1253,0,0,1253,0
3978,3811,3219,41,Xensium,"Xensium is refined and crafted into components, modules and other items.",Xensium.png,uncommon,2435,0,0,2435,0
3978,3812,3219,52,Organic Compounds,"Organic Compounds are refined and crafted into components, modules and other items.",Organic_Compound.png,common,5725,0,0,5725,0
3986,5083,9324,52,Organic Compounds,"Organic Compounds are refined and crafted into components, modules and other items.",Organic_Compound.png,common,1407,0,0,1407,0
3986,5084,9324,106,Elastomers,"Elastomers are refined and crafted into components, modules and other items.",Elastomers.png,abundant,2771,0,0,2771,0
3986,5085,9324,52,Organic Compounds,"Organic Compounds are refined and crafted into components, modules and other items.",Organic_Compound.png,common,2679,0,0,2679,0
3986,5086,9324,106,Elastomers,"Elastomers are refined and crafted into components, modules and other items.",Elastomers.png,abundant,5635,0,0,5635,0
4000,2417,3234,41,Xensium,"Xensium is refined and crafted into components, modules and other items.",Xensium.png,uncommon,1358,0,0,1358,0
4000,3605,3234,107,H2O,"H2O is refined and crafted into components, modules and other items.",H20.png,abundant,2682,0,0,2682,0
4000,13201,3234,106,Elastomers,"Elastomers are refined and crafted into components, modules and other items.",Elastomers.png,abundant,5950,0,0,5950,0
4010,1053,3242,126,Bruma Particles,"Bruma Particles are refined and crafted into components, modules and other items.",Bruma_Particle.png,rare,602,0,0,602,0
4010,1215,3242,107,H2O,"H2O is refined and crafted into components, modules and other items.",H20.png,abundant,2446,0,0,2446,0
4010,1316,3242,107,H2O,"H2O is refined and crafted into components, modules and other items.",H20.png,abundant,5725,573,0,5152,573
4010,2344,9342,113,Aerogens,"Aerogens are refined and crafted into components, modules and other items.",Aerogens.png,common,1278,0,0,1278,0
4010,2561,9342,109,Titanium,"Titanium is refined and crafted into components, modules and other items.",Titanium.png,common,2726,0,0,2726,0
4010,2771,9342,107,H2O,"H2O is refined and crafted into components, modules and other items.",H20.png,abundant,5819,0,0,5819,0
4010,2772,9342,105,Silicates,"Silicates are refined and crafted into components, modules and other items.",Silicates.png,abundant,4046,0,0,4046,0
4011,964,3243,120,Metamagnetic Ore,"Metamagnetic Ore is refined and crafted into components, modules and other items.",Metamagnetic_Ore.png,uncommon,2055,0,0,2055,0
4011,1123,3243,40,Polymetals,"Polymetals are refined and crafted into components, modules and other items.",Polymetals.png,common,1264,0,0,1264,0
4011,1429,3243,40,Polymetals,"Polymetals are refined and crafted into components, modules and other items.",Polymetals.png,common,4094,0,0,4094,0
4011,4187,9343,40,Polymetals,"Polymetals are refined and crafted into components, modules and other items.",Polymetals.png,common,1180,0,0,1180,0
4011,4188,9343,128,Tchaikovium,"Tchaikovium is refined and crafted into components, modules and other items.",Tchaikovium.png,rare,811,0,0,811,0
4011,4189,9343,110,Plutonium,"Plutonium is refined and crafted into components, modules and other items.",Plutonium.png,common,2529,0,0,2529,0
4011,4274,9343,105,Silicates,"Silicates are refined and crafted into components, modules and other items.",Silicates.png,abundant,5391,0,0,5391,0
4018,7660,3247,106,Elastomers,"Elastomers are refined and crafted into components, modules and other items.",Elastomers.png,abundant,5432,0,0,5432,0
4018,7661,3247,112,Amphoteric Substances,"Amphoteric Substances are refined and crafted into components, modules and other items.",Amphoteric_Substances.png,common,4414,0,0,4414,0
4018,14525,3247,53,Ignis Ore,"Ignis Ore is refined and crafted into components, modules and other items.",Ignis_Ore.png,rare,1722,1512,0,210,1512
4018,15876,3247,127,Microorganisms,"Microorganisms are refined and crafted into components, modules and other items.",Microorganism.png,rare,818,0,0,818,0
4019,4366,3248,40,Polymetals,"Polymetals are refined and crafted into components, modules and other items.",Polymetals.png,common,1056,0,0,1056,0
4019,4532,3248,110,Plutonium,"Plutonium is refined and crafted into components, modules and other items.",Plutonium.png,common,5724,0,0,5724,0
4019,12149,3248,120,Metamagnetic Ore,"Metamagnetic Ore is refined and crafted into components, modules and other items.",Metamagnetic_Ore.png,uncommon,2641,0,0,2641,0
4031,18420,9356,115,Nanofluids,"Nanofluids are refined and crafted into components, modules and other items.",Nanofluids.png,common,5101,0,0,5101,0
4043,1370,3263,107,H2O,"H2O is refined and crafted into components, modules and other items.",H20.png,abundant,2634,0,0,2634,0
4043,2853,3263,128,Tchaikovium,"Tchaikovium is refined and crafted into components, modules and other items.",Tchaikovium.png,rare,740,0,0,740,0
4043,2854,3263,115,Nanofluids,"Nanofluids are refined and crafted into components, modules and other items.",Nanofluids.png,common,4479,0,0,4479,0
4044,20431,3264,53,Ignis Ore,"Ignis Ore is refined and crafted into components, modules and other items.",Ignis_Ore.png,rare,723,0,0,723,0
4044,20461,3264,107,H2O,"H2O is refined and crafted into components, modules and other items.",H20.png,abundant,2954,0,0,2954,0
4044,20528,3264,105,Silicates,"Silicates are refined and crafted into components, modules and other items.",Silicates.png,abundant,4684,0,0,4684,0
4044,20529,3264,40,Polymetals,"Polymetals are refined and crafted into components, modules and other items.",Polymetals.png,common,4761,0,0,4761,0
4044,20533,9364,54,Hyperspecular Crystals,"Hyperspecular Crystals are refined and crafted into components, modules and other items.",Hyperspecular_Crystals.png,uncommon,1025,0,0,1025,0
4044,20534,9364,53,Ignis Ore,"Ignis Ore is refined and crafted into components, modules and other items.",Ignis_Ore.png,rare,734,0,0,734,0
4044,20595,9364,114,Ectopolymers,"Ectopolymers are refined and crafted into components, modules and other items.",Ectopolymers.png,common,2984,0,0,2984,0
4044,20651,9364,53,Ignis Ore,"Ignis Ore is refined and crafted into components, modules and other items.",Ignis_Ore.png,rare,3665,0,0,3665,0
4044,20652,9364,107,H2O,"H2O is refined and crafted into components, modules and other items.",H20.png,abundant,4393,0,0,4393,0
4055,17394,3274,53,Ignis Ore,"Ignis Ore is refined and crafted into components, modules and other items.",Ignis_Ore.png,rare,848,0,0,848,0
4055,17395,3274,106,Elastomers,"Elastomers are refined and crafted into components, modules and other items.",Elastomers.png,abundant,2934,0,0,2934,0
4055,17396,3274,42,Base Minerals,"Base Minerals are refined and crafted into components, modules and other items.",Base_Mineral.png,abundant,4256,0,0,4256,0
4056,3239,3275,119,Novis Compounds,"Novis Compounds are refined and crafted into components, modules and other items.",Novis_Compound.png,uncommon,1357,0,0,1357,0
4056,3240,3275,107,H2O,"H2O is refined and crafted into components, modules and other items.",H20.png,abundant,2625,0,0,2625,0
4056,3241,3275,112,Amphoteric Substances,"Amphoteric Substances are refined and crafted into components, modules and other items.",Amphoteric_Substances.png,common,5913,0,0,5913,0
4059,16776,3276,41,Xensium,"Xensium is refined and crafted into components, modules and other items.",Xensium.png,uncommon,1328,0,0,1328,0
4059,16777,3276,41,Xensium,"Xensium is refined and crafted into components, modules and other items.",Xensium.png,uncommon,2050,0,0,2050,0
4059,16778,3276,106,Elastomers,"Elastomers are refined and crafted into components, modules and other items.",Elastomers.png,abundant,5051,0,0,5051,0
4062,1497,3278,41,Xensium,"Xensium is refined and crafted into components, modules and other items.",Xensium.png,uncommon,1419,0,0,1419,0
4062,1508,3278,112,Amphoteric Substances,"Amphoteric Substances are refined and crafted into components, modules and other items.",Amphoteric_Substances.png,common,5857,0,0,5857,0
4062,3127,3278,40,Polymetals,"Polymetals are refined and crafted into components, modules and other items.",Polymetals.png,common,2500,2191,0,309,2191
4062,7757,9378,113,Aerogens,"Aerogens are refined and crafted into components, modules and other items.",Aerogens.png,common,2736,0,0,2736,0
4062,7790,9378,127,Microorganisms,"Microorganisms are refined and crafted into components, modules and other items.",Microorganism.png,rare,887,0,0,887,0
4062,19868,9378,107,H2O,"H2O is refined and crafted into components, modules and other items.",H20.png,abundant,4136,0,0,4136,0
4067,3366,3280,115,Nanofluids,"Nanofluids are refined and crafted into components, modules and other items.",Nanofluids.png,common,1457,0,0,1457,0
4067,4474,3280,113,Aerogens,"Aerogens are refined and crafted into components, modules and other items.",Aerogens.png,common,5083,0,0,5083,0
4067,10924,3280,40,Polymetals,"Polymetals are refined and crafted into components, modules and other items.",Polymetals.png,common,2353,0,0,2353,0
4067,16436,9380,105,Silicates,"Silicates are refined and crafted into components, modules and other items.",Silicates.png,abundant,4741,0,0,4741,0
4079,37,3289,109,Titanium,"Titanium is refined and crafted into components, modules and other items.",Titanium.png,common,1136,0,0,1136,0
4079,153,3289,42,Base Minerals,"Base Minerals are refined and crafted into components, modules and other items.",Base_Mineral.png,abundant,5314,0,0,5314,0
4079,404,3289,113,Aerogens,"Aerogens are refined and crafted into components, modules and other items.",Aerogens.png,common,2887,0,0,2887,0
4079,1483,9389,109,Titanium,"Titanium is refined and crafted into components, modules and other items.",Titanium.png,common,1023,0,0,1023,0
4079,1633,9389,123,Neolysium,"Neolysium is refined and crafted into components, modules and other items.",Neolysium.png,uncommon,2940,0,0,2940,0
4079,1634,9389,107,H2O,"H2O is refined and crafted into components, modules and other items.",H20.png,abundant,4784,0,0,4784,0
4086,3813,3292,109,Titanium,"Titanium is refined and crafted into components, modules and other items.",Titanium.png,common,1055,0,0,1055,0
4086,3814,3292,105,Silicates,"Silicates are refined and crafted into components, modules and other items.",Silicates.png,abundant,2174,0,0,2174,0
4086,3815,3292,107,H2O,"H2O is refined and crafted into components, modules and other items.",H20.png,abundant,5931,0,0,5931,0
4090,388,3294,40,Polymetals,"Polymetals are refined and crafted into components, modules and other items.",Polymetals.png,common,2382,0,0,2382,0
4090,389,3294,115,Nanofluids,"Nanofluids are refined and crafted into components, modules and other items.",Nanofluids.png,common,2946,0,0,2946,0
4097,2268,3300,41,Xensium,"Xensium is refined and crafted into components, modules and other items.",Xensium.png,uncommon,2289,0,0,2289,0
4097,4211,3300,126,Bruma Particles,"Bruma Particles are refined and crafted into components, modules and other items.",Bruma_Particle.png,rare,730,0,0,730,0
4097,4218,3300,105,Silicates,"Silicates are refined and crafted into components, modules and other items.",Silicates.png,abundant,4149,0,0,4149,0
4097,10169,9400,42,Base Minerals,"Base Minerals are refined and crafted into components, modules and other items.",Base_Mineral.png,abundant,2994,0,0,2994,0
4097,10170,9400,54,Hyperspecular Crystals,"Hyperspecular Crystals are refined and crafted into components, modules and other items.",Hyperspecular_Crystals.png,uncommon,5070,0,0,5070,0
4097,15183,9400,54,Hyperspecular Crystals,"Hyperspecular Crystals are refined and crafted into components, modules and other items.",Hyperspecular_Crystals.png,uncommon,1359,0,0,1359,0
4100,1426,3302,40,Polymetals,"Polymetals are refined and crafted into components, modules and other items.",Polymetals.png,common,2252,0,0,2252,0
4102,18352,3304,105,Silicates,"Silicates are refined and crafted into components, modules and other items.",Silicates.png,abundant,2473,0,0,2473,0
4102,18488,3304,117,Yprasium,"Yprasium is refined and crafted into components, modules and other items.",Yprasium.png,uncommon,1354,0,0,1354,0
4102,18491,3304,106,Elastomers,"Elastomers are refined and crafted into components, modules and other items.",Elastomers.png,abundant,4183,0,0,4183,0
4106,2444,3307,113,Aerogens,"Aerogens are refined and crafted into components, modules and other items.",Aerogens.png,common,1042,0,0,1042,0
4106,2445,3307,106,Elastomers,"Elastomers are refined and crafted into components, modules and other items.",Elastomers.png,abundant,2133,0,0,2133,0
4106,3930,3307,107,H2O,"H2O is refined and crafted into components, modules and other items.",H20.png,abundant,5591,0,0,5591,0
4119,16771,3313,118,Platinyx,"Platinyx is refined and crafted into components, modules and other items.",Platinyx.png,uncommon,1047,0,0,1047,0
4119,16772,3313,120,Metamagnetic Ore,"Metamagnetic Ore is refined and crafted into components, modules and other items.",Metamagnetic_Ore.png,uncommon,2628,0,0,2628,0
4119,16773,3313,110,Plutonium,"Plutonium is refined and crafted into components, modules and other items.",Plutonium.png,common,2163,0,0,2163,0
4119,16775,3313,42,Base Minerals,"Base Minerals are refined and crafted into components, modules and other items.",Base_Mineral.png,abundant,5051,0,0,5051,0
4123,2267,3316,41,Xensium,"Xensium is refined and crafted into components, modules and other items.",Xensium.png,uncommon,1005,0,0,1005,0
4126,1124,3319,41,Xensium,"Xensium is refined and crafted into components, modules and other items.",Xensium.png,uncommon,1247,0,0,1247,0
4126,1192,3319,106,Elastomers,"Elastomers are refined and crafted into components, modules and other items.",Elastomers.png,abundant,2761,0,0,2761,0
4126,1430,3319,127,Microorganisms,"Microorganisms are refined and crafted into components, modules and other items.",Microorganism.png,rare,2947,0,0,2947,0
4126,4158,9419,52,Organic Compounds,"Organic Compounds are refined and crafted into components, modules and other items.",Organic_Compound.png,common,1496,0,0,1496,0
4126,4159,9419,115,Nanofluids,"Nanofluids are refined and crafted into components, modules and other items.",Nanofluids.png,common,2215,0,0,2215,0
4126,4160,9419,107,H2O,"H2O is refined and crafted into components, modules and other items.",H20.png,abundant,4169,0,0,4169,0
4139,4602,3326,107,H2O,"H2O is refined and crafted into components, modules and other items.",H20.png,abundant,5000,0,0,5000,0
4139,4608,3326,121,Hypoatomic Substances,"Hypoatomic Substances are refined and crafted into components, modules and other items.",Hypoatomic_Substances.png,uncommon,1344,0,0,1344,0
4139,4609,3326,106,Elastomers,"Elastomers are refined and crafted into components, modules and other items.",Elastomers.png,abundant,2752,0,0,2752,0
4139,4763,9426,127,Microorganisms,"Microorganisms are refined and crafted into components, modules and other items.",Microorganism.png,rare,845,507,0,338,507
4139,7800,9426,42,Base Minerals,"Base Minerals are refined and crafted into components, modules and other items.",Base_Mineral.png,abundant,4716,0,0,4716,0
4139,9813,9426,107,H2O,"H2O is refined and crafted into components, modules and other items.",H20.png,abundant,2779,0,0,2779,0
4142,2991,3328,40,Polymetals,"Polymetals are refined and crafted into components, modules and other items.",Polymetals.png,common,2959,0,0,2959,0
4142,3108,3328,126,Bruma Particles,"Bruma Particles are refined and crafted into components, modules and other items.",Bruma_Particle.png,rare,650,260,0,390,260
4142,3109,3328,110,Plutonium,"Plutonium is refined and crafted into components, modules and other items.",Plutonium.png,common,1019,0,0,1019,0
4142,3111,3328,42,Base Minerals,"Base Minerals are refined and crafted into components, modules and other items.",Base_Mineral.png,abundant,5479,0,0,5479,0
4142,3112,3328,119,Novis Compounds,"Novis Compounds are refined and crafted into components, modules and other items.",Novis_Compound.png,uncommon,5708,0,0,5708,0
4142,4137,9428,110,Plutonium,"Plutonium is refined and crafted into components, modules and other items.",Plutonium.png,common,1403,0,0,1403,0
4142,4261,9428,40,Polymetals,"Polymetals are refined and crafted into components, modules and other items.",Polymetals.png,common,2967,0,0,2967,0
4142,4263,9428,42,Base Minerals,"Base Minerals are refined and crafted into components, modules and other items.",Base_Mineral.png,abundant,4355,0,0,4355,0
4151,36,3334,110,Plutonium,"Plutonium is refined and crafted into components, modules and other items.",Plutonium.png,common,2542,0,0,2542,0
4151,297,3334,105,Silicates,"Silicates are refined and crafted into components, modules and other items.",Silicates.png,abundant,4930,986,0,3944,986
4151,431,3334,52,Organic Compounds,"Organic Compounds are refined and crafted into components, modules and other items.",Organic_Compound.png,common,1097,0,0,1097,0
4151,1986,9434,115,Nanofluids,"Nanofluids are refined and crafted into components, modules and other items.",Nanofluids.png,common,2741,0,0,2741,0
4151,4217,9434,41,Xensium,"Xensium is refined and crafted into components, modules and other items.",Xensium.png,uncommon,1108,0,0,1108,0
4151,4227,9434,115,Nanofluids,"Nanofluids are refined and crafted into components, modules and other items.",Nanofluids.png,common,5535,0,0,5535,0
4152,3506,3335,109,Titanium,"Titanium is refined and crafted into components, modules and other items.",Titanium.png,common,2602,0,0,2602,0
4152,3507,3335,109,Titanium,"Titanium is refined and crafted into components, modules and other items.",Titanium.png,common,5176,0,0,5176,0
4152,4445,3335,53,Ignis Ore,"Ignis Ore is refined and crafted into components, modules and other items.",Ignis_Ore.png,rare,713,0,0,713,0
4152,4446,3335,41,Xensium,"Xensium is refined and crafted into components, modules and other items.",Xensium.png,uncommon,1211,0,0,1211,0
4152,4447,9435,112,Amphoteric Substances,"Amphoteric Substances are refined and crafted into components, modules and other items.",Amphoteric_Substances.png,common,2595,0,0,2595,0
4152,4448,9435,105,Silicates,"Silicates are refined and crafted into components, modules and other items.",Silicates.png,abundant,4811,0,0,4811,0
4152,4449,9435,42,Base Minerals,"Base Minerals are refined and crafted into components, modules and other items.",Base_Mineral.png,abundant,5446,0,0,5446,0
4152,6238,9435,120,Metamagnetic Ore,"Metamagnetic Ore is refined and crafted into components, modules and other items.",Metamagnetic_Ore.png,uncommon,1319,0,0,1319,0
4154,17397,3336,128,Tchaikovium,"Tchaikovium is refined and crafted into components, modules and other items.",Tchaikovium.png,rare,697,0,0,697,0
4154,17398,3336,110,Plutonium,"Plutonium is refined and crafted into components, modules and other items.",Plutonium.png,common,2941,0,0,2941,0
4154,17399,3336,42,Base Minerals,"Base Minerals are refined and crafted into components, modules and other items.",Base_Mineral.png,abundant,5453,0,0,5453,0
4155,1066,3337,115,Nanofluids,"Nanofluids are refined and crafted into components, modules and other items.",Nanofluids.png,common,1138,0,0,1138,0
4155,1613,3337,115,Nanofluids,"Nanofluids are refined and crafted into components, modules and other items.",Nanofluids.png,common,4327,0,0,4327,0
4155,1626,3337,115,Nanofluids,"Nanofluids are refined and crafted into components, modules and other items.",Nanofluids.png,common,2716,0,0,2716,0
4155,1604,9437,40,Polymetals,"Polymetals are refined and crafted into components, modules and other items.",Polymetals.png,common,2863,0,0,2863,0
4155,1605,9437,128,Tchaikovium,"Tchaikovium is refined and crafted into components, modules and other items.",Tchaikovium.png,rare,611,0,0,611,0
4155,2441,9437,127,Microorganisms,"Microorganisms are refined and crafted into components, modules and other items.",Microorganism.png,rare,3836,0,0,3836,0
4164,3606,3342,42,Base Minerals,"Base Minerals are refined and crafted into components, modules and other items.",Base_Mineral.png,abundant,4438,0,0,4438,0
4164,3903,3342,128,Tchaikovium,"Tchaikovium is refined and crafted into components, modules and other items.",Tchaikovium.png,rare,652,0,0,652,0
4165,1882,3343,123,Neolysium,"Neolysium is refined and crafted into components, modules and other items.",Neolysium.png,uncommon,1164,0,0,1164,0
4165,2356,3343,113,Aerogens,"Aerogens are refined and crafted into components, modules and other items.",Aerogens.png,common,2451,0,0,2451,0
4165,2357,3343,107,H2O,"H2O is refined and crafted into components, modules and other items.",H20.png,abundant,4446,0,0,4446,0
4165,4390,9443,123,Neolysium,"Neolysium is refined and crafted into components, modules and other items.",Neolysium.png,uncommon,1150,0,0,1150,0
4165,4391,9443,54,Hyperspecular Crystals,"Hyperspecular Crystals are refined and crafted into components, modules and other items.",Hyperspecular_Crystals.png,uncommon,1153,0,0,1153,0
4165,4393,9443,114,Ectopolymers,"Ectopolymers are refined and crafted into components, modules and other items.",Ectopolymers.png,common,2676,0,0,2676,0
4165,4544,9443,107,H2O,"H2O is refined and crafted into components, modules and other items.",H20.png,abundant,4232,0,0,4232,0
4168,50,3346,107,H2O,"H2O is refined and crafted into components, modules and other items.",H20.png,abundant,5398,0,0,5398,0
4168,12873,3346,112,Amphoteric Substances,"Amphoteric Substances are refined and crafted into components, modules and other items.",Amphoteric_Substances.png,common,2638,0,0,2638,0
4168,14125,3346,41,Xensium,"Xensium is refined and crafted into components, modules and other items.",Xensium.png,uncommon,1497,0,0,1497,0
4170,16402,3348,40,Polymetals,"Polymetals are refined and crafted into components, modules and other items.",Polymetals.png,common,2095,0,0,2095,0
4170,16996,3348,41,Xensium,"Xensium is refined and crafted into components, modules and other items.",Xensium.png,uncommon,1083,0,0,1083,0
4170,18562,3348,110,Plutonium,"Plutonium is refined and crafted into components, modules and other items.",Plutonium.png,common,5009,0,0,5009,0
4172,645,3350,40,Polymetals,"Polymetals are refined and crafted into components, modules and other items.",Polymetals.png,common,1458,0,0,1458,0
4172,926,3350,110,Plutonium,"Plutonium is refined and crafted into components, modules and other items.",Plutonium.png,common,2106,0,0,2106,0
4172,980,3350,110,Plutonium,"Plutonium is refined and crafted into components, modules and other items.",Plutonium.png,common,4212,0,0,4212,0
4172,2571,9450,128,Tchaikovium,"Tchaikovium is refined and crafted into components, modules and other items.",Tchaikovium.png,rare,664,0,0,664,0
4172,3516,9450,105,Silicates,"Silicates are refined and crafted into components, modules and other items.",Silicates.png,abundant,5232,0,0,5232,0
4172,4726,9450,105,Silicates,"Silicates are refined and crafted into components, modules and other items.",Silicates.png,abundant,2263,0,0,2263,0
4179,1189,3356,52,Organic Compounds,"Organic Compounds are refined and crafted into components, modules and other items.",Organic_Compound.png,common,1289,0,0,1289,0
4179,1190,3356,117,Yprasium,"Yprasium is refined and crafted into components, modules and other items.",Yprasium.png,uncommon,1375,0,0,1375,0
4179,1191,3356,113,Aerogens,"Aerogens are refined and crafted into components, modules and other items.",Aerogens.png,common,2126,0,0,2126,0
4179,1513,3356,117,Yprasium,"Yprasium is refined and crafted into components, modules and other items.",Yprasium.png,uncommon,5504,0,0,5504,0
4179,3754,9456,52,Organic Compounds,"Organic Compounds are refined and crafted into components, modules and other items.",Organic_Compound.png,common,1418,0,0,1418,0
4179,3755,9456,52,Organic Compounds,"Organic Compounds are refined and crafted into components, modules and other items.",Organic_Compound.png,common,2395,0,0,2395,0
4179,3756,9456,42,Base Minerals,"Base Minerals are refined and crafted into components, modules and other items.",Base_Mineral.png,abundant,5628,0,0,5628,0
4185,196,3360,123,Neolysium,"Neolysium is refined and crafted into components, modules and other items.",Neolysium.png,uncommon,1179,0,0,1179,0
4185,1514,3360,105,Silicates,"Silicates are refined and crafted into components, modules and other items.",Silicates.png,abundant,2792,0,0,2792,0
4185,1515,3360,112,Amphoteric Substances,"Amphoteric Substances are refined and crafted into components, modules and other items.",Amphoteric_Substances.png,common,4345,0,0,4345,0
4185,965,9460,115,Nanofluids,"Nanofluids are refined and crafted into components, modules and other items.",Nanofluids.png,common,2743,686,0,2057,686
4185,966,9460,112,Amphoteric Substances,"Amphoteric Substances are refined and crafted into components, modules and other items.",Amphoteric_Substances.png,common,2346,0,0,2346,0
4185,2069,9460,109,Titanium,"Titanium is refined and crafted into components, modules and other items.",Titanium.png,common,1314,0,0,1314,0
4185,2070,9460,106,Elastomers,"Elastomers are refined and crafted into components, modules and other items.",Elastomers.png,abundant,5014,0,0,5014,0
4187,3242,3362,121,Hypoatomic Substances,"Hypoatomic Substances are refined and crafted into components, modules and other items.",Hypoatomic_Substances.png,uncommon,1406,0,0,1406,0
4187,3243,3362,113,Aerogens,"Aerogens are refined and crafted into components, modules and other items.",Aerogens.png,common,2011,0,0,2011,0
4187,3244,3362,115,Nanofluids,"Nanofluids are refined and crafted into components, modules and other items.",Nanofluids.png,common,5551,0,0,5551,0
4192,1498,3365,110,Plutonium,"Plutonium is refined and crafted into components, modules and other items.",Plutonium.png,common,1351,0,0,1351,0
4192,1640,3365,109,Titanium,"Titanium is refined and crafted into components, modules and other items.",Titanium.png,common,5414,0,0,5414,0
4192,3146,3365,106,Elastomers,"Elastomers are refined and crafted into components, modules and other items.",Elastomers.png,abundant,2174,0,0,2174,0
4192,7758,9465,105,Silicates,"Silicates are refined and crafted into components, modules and other items.",Silicates.png,abundant,2588,0,0,2588,0
4192,15412,9465,113,Aerogens,"Aerogens are refined and crafted into components, modules and other items.",Aerogens.png,common,1101,0,0,1101,0
4192,19869,9465,105,Silicates,"Silicates are refined and crafted into components, modules and other items.",Silicates.png,abundant,5994,0,0,5994,0
4195,3816,3367,110,Plutonium,"Plutonium is refined and crafted into components, modules and other items.",Plutonium.png,common,1003,0,0,1003,0
4195,3817,3367,41,Xensium,"Xensium is refined and crafted into components, modules and other items.",Xensium.png,uncommon,2864,0,0,2864,0
4195,3818,3367,42,Base Minerals,"Base Minerals are refined and crafted into components, modules and other items.",Base_Mineral.png,abundant,4737,0,0,4737,0
4198,2723,3370,126,Bruma Particles,"Bruma Particles are refined and crafted into components, modules and other items.",Bruma_Particle.png,rare,612,0,0,612,0
4198,3436,3370,119,Novis Compounds,"Novis Compounds are refined and crafted into components, modules and other items.",Novis_Compound.png,uncommon,2647,0,0,2647,0
4198,3525,3370,106,Elastomers,"Elastomers are refined and crafted into components, modules and other items.",Elastomers.png,abundant,5266,0,0,5266,0
4198,3036,9470,41,Xensium,"Xensium is refined and crafted into components, modules and other items.",Xensium.png,uncommon,1124,0,0,1124,0
4198,3437,9470,106,Elastomers,"Elastomers are refined and crafted into components, modules and other items.",Elastomers.png,abundant,5830,0,0,5830,0
4198,3526,9470,107,H2O,"H2O is refined and crafted into components, modules and other items.",H20.png,abundant,2018,0,0,2018,0
4200,2355,3372,40,Polymetals,"Polymetals are refined and crafted into components, modules and other items.",Polymetals.png,common,1157,0,0,1157,0
4200,2411,3372,115,Nanofluids,"Nanofluids are refined and crafted into components, modules and other items.",Nanofluids.png,common,5507,0,0,5507,0
4200,2483,3372,105,Silicates,"Silicates are refined and crafted into components, modules and other items.",Silicates.png,abundant,2651,0,0,2651,0
4200,4507,9472,107,H2O,"H2O is refined and crafted into components, modules and other items.",H20.png,abundant,2929,0,0,2929,0
4200,4570,9472,107,H2O,"H2O is refined and crafted into components, modules and other items.",H20.png,abundant,5504,0,0,5504,0
4200,4663,9472,123,Neolysium,"Neolysium is refined and crafted into components, modules and other items.",Neolysium.png,uncommon,1262,0,0,1262,0
4202,4367,3373,119,Novis Compounds,"Novis Compounds are refined and crafted into components, modules and other items.",Novis_Compound.png,uncommon,1369,0,0,1369,0
4202,4533,3373,42,Base Minerals,"Base Minerals are refined and crafted into components, modules and other items.",Base_Mineral.png,abundant,4059,0,0,4059,0
4202,12212,3373,41,Xensium,"Xensium is refined and crafted into components, modules and other items.",Xensium.png,uncommon,2763,0,0,2763,0
4206,2425,3377,109,Titanium,"Titanium is refined and crafted into components, modules and other items.",Titanium.png,common,1172,0,0,1172,0
4206,2512,3377,54,Hyperspecular Crystals,"Hyperspecular Crystals are refined and crafted into components, modules and other items.",Hyperspecular_Crystals.png,uncommon,2554,640,0,1914,640
4206,2579,3377,105,Silicates,"Silicates are refined and crafted into components, modules and other items.",Silicates.png,abundant,5702,1142,0,4560,1142
4213,2724,3381,120,Metamagnetic Ore,"Metamagnetic Ore is refined and crafted into components, modules and other items.",Metamagnetic_Ore.png,uncommon,1361,0,0,1361,0
4213,3438,3381,40,Polymetals,"Polymetals are refined and crafted into components, modules and other items.",Polymetals.png,common,2656,0,0,2656,0
4213,3935,3381,105,Silicates,"Silicates are refined and crafted into components, modules and other items.",Silicates.png,abundant,5498,0,0,5498,0
4213,3439,9481,128,Tchaikovium,"Tchaikovium is refined and crafted into components, modules and other items.",Tchaikovium.png,rare,892,0,0,892,0
4213,3915,9481,105,Silicates,"Silicates are refined and crafted into components, modules and other items.",Silicates.png,abundant,2453,0,0,2453,0
4213,3936,9481,42,Base Minerals,"Base Minerals are refined and crafted into components, modules and other items.",Base_Mineral.png,abundant,4711,0,0,4711,0
4215,4100,3382,110,Plutonium,"Plutonium is refined and crafted into components, modules and other items.",Plutonium.png,common,1138,0,0,1138,0
4215,4101,3382,118,Platinyx,"Platinyx is refined and crafted into components, modules and other items.",Platinyx.png,uncommon,2819,0,0,2819,0
4215,4102,3382,110,Plutonium,"Plutonium is refined and crafted into components, modules and other items.",Plutonium.png,common,2454,0,0,2454,0
4215,4103,3382,106,Elastomers,"Elastomers are refined and crafted into components, modules and other items.",Elastomers.png,abundant,4961,0,0,4961,0
4226,1371,3391,117,Yprasium,"Yprasium is refined and crafted into components, modules and other items.",Yprasium.png,uncommon,2543,0,0,2543,0
4226,2855,3391,117,Yprasium,"Yprasium is refined and crafted into components, modules and other items.",Yprasium.png,uncommon,1199,0,0,1199,0
4226,2856,3391,106,Elastomers,"Elastomers are refined and crafted into components, modules and other items.",Elastomers.png,abundant,4137,0,0,4137,0
4229,2038,3394,40,Polymetals,"Polymetals are refined and crafted into components, modules and other items.",Polymetals.png,common,1240,0,0,1240,0
4229,2071,3394,107,H2O,"H2O is refined and crafted into components, modules and other items.",H20.png,abundant,4638,0,0,4638,0
4229,2072,3394,107,H2O,"H2O is refined and crafted into components, modules and other items.",H20.png,abundant,5607,0,0,5607,0
4229,2281,3394,119,Novis Compounds,"Novis Compounds are refined and crafted into components, modules and other items.",Novis_Compound.png,uncommon,2576,0,0,2576,0
4229,4062,9494,41,Xensium,"Xensium is refined and crafted into components, modules and other items.",Xensium.png,uncommon,1099,0,0,1099,0
4229,4063,9494,106,Elastomers,"Elastomers are refined and crafted into components, modules and other items.",Elastomers.png,abundant,2668,0,0,2668,0
4229,4064,9494,107,H2O,"H2O is refined and crafted into components, modules and other items.",H20.png,abundant,4113,0,0,4113,0
4250,327,3407,106,Elastomers,"Elastomers are refined and crafted into components, modules and other items.",Elastomers.png,abundant,5504,0,0,5504,0
4250,1929,3407,40,Polymetals,"Polymetals are refined and crafted into components, modules and other items.",Polymetals.png,common,2771,0,0,2771,0
4253,144,3409,105,Silicates,"Silicates are refined and crafted into components, modules and other items.",Silicates.png,abundant,4053,0,0,4053,0
4254,17935,3410,107,H2O,"H2O is refined and crafted into components, modules and other items.",H20.png,abundant,4629,0,0,4629,0
4254,18484,3410,117,Yprasium,"Yprasium is refined and crafted into components, modules and other items.",Yprasium.png,uncommon,1147,0,0,1147,0
4254,18485,3410,117,Yprasium,"Yprasium is refined and crafted into components, modules and other items.",Yprasium.png,uncommon,2388,0,0,2388,0
4254,18486,9510,114,Ectopolymers,"Ectopolymers are refined and crafted into components, modules and other items.",Ectopolymers.png,common,2546,0,0,2546,0
4254,18587,9510,54,Hyperspecular Crystals,"Hyperspecular Crystals are refined and crafted into components, modules and other items.",Hyperspecular_Crystals.png,uncommon,1290,0,0,1290,0
4254,18745,9510,105,Silicates,"Silicates are refined and crafted into components, modules and other items.",Silicates.png,abundant,4460,0,0,4460,0
4257,13642,3412,127,Microorganisms,"Microorganisms are refined and crafted into components, modules and other items.",Microorganism.png,rare,744,0,0,744,0
4257,15152,3412,106,Elastomers,"Elastomers are refined and crafted into components, modules and other items.",Elastomers.png,abundant,5940,0,0,5940,0
4260,3819,3415,109,Titanium,"Titanium is refined and crafted into components, modules and other items.",Titanium.png,common,1315,0,0,1315,0
4260,3820,3415,53,Ignis Ore,"Ignis Ore is refined and crafted into components, modules and other items.",Ignis_Ore.png,rare,1313,0,0,1313,0
4260,3821,3415,107,H2O,"H2O is refined and crafted into components, modules and other items.",H20.png,abundant,5097,0,0,5097,0
4261,2292,3416,110,Plutonium,"Plutonium is refined and crafted into components, modules and other items.",Plutonium.png,common,2458,0,0,2458,0
4261,4286,3416,117,Yprasium,"Yprasium is refined and crafted into components, modules and other items.",Yprasium.png,uncommon,1341,0,0,1341,0
4261,8751,3416,106,Elastomers,"Elastomers are refined and crafted into components, modules and other items.",Elastomers.png,abundant,4793,0,0,4793,0
4261,12641,9516,106,Elastomers,"Elastomers are refined and crafted into components, modules and other items.",Elastomers.png,abundant,2524,0,0,2524,0
4261,15184,9516,121,Hypoatomic Substances,"Hypoatomic Substances are refined and crafted into components, modules and other items.",Hypoatomic_Substances.png,uncommon,1070,0,0,1070,0
4261,15185,9516,105,Silicates,"Silicates are refined and crafted into components, modules and other items.",Silicates.png,abundant,4206,0,0,4206,0
4267,1793,3422,109,Titanium,"Titanium is refined and crafted into components, modules and other items.",Titanium.png,common,1463,0,0,1463,0
4267,1794,3422,107,H2O,"H2O is refined and crafted into components, modules and other items.",H20.png,abundant,2739,0,0,2739,0
4267,1795,3422,105,Silicates,"Silicates are refined and crafted into components, modules and other items.",Silicates.png,abundant,4341,0,0,4341,0
4268,7662,3423,107,H2O,"H2O is refined and crafted into components, modules and other items.",H20.png,abundant,5448,0,0,5448,0
4268,14554,3423,120,Metamagnetic Ore,"Metamagnetic Ore is refined and crafted into components, modules and other items.",Metamagnetic_Ore.png,uncommon,2413,0,0,2413,0
4268,17165,3423,112,Amphoteric Substances,"Amphoteric Substances are refined and crafted into components, modules and other items.",Amphoteric_Substances.png,common,1449,0,0,1449,0
4278,1193,3430,54,Hyperspecular Crystals,"Hyperspecular Crystals are refined and crafted into components, modules and other items.",Hyperspecular_Crystals.png,uncommon,1145,0,0,1145,0
4278,1516,3430,113,Aerogens,"Aerogens are refined and crafted into components, modules and other items.",Aerogens.png,common,2878,0,0,2878,0
4278,1996,3430,107,H2O,"H2O is refined and crafted into components, modules and other items.",H20.png,abundant,5487,0,0,5487,0
4278,1997,9530,121,Hypoatomic Substances,"Hypoatomic Substances are refined and crafted into components, modules and other items.",Hypoatomic_Substances.png,uncommon,1371,0,0,1371,0
4278,3763,9530,126,Bruma Particles,"Bruma Particles are refined and crafted into components, modules and other items.",Bruma_Particle.png,rare,1413,0,0,1413,0
4278,3764,9530,42,Base Minerals,"Base Minerals are refined and crafted into components, modules and other items.",Base_Mineral.png,abundant,4850,0,0,4850,0
4280,2184,3432,113,Aerogens,"Aerogens are refined and crafted into components, modules and other items.",Aerogens.png,common,2360,0,0,2360,0
4280,2990,3432,107,H2O,"H2O is refined and crafted into components, modules and other items.",H20.png,abundant,5580,0,0,5580,0
4280,3653,3432,121,Hypoatomic Substances,"Hypoatomic Substances are refined and crafted into components, modules and other items.",Hypoatomic_Substances.png,uncommon,1485,0,0,1485,0
4280,4138,9532,118,Platinyx,"Platinyx is refined and crafted into components, modules and other items.",Platinyx.png,uncommon,1030,0,0,1030,0
4280,4326,9532,113,Aerogens,"Aerogens are refined and crafted into components, modules and other items.",Aerogens.png,common,2199,0,0,2199,0
4280,4406,9532,115,Nanofluids,"Nanofluids are refined and crafted into components, modules and other items.",Nanofluids.png,common,4109,0,0,4109,0
4281,565,3433,113,Aerogens,"Aerogens are refined and crafted into components, modules and other items.",Aerogens.png,common,2082,0,0,2082,0
4281,672,3433,123,Neolysium,"Neolysium is refined and crafted into components, modules and other items.",Neolysium.png,uncommon,1375,0,0,1375,0
4281,803,3433,106,Elastomers,"Elastomers are refined and crafted into components, modules and other items.",Elastomers.png,abundant,5813,0,0,5813,0
4281,2277,9533,54,Hyperspecular Crystals,"Hyperspecular Crystals are refined and crafted into components, modules and other items.",Hyperspecular_Crystals.png,uncommon,2290,0,0,2290,0
4281,2289,9533,126,Bruma Particles,"Bruma Particles are refined and crafted into components, modules and other items.",Bruma_Particle.png,rare,843,0,0,843,0
4281,2290,9533,115,Nanofluids,"Nanofluids are refined and crafted into components, modules and other items.",Nanofluids.png,common,1194,0,0,1194,0
4281,2317,9533,105,Silicates,"Silicates are refined and crafted into components, modules and other items.",Silicates.png,abundant,4622,0,0,4622,0
4285,1194,3434,119,Novis Compounds,"Novis Compounds are refined and crafted into components, modules and other items.",Novis_Compound.png,uncommon,1489,0,0,1489,0
4285,1517,3434,107,H2O,"H2O is refined and crafted into components, modules and other items.",H20.png,abundant,2278,0,0,2278,0
4285,1998,3434,42,Base Minerals,"Base Minerals are refined and crafted into components, modules and other items.",Base_Mineral.png,abundant,4330,0,0,4330,0
4285,1999,9534,127,Microorganisms,"Microorganisms are refined and crafted into components, modules and other items.",Microorganism.png,rare,763,0,0,763,0
4285,3770,9534,127,Microorganisms,"Microorganisms are refined and crafted into components, modules and other items.",Microorganism.png,rare,1295,0,0,1295,0
4285,3771,9534,112,Amphoteric Substances,"Amphoteric Substances are refined and crafted into components, modules and other items.",Amphoteric_Substances.png,common,4929,0,0,4929,0
4285,3772,9534,107,H2O,"H2O is refined and crafted into components, modules and other items.",H20.png,abundant,5572,0,0,5572,0
4287,3607,3436,106,Elastomers,"Elastomers are refined and crafted into components, modules and other items.",Elastomers.png,abundant,2995,0,0,2995,0
4287,3608,3436,123,Neolysium,"Neolysium is refined and crafted into components, modules and other items.",Neolysium.png,uncommon,2148,0,0,2148,0
4287,3657,3436,107,H2O,"H2O is refined and crafted into components, modules and other items.",H20.png,abundant,4815,0,0,4815,0
4287,3660,3436,52,Organic Compounds,"Organic Compounds are refined and crafted into components, modules and other items.",Organic_Compound.png,common,1423,0,0,1423,0
4287,4265,9536,41,Xensium,"Xensium is refined and crafted into components, modules and other items.",Xensium.png,uncommon,1062,0,0,1062,0
4287,4408,9536,121,Hypoatomic Substances,"Hypoatomic Substances are refined and crafted into components, modules and other items.",Hypoatomic_Substances.png,uncommon,2888,0,0,2888,0
4287,4409,9536,126,Bruma Particles,"Bruma Particles are refined and crafted into components, modules and other items.",Bruma_Particle.png,rare,1520,0,0,1520,0
4287,4535,9536,106,Elastomers,"Elastomers are refined and crafted into components, modules and other items.",Elastomers.png,abundant,5157,0,0,5157,0
4297,8062,3444,127,Microorganisms,"Microorganisms are refined and crafted into components, modules and other items.",Microorganism.png,rare,774,774,0,0,774
4297,8063,3444,126,Bruma Particles,"Bruma Particles are refined and crafted into components, modules and other items.",Bruma_Particle.png,rare,834,501,0,333,501
4297,8076,3444,107,H2O,"H2O is refined and crafted into components, modules and other items.",H20.png,abundant,2962,0,0,2962,0
4297,8077,3444,112,Amphoteric Substances,"Amphoteric Substances are refined and crafted into components, modules and other items.",Amphoteric_Substances.png,common,2441,0,0,2441,0
4297,8221,3444,106,Elastomers,"Elastomers are refined and crafted into components, modules and other items.",Elastomers.png,abundant,5405,0,0,5405,0
4297,8064,9544,41,Xensium,"Xensium is refined and crafted into components, modules and other items.",Xensium.png,uncommon,2868,0,0,2868,0
4297,8200,9544,105,Silicates,"Silicates are refined and crafted into components, modules and other items.",Silicates.png,abundant,5649,0,0,5649,0
4297,8201,9544,42,Base Minerals,"Base Minerals are refined and crafted into components, modules and other items.",Base_Mineral.png,abundant,4411,0,0,4411,0
4297,8224,9544,119,Novis Compounds,"Novis Compounds are refined and crafted into components, modules and other items.",Novis_Compound.png,uncommon,1269,0,0,1269,0
4304,4226,3450,105,Silicates,"Silicates are refined and crafted into components, modules and other items.",Silicates.png,abundant,5928,0,0,5928,0
4304,4247,3450,117,Yprasium,"Yprasium is refined and crafted into components, modules and other items.",Yprasium.png,uncommon,1132,0,0,1132,0
4304,4731,3450,110,Plutonium,"Plutonium is refined and crafted into components, modules and other items.",Plutonium.png,common,2201,0,0,2201,0
4304,4257,9550,118,Platinyx,"Platinyx is refined and crafted into components, modules and other items.",Platinyx.png,uncommon,2854,0,0,2854,0
4304,4394,9550,106,Elastomers,"Elastomers are refined and crafted into components, modules and other items.",Elastomers.png,abundant,5029,0,0,5029,0
4304,4732,9550,127,Microorganisms,"Microorganisms are refined and crafted into components, modules and other items.",Microorganism.png,rare,673,0,0,673,0
4304,4733,9550,110,Plutonium,"Plutonium is refined and crafted into components, modules and other items.",Plutonium.png,common,1252,0,0,1252,0
4308,2358,3453,110,Plutonium,"Plutonium is refined and crafted into components, modules and other items.",Plutonium.png,common,1466,0,0,1466,0
4308,2455,3453,42,Base Minerals,"Base Minerals are refined and crafted into components, modules and other items.",Base_Mineral.png,abundant,5033,0,0,5033,0
4308,2484,3453,105,Silicates,"Silicates are refined and crafted into components, modules and other items.",Silicates.png,abundant,2709,0,0,2709,0
4308,4572,9553,113,Aerogens,"Aerogens are refined and crafted into components, modules and other items.",Aerogens.png,common,4515,0,0,4515,0
4308,4664,9553,128,Tchaikovium,"Tchaikovium is refined and crafted into components, modules and other items.",Tchaikovium.png,rare,828,0,0,828,0
4308,4665,9553,109,Titanium,"Titanium is refined and crafted into components, modules and other items.",Titanium.png,common,2916,0,0,2916,0
4311,3822,3455,41,Xensium,"Xensium is refined and crafted into components, modules and other items.",Xensium.png,uncommon,1317,0,0,1317,0
4311,3823,3455,115,Nanofluids,"Nanofluids are refined and crafted into components, modules and other items.",Nanofluids.png,common,2370,0,0,2370,0
4311,3824,3455,127,Microorganisms,"Microorganisms are refined and crafted into components, modules and other items.",Microorganism.png,rare,3931,0,0,3931,0
4321,2489,3465,121,Hypoatomic Substances,"Hypoatomic Substances are refined and crafted into components, modules and other items.",Hypoatomic_Substances.png,uncommon,1492,0,0,1492,0
4321,2490,3465,121,Hypoatomic Substances,"Hypoatomic Substances are refined and crafted into components, modules and other items.",Hypoatomic_Substances.png,uncommon,2410,0,0,2410,0
4321,2726,3465,106,Elastomers,"Elastomers are refined and crafted into components, modules and other items.",Elastomers.png,abundant,4138,0,0,4138,0
4321,4666,9565,121,Hypoatomic Substances,"Hypoatomic Substances are refined and crafted into components, modules and other items.",Hypoatomic_Substances.png,uncommon,2738,0,0,2738,0
4321,4667,9565,113,Aerogens,"Aerogens are refined and crafted into components, modules and other items.",Aerogens.png,common,5934,0,0,5934,0
4321,4749,9565,113,Aerogens,"Aerogens are refined and crafted into components, modules and other items.",Aerogens.png,common,1166,0,0,1166,0
4323,623,3467,115,Nanofluids,"Nanofluids are refined and crafted into components, modules and other items.",Nanofluids.png,common,1335,0,0,1335,0
4329,4695,3471,105,Silicates,"Silicates are refined and crafted into components, modules and other items.",Silicates.png,abundant,4069,0,0,4069,0
4329,4814,3471,120,Metamagnetic Ore,"Metamagnetic Ore is refined and crafted into components, modules and other items.",Metamagnetic_Ore.png,uncommon,1197,0,0,1197,0
4329,15280,3471,40,Polymetals,"Polymetals are refined and crafted into components, modules and other items.",Polymetals.png,common,2900,0,0,2900,0
4329,4815,9571,120,Metamagnetic Ore,"Metamagnetic Ore is refined and crafted into components, modules and other items.",Metamagnetic_Ore.png,uncommon,1495,0,0,1495,0
4329,4816,9571,105,Silicates,"Silicates are refined and crafted into components, modules and other items.",Silicates.png,abundant,2884,0,0,2884,0
4329,7598,9571,105,Silicates,"Silicates are refined and crafted into components, modules and other items.",Silicates.png,abundant,5718,0,0,5718,0
4332,7599,3473,114,Ectopolymers,"Ectopolymers are refined and crafted into components, modules and other items.",Ectopolymers.png,common,1225,0,0,1225,0
4332,7600,3473,117,Yprasium,"Yprasium is refined and crafted into components, modules and other items.",Yprasium.png,uncommon,1270,0,0,1270,0
4332,7601,3473,105,Silicates,"Silicates are refined and crafted into components, modules and other items.",Silicates.png,abundant,4300,0,0,4300,0
4332,7602,3473,107,H2O,"H2O is refined and crafted into components, modules and other items.",H20.png,abundant,5013,0,0,5013,0
4332,15281,3473,52,Organic Compounds,"Organic Compounds are refined and crafted into components, modules and other items.",Organic_Compound.png,common,2555,0,0,2555,0
4332,7603,9573,110,Plutonium,"Plutonium is refined and crafted into components, modules and other items.",Plutonium.png,common,1424,0,0,1424,0
4332,7604,9573,52,Organic Compounds,"Organic Compounds are refined and crafted into components, modules and other items.",Organic_Compound.png,common,2002,0,0,2002,0
4332,7605,9573,52,Organic Compounds,"Organic Compounds are refined and crafted into components, modules and other items.",Organic_Compound.png,common,5674,0,0,5674,0
4338,2218,3478,126,Bruma Particles,"Bruma Particles are refined and crafted into components, modules and other items.",Bruma_Particle.png,rare,679,0,0,679,0
4338,2219,3478,123,Neolysium,"Neolysium is refined and crafted into components, modules and other items.",Neolysium.png,uncommon,1197,0,0,1197,0
4338,2496,3478,42,Base Minerals,"Base Minerals are refined and crafted into components, modules and other items.",Base_Mineral.png,abundant,2155,0,0,2155,0
4338,2497,3478,40,Polymetals,"Polymetals are refined and crafted into components, modules and other items.",Polymetals.png,common,5843,0,0,5843,0
4342,17400,3481,117,Yprasium,"Yprasium is refined and crafted into components, modules and other items.",Yprasium.png,uncommon,1030,0,0,1030,0
4342,17401,3481,117,Yprasium,"Yprasium is refined and crafted into components, modules and other items.",Yprasium.png,uncommon,2998,0,0,2998,0
4342,17402,3481,115,Nanofluids,"Nanofluids are refined and crafted into components, modules and other items.",Nanofluids.png,common,4652,0,0,4652,0
4353,1254,3487,127,Microorganisms,"Microorganisms are refined and crafted into components, modules and other items.",Microorganism.png,rare,726,0,0,726,0
4353,2000,3487,41,Xensium,"Xensium is refined and crafted into components, modules and other items.",Xensium.png,uncommon,2170,0,0,2170,0
4353,2001,3487,107,H2O,"H2O is refined and crafted into components, modules and other items.",H20.png,abundant,4144,0,0,4144,0
4353,2002,9587,41,Xensium,"Xensium is refined and crafted into components, modules and other items.",Xensium.png,uncommon,1463,0,0,1463,0
4353,4147,9587,112,Amphoteric Substances,"Amphoteric Substances are refined and crafted into components, modules and other items.",Amphoteric_Substances.png,common,2717,0,0,2717,0
4353,4148,9587,40,Polymetals,"Polymetals are refined and crafted into components, modules and other items.",Polymetals.png,common,4876,0,0,4876,0
4373,71,3499,126,Bruma Particles,"Bruma Particles are refined and crafted into components, modules and other items.",Bruma_Particle.png,rare,821,821,0,0,821
4373,439,3499,110,Plutonium,"Plutonium is refined and crafted into components, modules and other items.",Plutonium.png,common,5260,0,0,5260,0
4373,440,3499,107,H2O,"H2O is refined and crafted into components, modules and other items.",H20.png,abundant,4111,0,0,4111,0
4373,473,3499,113,Aerogens,"Aerogens are refined and crafted into components, modules and other items.",Aerogens.png,common,2753,0,0,2753,0
4373,1484,9599,126,Bruma Particles,"Bruma Particles are refined and crafted into components, modules and other items.",Bruma_Particle.png,rare,788,788,0,0,788
4373,3126,9599,123,Neolysium,"Neolysium is refined and crafted into components, modules and other items.",Neolysium.png,uncommon,2173,0,0,2173,0
4373,3297,9599,123,Neolysium,"Neolysium is refined and crafted into components, modules and other items.",Neolysium.png,uncommon,4733,0,0,4733,0
4374,17403,3500,110,Plutonium,"Plutonium is refined and crafted into components, modules and other items.",Plutonium.png,common,1275,0,0,1275,0
4374,17404,3500,40,Polymetals,"Polymetals are refined and crafted into components, modules and other items.",Polymetals.png,common,1499,0,0,1499,0
4374,17405,3500,118,Platinyx,"Platinyx is refined and crafted into components, modules and other items.",Platinyx.png,uncommon,2628,0,0,2628,0
4374,17406,3500,110,Plutonium,"Plutonium is refined and crafted into components, modules and other items.",Plutonium.png,common,5814,0,0,5814,0
4378,8059,3503,53,Ignis Ore,"Ignis Ore is refined and crafted into components, modules and other items.",Ignis_Ore.png,rare,602,602,0,0,602
4378,8078,3503,121,Hypoatomic Substances,"Hypoatomic Substances are refined and crafted into components, modules and other items.",Hypoatomic_Substances.png,uncommon,2115,0,0,2115,0
4378,8222,3503,42,Base Minerals,"Base Minerals are refined and crafted into components, modules and other items.",Base_Mineral.png,abundant,4633,0,0,4633,0
4378,8223,3503,42,Base Minerals,"Base Minerals are refined and crafted into components, modules and other items.",Base_Mineral.png,abundant,5142,0,0,5142,0
4378,8060,9603,54,Hyperspecular Crystals,"Hyperspecular Crystals are refined and crafted into components, modules and other items.",Hyperspecular_Crystals.png,uncommon,2383,0,0,2383,0
4378,8061,9603,113,Aerogens,"Aerogens are refined and crafted into components, modules and other items.",Aerogens.png,common,5247,0,0,5247,0
4378,8225,9603,126,Bruma Particles,"Bruma Particles are refined and crafted into components, modules and other items.",Bruma_Particle.png,rare,806,648,0,158,648
4378,8226,9603,113,Aerogens,"Aerogens are refined and crafted into components, modules and other items.",Aerogens.png,common,1224,0,0,1224,0
4382,3825,3507,127,Microorganisms,"Microorganisms are refined and crafted into components, modules and other items.",Microorganism.png,rare,735,0,0,735,0
4382,3826,3507,107,H2O,"H2O is refined and crafted into components, modules and other items.",H20.png,abundant,2774,0,0,2774,0
4382,3827,3507,106,Elastomers,"Elastomers are refined and crafted into components, modules and other items.",Elastomers.png,abundant,4334,0,0,4334,0
4394,3245,3518,127,Microorganisms,"Microorganisms are refined and crafted into components, modules and other items.",Microorganism.png,rare,891,0,0,891,0
4394,3246,3518,52,Organic Compounds,"Organic Compounds are refined and crafted into components, modules and other items.",Organic_Compound.png,common,2470,0,0,2470,0
4394,3247,3518,107,H2O,"H2O is refined and crafted into components, modules and other items.",H20.png,abundant,5933,0,0,5933,0
4394,3248,3518,121,Hypoatomic Substances,"Hypoatomic Substances are refined and crafted into components, modules and other items.",Hypoatomic_Substances.png,uncommon,4728,0,0,4728,0
4396,3070,3520,114,Ectopolymers,"Ectopolymers are refined and crafted into components, modules and other items.",Ectopolymers.png,common,5082,0,0,5082,0
4397,18425,3521,53,Ignis Ore,"Ignis Ore is refined and crafted into components, modules and other items.",Ignis_Ore.png,rare,692,0,0,692,0
4397,18426,3521,112,Amphoteric Substances,"Amphoteric Substances are refined and crafted into components, modules and other items.",Amphoteric_Substances.png,common,2244,0,0,2244,0
4397,18427,3521,109,Titanium,"Titanium is refined and crafted into components, modules and other items.",Titanium.png,common,5412,0,0,5412,0
4400,2295,3524,53,Ignis Ore,"Ignis Ore is refined and crafted into components, modules and other items.",Ignis_Ore.png,rare,755,0,0,755,0
4400,2830,3524,112,Amphoteric Substances,"Amphoteric Substances are refined and crafted into components, modules and other items.",Amphoteric_Substances.png,common,2078,0,0,2078,0
4400,4357,3524,107,H2O,"H2O is refined and crafted into components, modules and other items.",H20.png,abundant,5825,0,0,5825,0
4402,390,3526,113,Aerogens,"Aerogens are refined and crafted into components, modules and other items.",Aerogens.png,common,2394,0,0,2394,0
4402,3789,3526,126,Bruma Particles,"Bruma Particles are refined and crafted into components, modules and other items.",Bruma_Particle.png,rare,887,0,0,887,0
4402,3790,3526,126,Bruma Particles,"Bruma Particles are refined and crafted into components, modules and other items.",Bruma_Particle.png,rare,785,0,0,785,0
4402,4441,3526,42,Base Minerals,"Base Minerals are refined and crafted into components, modules and other items.",Base_Mineral.png,abundant,5337,0,0,5337,0
4402,3508,9626,113,Aerogens,"Aerogens are refined and crafted into components, modules and other items.",Aerogens.png,common,2362,0,0,2362,0
4402,3509,9626,54,Hyperspecular Crystals,"Hyperspecular Crystals are refined and crafted into components, modules and other items.",Hyperspecular_Crystals.png,uncommon,2390,0,0,2390,0
4402,4442,9626,126,Bruma Particles,"Bruma Particles are refined and crafted into components, modules and other items.",Bruma_Particle.png,rare,838,0,0,838,0
4402,4443,9626,105,Silicates,"Silicates are refined and crafted into components, modules and other items.",Silicates.png,abundant,5250,0,0,5250,0
4402,4444,9626,105,Silicates,"Silicates are refined and crafted into components, modules and other items.",Silicates.png,abundant,5470,0,0,5470,0
4403,1945,3527,41,Xensium,"Xensium is refined and crafted into components, modules and other items.",Xensium.png,uncommon,1249,0,0,1249,0
4403,2318,3527,121,Hypoatomic Substances,"Hypoatomic Substances are refined and crafted into components, modules and other items.",Hypoatomic_Substances.png,uncommon,2054,0,0,2054,0
4403,4358,3527,41,Xensium,"Xensium is refined and crafted into components, modules and other items.",Xensium.png,uncommon,5473,0,0,5473,0
4410,1674,3534,54,Hyperspecular Crystals,"Hyperspecular Crystals are refined and crafted into components, modules and other items.",Hyperspecular_Crystals.png,uncommon,1103,0,0,1103,0
4410,1675,3534,54,Hyperspecular Crystals,"Hyperspecular Crystals are refined and crafted into components, modules and other items.",Hyperspecular_Crystals.png,uncommon,2860,0,0,2860,0
4410,1676,3534,107,H2O,"H2O is refined and crafted into components, modules and other items.",H20.png,abundant,5722,0,0,5722,0
4410,1677,9634,113,Aerogens,"Aerogens are refined and crafted into components, modules and other items.",Aerogens.png,common,2158,0,0,2158,0
4410,1807,9634,123,Neolysium,"Neolysium is refined and crafted into components, modules and other items.",Neolysium.png,uncommon,1072,0,0,1072,0
4410,1808,9634,107,H2O,"H2O is refined and crafted into components, modules and other items.",H20.png,abundant,5811,0,0,5811,0
4411,3249,3535,54,Hyperspecular Crystals,"Hyperspecular Crystals are refined and crafted into components, modules and other items.",Hyperspecular_Crystals.png,uncommon,1293,0,0,1293,0
4411,3250,3535,107,H2O,"H2O is refined and crafted into components, modules and other items.",H20.png,abundant,2805,0,0,2805,0
4411,3251,3535,107,H2O,"H2O is refined and crafted into components, modules and other items.",H20.png,abundant,5351,0,0,5351,0
4422,828,3546,126,Bruma Particles,"Bruma Particles are refined and crafted into components, modules and other items.",Bruma_Particle.png,rare,743,0,0,743,0
4422,829,3546,114,Ectopolymers,"Ectopolymers are refined and crafted into components, modules and other items.",Ectopolymers.png,common,2228,0,0,2228,0
4423,12749,3547,127,Microorganisms,"Microorganisms are refined and crafted into components, modules and other items.",Microorganism.png,rare,691,0,0,691,0
4423,13636,3547,105,Silicates,"Silicates are refined and crafted into components, modules and other items.",Silicates.png,abundant,4153,0,0,4153,0
4423,15148,3547,42,Base Minerals,"Base Minerals are refined and crafted into components, modules and other items.",Base_Mineral.png,abundant,2671,0,0,2671,0
4435,1944,3559,117,Yprasium,"Yprasium is refined and crafted into components, modules and other items.",Yprasium.png,uncommon,1156,0,0,1156,0
4435,2294,3559,117,Yprasium,"Yprasium is refined and crafted into components, modules and other items.",Yprasium.png,uncommon,2195,0,0,2195,0
4435,4359,3559,52,Organic Compounds,"Organic Compounds are refined and crafted into components, modules and other items.",Organic_Compound.png,common,4890,0,0,4890,0
4437,718,3561,115,Nanofluids,"Nanofluids are refined and crafted into components, modules and other items.",Nanofluids.png,common,2889,0,0,2889,0
4437,719,3561,121,Hypoatomic Substances,"Hypoatomic Substances are refined and crafted into components, modules and other items.",Hypoatomic_Substances.png,uncommon,2855,0,0,2855,0
4437,720,3561,107,H2O,"H2O is refined and crafted into components, modules and other items.",H20.png,abundant,4683,0,0,4683,0
4446,1565,3570,54,Hyperspecular Crystals,"Hyperspecular Crystals are refined and crafted into components, modules and other items.",Hyperspecular_Crystals.png,uncommon,1228,0,0,1228,0
4446,1566,3570,109,Titanium,"Titanium is refined and crafted into components, modules and other items.",Titanium.png,common,2475,0,0,2475,0
4448,3828,3572,127,Microorganisms,"Microorganisms are refined and crafted into components, modules and other items.",Microorganism.png,rare,870,0,0,870,0
4448,3829,3572,105,Silicates,"Silicates are refined and crafted into components, modules and other items.",Silicates.png,abundant,2523,0,0,2523,0
4448,3830,3572,107,H2O,"H2O is refined and crafted into components, modules and other items.",H20.png,abundant,5652,0,0,5652,0
4451,197,3575,128,Tchaikovium,"Tchaikovium is refined and crafted into components, modules and other items.",Tchaikovium.png,rare,827,0,0,827,0
4451,2003,3575,117,Yprasium,"Yprasium is refined and crafted into components, modules and other items.",Yprasium.png,uncommon,2992,0,0,2992,0
4451,2004,3575,106,Elastomers,"Elastomers are refined and crafted into components, modules and other items.",Elastomers.png,abundant,4208,0,0,4208,0
4451,994,9675,117,Yprasium,"Yprasium is refined and crafted into components, modules and other items.",Yprasium.png,uncommon,2616,0,0,2616,0
4451,2005,9675,115,Nanofluids,"Nanofluids are refined and crafted into components, modules and other items.",Nanofluids.png,common,1196,0,0,1196,0
4451,4175,9675,105,Silicates,"Silicates are refined and crafted into components, modules and other items.",Silicates.png,abundant,4492,0,0,4492,0
4465,7294,3589,52,Organic Compounds,"Organic Compounds are refined and crafted into components, modules and other items.",Organic_Compound.png,common,1463,0,0,1463,0
4465,13637,3589,52,Organic Compounds,"Organic Compounds are refined and crafted into components, modules and other items.",Organic_Compound.png,common,4166,0,0,4166,0
4465,17728,3589,115,Nanofluids,"Nanofluids are refined and crafted into components, modules and other items.",Nanofluids.png,common,2362,0,0,2362,0
4465,17729,3589,107,H2O,"H2O is refined and crafted into components, modules and other items.",H20.png,abundant,2344,0,0,2344,0
4468,2706,3592,114,Ectopolymers,"Ectopolymers are refined and crafted into components, modules and other items.",Ectopolymers.png,common,2559,0,0,2559,0
4468,2707,3592,109,Titanium,"Titanium is refined and crafted into components, modules and other items.",Titanium.png,common,2482,311,0,2171,311
4469,448,3593,123,Neolysium,"Neolysium is refined and crafted into components, modules and other items.",Neolysium.png,uncommon,1115,1115,0,0,1115
4469,1024,3593,112,Amphoteric Substances,"Amphoteric Substances are refined and crafted into components, modules and other items.",Amphoteric_Substances.png,common,2930,734,0,2196,734
4469,1025,3593,107,H2O,"H2O is refined and crafted into components, modules and other items.",H20.png,abundant,4889,3423,0,1466,3423
4469,2148,9693,106,Elastomers,"Elastomers are refined and crafted into components, modules and other items.",Elastomers.png,abundant,4158,416,0,3742,416
4469,2149,9693,53,Ignis Ore,"Ignis Ore is refined and crafted into components, modules and other items.",Ignis_Ore.png,rare,3954,2772,0,1182,2772
4469,2403,9693,53,Ignis Ore,"Ignis Ore is refined and crafted into components, modules and other items.",Ignis_Ore.png,rare,696,140,0,556,140
4469,2404,9693,42,Base Minerals,"Base Minerals are refined and crafted into components, modules and other items.",Base_Mineral.png,abundant,2368,296,0,2072,296
4469,2405,9693,112,Amphoteric Substances,"Amphoteric Substances are refined and crafted into components, modules and other items.",Amphoteric_Substances.png,common,2293,287,0,2006,287
4472,3467,3596,106,Elastomers,"Elastomers are refined and crafted into components, modules and other items.",Elastomers.png,abundant,4208,0,0,4208,0
4472,4220,3596,112,Amphoteric Substances,"Amphoteric Substances are refined and crafted into components, modules and other items.",Amphoteric_Substances.png,common,2749,0,0,2749,0
4472,4422,3596,128,Tchaikovium,"Tchaikovium is refined and crafted into components, modules and other items.",Tchaikovium.png,rare,686,138,0,548,138
4472,8054,9696,112,Amphoteric Substances,"Amphoteric Substances are refined and crafted into components, modules and other items.",Amphoteric_Substances.png,common,2218,0,0,2218,0
4473,4368,3597,112,Amphoteric Substances,"Amphoteric Substances are refined and crafted into components, modules and other items.",Amphoteric_Substances.png,common,1462,0,0,1462,0
4473,4369,3597,121,Hypoatomic Substances,"Hypoatomic Substances are refined and crafted into components, modules and other items.",Hypoatomic_Substances.png,uncommon,1270,0,0,1270,0
4473,4567,3597,40,Polymetals,"Polymetals are refined and crafted into components, modules and other items.",Polymetals.png,common,5648,0,0,5648,0
4477,2185,3601,53,Ignis Ore,"Ignis Ore is refined and crafted into components, modules and other items.",Ignis_Ore.png,rare,1759,1540,0,219,1540
4477,2186,3601,109,Titanium,"Titanium is refined and crafted into components, modules and other items.",Titanium.png,common,2491,0,0,2491,0
4477,2449,3601,105,Silicates,"Silicates are refined and crafted into components, modules and other items.",Silicates.png,abundant,4260,0,0,4260,0
4477,3337,3601,112,Amphoteric Substances,"Amphoteric Substances are refined and crafted into components, modules and other items.",Amphoteric_Substances.png,common,1390,0,0,1390,0
4477,2450,9701,109,Titanium,"Titanium is refined and crafted into components, modules and other items.",Titanium.png,common,2595,0,0,2595,0
4477,2451,9701,109,Titanium,"Titanium is refined and crafted into components, modules and other items.",Titanium.png,common,2120,0,0,2120,0
4477,4426,9701,123,Neolysium,"Neolysium is refined and crafted into components, modules and other items.",Neolysium.png,uncommon,1089,0,0,1089,0
4477,4536,9701,105,Silicates,"Silicates are refined and crafted into components, modules and other items.",Silicates.png,abundant,5152,0,0,5152,0
4480,20536,3604,110,Plutonium,"Plutonium is refined and crafted into components, modules and other items.",Plutonium.png,common,5992,0,0,5992,0
4486,4104,3610,126,Bruma Particles,"Bruma Particles are refined and crafted into components, modules and other items.",Bruma_Particle.png,rare,744,0,0,744,0
4486,4105,3610,54,Hyperspecular Crystals,"Hyperspecular Crystals are refined and crafted into components, modules and other items.",Hyperspecular_Crystals.png,uncommon,2087,0,0,2087,0
4486,4106,3610,126,Bruma Particles,"Bruma Particles are refined and crafted into components, modules and other items.",Bruma_Particle.png,rare,1293,0,0,1293,0
4486,4107,3610,113,Aerogens,"Aerogens are refined and crafted into components, modules and other items.",Aerogens.png,common,4386,0,0,4386,0
4490,16476,3614,114,Ectopolymers,"Ectopolymers are refined and crafted into components, modules and other items.",Ectopolymers.png,common,2078,0,0,2078,0
4490,17062,3614,54,Hyperspecular Crystals,"Hyperspecular Crystals are refined and crafted into components, modules and other items.",Hyperspecular_Crystals.png,uncommon,1333,0,0,1333,0
4490,18580,3614,106,Elastomers,"Elastomers are refined and crafted into components, modules and other items.",Elastomers.png,abundant,5773,0,0,5773,0
4491,3831,3615,53,Ignis Ore,"Ignis Ore is refined and crafted into components, modules and other items.",Ignis_Ore.png,rare,737,0,0,737,0
4491,3832,3615,114,Ectopolymers,"Ectopolymers are refined and crafted into components, modules and other items.",Ectopolymers.png,common,2713,0,0,2713,0
4491,3833,3615,107,H2O,"H2O is refined and crafted into components, modules and other items.",H20.png,abundant,5458,0,0,5458,0
4503,534,3627,109,Titanium,"Titanium is refined and crafted into components, modules and other items.",Titanium.png,common,2989,0,0,2989,0
4503,951,3627,106,Elastomers,"Elastomers are refined and crafted into components, modules and other items.",Elastomers.png,abundant,4164,0,0,4164,0
4503,952,3627,123,Neolysium,"Neolysium is refined and crafted into components, modules and other items.",Neolysium.png,uncommon,1098,0,0,1098,0
4507,3252,3631,126,Bruma Particles,"Bruma Particles are refined and crafted into components, modules and other items.",Bruma_Particle.png,rare,900,0,0,900,0
4507,3253,3631,115,Nanofluids,"Nanofluids are refined and crafted into components, modules and other items.",Nanofluids.png,common,2958,0,0,2958,0
4507,3254,3631,105,Silicates,"Silicates are refined and crafted into components, modules and other items.",Silicates.png,abundant,4563,0,0,4563,0
4523,1598,3647,110,Plutonium,"Plutonium is refined and crafted into components, modules and other items.",Plutonium.png,common,1306,0,0,1306,0
4523,1609,3647,106,Elastomers,"Elastomers are refined and crafted into components, modules and other items.",Elastomers.png,abundant,2255,0,0,2255,0
4523,1729,3647,115,Nanofluids,"Nanofluids are refined and crafted into components, modules and other items.",Nanofluids.png,common,4457,0,0,4457,0
4523,7492,9747,113,Aerogens,"Aerogens are refined and crafted into components, modules and other items.",Aerogens.png,common,2148,0,0,2148,0
4523,7495,9747,113,Aerogens,"Aerogens are refined and crafted into components, modules and other items.",Aerogens.png,common,1178,0,0,1178,0
4523,7514,9747,105,Silicates,"Silicates are refined and crafted into components, modules and other items.",Silicates.png,abundant,4177,0,0,4177,0
4526,4108,3650,126,Bruma Particles,"Bruma Particles are refined and crafted into components, modules and other items.",Bruma_Particle.png,rare,822,0,0,822,0
4526,4109,3650,107,H2O,"H2O is refined and crafted into components, modules and other items.",H20.png,abundant,2005,0,0,2005,0
4526,4110,3650,107,H2O,"H2O is refined and crafted into components, modules and other items.",H20.png,abundant,5147,0,0,5147,0
4527,3440,3651,128,Tchaikovium,"Tchaikovium is refined and crafted into components, modules and other items.",Tchaikovium.png,rare,1576,0,0,1576,0
4527,4349,3651,54,Hyperspecular Crystals,"Hyperspecular Crystals are refined and crafted into components, modules and other items.",Hyperspecular_Crystals.png,uncommon,1227,0,0,1227,0
4527,4863,3651,106,Elastomers,"Elastomers are refined and crafted into components, modules and other items.",Elastomers.png,abundant,5511,0,0,5511,0
4527,3937,9751,128,Tchaikovium,"Tchaikovium is refined and crafted into components, modules and other items.",Tchaikovium.png,rare,659,0,0,659,0
4527,3938,9751,128,Tchaikovium,"Tchaikovium is refined and crafted into components, modules and other items.",Tchaikovium.png,rare,716,0,0,716,0
4527,4350,9751,110,Plutonium,"Plutonium is refined and crafted into components, modules and other items.",Plutonium.png,common,2933,0,0,2933,0
4527,4864,9751,42,Base Minerals,"Base Minerals are refined and crafted into components, modules and other items.",Base_Mineral.png,abundant,4208,0,0,4208,0
4528,4351,3652,119,Novis Compounds,"Novis Compounds are refined and crafted into components, modules and other items.",Novis_Compound.png,uncommon,1172,0,0,1172,0
4528,4353,3652,106,Elastomers,"Elastomers are refined and crafted into components, modules and other items.",Elastomers.png,abundant,2587,0,0,2587,0
4528,6832,3652,107,H2O,"H2O is refined and crafted into components, modules and other items.",H20.png,abundant,4674,0,0,4674,0
4528,4352,9752,52,Organic Compounds,"Organic Compounds are refined and crafted into components, modules and other items.",Organic_Compound.png,common,1072,0,0,1072,0
4528,4865,9752,106,Elastomers,"Elastomers are refined and crafted into components, modules and other items.",Elastomers.png,abundant,2554,0,0,2554,0
4528,6833,9752,107,H2O,"H2O is refined and crafted into components, modules and other items.",H20.png,abundant,4940,0,0,4940,0
4532,647,3656,128,Tchaikovium,"Tchaikovium is refined and crafted into components, modules and other items.",Tchaikovium.png,rare,842,0,0,842,0
4532,1037,3656,113,Aerogens,"Aerogens are refined and crafted into components, modules and other items.",Aerogens.png,common,2553,0,0,2553,0
4532,1078,3656,42,Base Minerals,"Base Minerals are refined and crafted into components, modules and other items.",Base_Mineral.png,abundant,5631,0,0,5631,0
4532,2631,9756,127,Microorganisms,"Microorganisms are refined and crafted into components, modules and other items.",Microorganism.png,rare,890,0,0,890,0
4532,4744,9756,107,H2O,"H2O is refined and crafted into components, modules and other items.",H20.png,abundant,4391,0,0,4391,0
4532,4755,9756,54,Hyperspecular Crystals,"Hyperspecular Crystals are refined and crafted into components, modules and other items.",Hyperspecular_Crystals.png,uncommon,2458,0,0,2458,0
4534,669,3658,128,Tchaikovium,"Tchaikovium is refined and crafted into components, modules and other items.",Tchaikovium.png,rare,698,0,0,698,0
4534,1038,3658,42,Base Minerals,"Base Minerals are refined and crafted into components, modules and other items.",Base_Mineral.png,abundant,2303,0,0,2303,0
4534,1079,3658,42,Base Minerals,"Base Minerals are refined and crafted into components, modules and other items.",Base_Mineral.png,abundant,4916,0,0,4916,0
4534,2937,9758,53,Ignis Ore,"Ignis Ore is refined and crafted into components, modules and other items.",Ignis_Ore.png,rare,658,0,0,658,0
4534,4882,9758,114,Ectopolymers,"Ectopolymers are refined and crafted into components, modules and other items.",Ectopolymers.png,common,2693,0,0,2693,0
4534,4918,9758,106,Elastomers,"Elastomers are refined and crafted into components, modules and other items.",Elastomers.png,abundant,4097,0,0,4097,0
4539,3331,3663,128,Tchaikovium,"Tchaikovium is refined and crafted into components, modules and other items.",Tchaikovium.png,rare,837,0,0,837,0
4539,3332,3663,40,Polymetals,"Polymetals are refined and crafted into components, modules and other items.",Polymetals.png,common,2951,0,0,2951,0
4539,3333,3663,110,Plutonium,"Plutonium is refined and crafted into components, modules and other items.",Plutonium.png,common,5112,0,0,5112,0
4539,3743,9763,121,Hypoatomic Substances,"Hypoatomic Substances are refined and crafted into components, modules and other items.",Hypoatomic_Substances.png,uncommon,1358,0,0,1358,0
4539,5152,9763,42,Base Minerals,"Base Minerals are refined and crafted into components, modules and other items.",Base_Mineral.png,abundant,4371,0,0,4371,0
4539,5414,9763,110,Plutonium,"Plutonium is refined and crafted into components, modules and other items.",Plutonium.png,common,2328,0,0,2328,0
4540,3013,3664,110,Plutonium,"Plutonium is refined and crafted into components, modules and other items.",Plutonium.png,common,1378,0,0,1378,0
4540,3360,3664,41,Xensium,"Xensium is refined and crafted into components, modules and other items.",Xensium.png,uncommon,2916,730,0,2186,730
4540,6503,3664,105,Silicates,"Silicates are refined and crafted into components, modules and other items.",Silicates.png,abundant,5423,0,0,5423,0
4542,878,3666,117,Yprasium,"Yprasium is refined and crafted into components, modules and other items.",Yprasium.png,uncommon,2559,0,0,2559,0
4542,2020,3666,53,Ignis Ore,"Ignis Ore is refined and crafted into components, modules and other items.",Ignis_Ore.png,rare,796,0,0,796,0
4542,11254,3666,105,Silicates,"Silicates are refined and crafted into components, modules and other items.",Silicates.png,abundant,5081,0,0,5081,0
4545,3255,3669,118,Platinyx,"Platinyx is refined and crafted into components, modules and other items.",Platinyx.png,uncommon,1172,0,0,1172,0
4545,3256,3669,119,Novis Compounds,"Novis Compounds are refined and crafted into components, modules and other items.",Novis_Compound.png,uncommon,2610,0,0,2610,0
4545,3257,3669,106,Elastomers,"Elastomers are refined and crafted into components, modules and other items.",Elastomers.png,abundant,5207,0,0,5207,0
4552,1255,3676,115,Nanofluids,"Nanofluids are refined and crafted into components, modules and other items.",Nanofluids.png,common,1397,0,0,1397,0
4552,2006,3676,110,Plutonium,"Plutonium is refined and crafted into components, modules and other items.",Plutonium.png,common,2723,0,0,2723,0
4552,2007,3676,106,Elastomers,"Elastomers are refined and crafted into components, modules and other items.",Elastomers.png,abundant,5390,0,0,5390,0
4552,2008,9776,114,Ectopolymers,"Ectopolymers are refined and crafted into components, modules and other items.",Ectopolymers.png,common,1342,0,0,1342,0
4552,4179,9776,40,Polymetals,"Polymetals are refined and crafted into components, modules and other items.",Polymetals.png,common,2965,0,0,2965,0
4552,4180,9776,120,Metamagnetic Ore,"Metamagnetic Ore is refined and crafted into components, modules and other items.",Metamagnetic_Ore.png,uncommon,2600,0,0,2600,0
4552,4181,9776,40,Polymetals,"Polymetals are refined and crafted into components, modules and other items.",Polymetals.png,common,4644,0,0,4644,0
4558,1256,3682,126,Bruma Particles,"Bruma Particles are refined and crafted into components, modules and other items.",Bruma_Particle.png,rare,702,0,0,702,0
4558,2009,3682,120,Metamagnetic Ore,"Metamagnetic Ore is refined and crafted into components, modules and other items.",Metamagnetic_Ore.png,uncommon,2269,0,0,2269,0
4558,2015,3682,114,Ectopolymers,"Ectopolymers are refined and crafted into components, modules and other items.",Ectopolymers.png,common,4444,0,0,4444,0
4558,2016,9782,119,Novis Compounds,"Novis Compounds are refined and crafted into components, modules and other items.",Novis_Compound.png,uncommon,1332,0,0,1332,0
4558,4177,9782,40,Polymetals,"Polymetals are refined and crafted into components, modules and other items.",Polymetals.png,common,2418,0,0,2418,0
4558,4178,9782,40,Polymetals,"Polymetals are refined and crafted into components, modules and other items.",Polymetals.png,common,4141,0,0,4141,0
4564,1229,3688,54,Hyperspecular Crystals,"Hyperspecular Crystals are refined and crafted into components, modules and other items.",Hyperspecular_Crystals.png,uncommon,1124,0,0,1124,0
4564,1230,3688,127,Microorganisms,"Microorganisms are refined and crafted into components, modules and other items.",Microorganism.png,rare,657,0,0,657,0
4564,1231,3688,109,Titanium,"Titanium is refined and crafted into components, modules and other items.",Titanium.png,common,2670,0,0,2670,0
4564,1232,3688,106,Elastomers,"Elastomers are refined and crafted into components, modules and other items.",Elastomers.png,abundant,4765,0,0,4765,0
4564,18065,9788,114,Ectopolymers,"Ectopolymers are refined and crafted into components, modules and other items.",Ectopolymers.png,common,1308,0,0,1308,0
4564,18066,9788,121,Hypoatomic Substances,"Hypoatomic Substances are refined and crafted into components, modules and other items.",Hypoatomic_Substances.png,uncommon,2320,0,0,2320,0
4564,18067,9788,42,Base Minerals,"Base Minerals are refined and crafted into components, modules and other items.",Base_Mineral.png,abundant,4192,0,0,4192,0
4565,522,3689,109,Titanium,"Titanium is refined and crafted into components, modules and other items.",Titanium.png,common,5061,0,0,5061,0
4565,937,3689,110,Plutonium,"Plutonium is refined and crafted into components, modules and other items.",Plutonium.png,common,2850,0,0,2850,0
4565,2365,3689,110,Plutonium,"Plutonium is refined and crafted into components, modules and other items.",Plutonium.png,common,1163,0,0,1163,0
4568,19669,3692,106,Elastomers,"Elastomers are refined and crafted into components, modules and other items.",Elastomers.png,abundant,5860,0,0,5860,0
4574,250,3698,107,H2O,"H2O is refined and crafted into components, modules and other items.",H20.png,abundant,2820,0,0,2820,0
4574,331,3698,52,Organic Compounds,"Organic Compounds are refined and crafted into components, modules and other items.",Organic_Compound.png,common,4018,0,0,4018,0
4574,912,3698,118,Platinyx,"Platinyx is refined and crafted into components, modules and other items.",Platinyx.png,uncommon,1011,0,0,1011,0
4574,3358,9798,42,Base Minerals,"Base Minerals are refined and crafted into components, modules and other items.",Base_Mineral.png,abundant,2374,0,0,2374,0
4574,3359,9798,107,H2O,"H2O is refined and crafted into components, modules and other items.",H20.png,abundant,2499,0,0,2499,0
4574,3704,9798,40,Polymetals,"Polymetals are refined and crafted into components, modules and other items.",Polymetals.png,common,1500,0,0,1500,0
4574,3705,9798,120,Metamagnetic Ore,"Metamagnetic Ore is refined and crafted into components, modules and other items.",Metamagnetic_Ore.png,uncommon,5372,0,0,5372,0
4575,1002,3699,42,Base Minerals,"Base Minerals are refined and crafted into components, modules and other items.",Base_Mineral.png,abundant,4544,0,0,4544,0
4575,2057,3699,54,Hyperspecular Crystals,"Hyperspecular Crystals are refined and crafted into components, modules and other items.",Hyperspecular_Crystals.png,uncommon,2563,0,0,2563,0
4575,4465,3699,109,Titanium,"Titanium is refined and crafted into components, modules and other items.",Titanium.png,common,1071,0,0,1071,0
4575,4466,9799,126,Bruma Particles,"Bruma Particles are refined and crafted into components, modules and other items.",Bruma_Particle.png,rare,796,0,0,796,0
4575,7822,9799,42,Base Minerals,"Base Minerals are refined and crafted into components, modules and other items.",Base_Mineral.png,abundant,4469,0,0,4469,0
4575,10663,9799,109,Titanium,"Titanium is refined and crafted into components, modules and other items.",Titanium.png,common,2244,0,0,2244,0
4582,3016,3706,120,Metamagnetic Ore,"Metamagnetic Ore is refined and crafted into components, modules and other items.",Metamagnetic_Ore.png,uncommon,1021,0,0,1021,0
4582,4568,3706,107,H2O,"H2O is refined and crafted into components, modules and other items.",H20.png,abundant,5451,0,0,5451,0
4582,12213,3706,105,Silicates,"Silicates are refined and crafted into components, modules and other items.",Silicates.png,abundant,2771,0,0,2771,0
4584,3014,3708,126,Bruma Particles,"Bruma Particles are refined and crafted into components, modules and other items.",Bruma_Particle.png,rare,828,166,0,662,166
4584,3361,3708,113,Aerogens,"Aerogens are refined and crafted into components, modules and other items.",Aerogens.png,common,2768,0,0,2768,0
4584,6504,3708,106,Elastomers,"Elastomers are refined and crafted into components, modules and other items.",Elastomers.png,abundant,4139,0,0,4139,0
4585,1372,3709,115,Nanofluids,"Nanofluids are refined and crafted into components, modules and other items.",Nanofluids.png,common,2522,0,0,2522,0
4585,2857,3709,127,Microorganisms,"Microorganisms are refined and crafted into components, modules and other items.",Microorganism.png,rare,847,0,0,847,0
4585,2858,3709,106,Elastomers,"Elastomers are refined and crafted into components, modules and other items.",Elastomers.png,abundant,4251,0,0,4251,0
4586,18285,3710,53,Ignis Ore,"Ignis Ore is refined and crafted into components, modules and other items.",Ignis_Ore.png,rare,682,0,0,682,0
4589,341,3713,109,Titanium,"Titanium is refined and crafted into components, modules and other items.",Titanium.png,common,1073,0,0,1073,0
4589,2076,3713,42,Base Minerals,"Base Minerals are refined and crafted into components, modules and other items.",Base_Mineral.png,abundant,2614,0,0,2614,0
4589,2077,3713,107,H2O,"H2O is refined and crafted into components, modules and other items.",H20.png,abundant,5222,0,0,5222,0
4589,1034,9813,113,Aerogens,"Aerogens are refined and crafted into components, modules and other items.",Aerogens.png,common,2729,0,0,2729,0
4589,2078,9813,123,Neolysium,"Neolysium is refined and crafted into components, modules and other items.",Neolysium.png,uncommon,1269,0,0,1269,0
4589,3793,9813,105,Silicates,"Silicates are refined and crafted into components, modules and other items.",Silicates.png,abundant,5403,0,0,5403,0
4593,1233,3717,54,Hyperspecular Crystals,"Hyperspecular Crystals are refined and crafted into components, modules and other items.",Hyperspecular_Crystals.png,uncommon,1095,0,0,1095,0
4593,1239,3717,107,H2O,"H2O is refined and crafted into components, modules and other items.",H20.png,abundant,2212,0,0,2212,0
4593,1620,3717,107,H2O,"H2O is refined and crafted into components, modules and other items.",H20.png,abundant,5624,0,0,5624,0
4593,18068,9817,114,Ectopolymers,"Ectopolymers are refined and crafted into components, modules and other items.",Ectopolymers.png,common,1189,0,0,1189,0
4593,18069,9817,106,Elastomers,"Elastomers are refined and crafted into components, modules and other items.",Elastomers.png,abundant,2554,0,0,2554,0
4593,18070,9817,54,Hyperspecular Crystals,"Hyperspecular Crystals are refined and crafted into components, modules and other items.",Hyperspecular_Crystals.png,uncommon,4446,0,0,4446,0
4602,3134,3726,42,Base Minerals,"Base Minerals are refined and crafted into components, modules and other items.",Base_Mineral.png,abundant,2281,286,0,1995,286
4616,18583,3740,114,Ectopolymers,"Ectopolymers are refined and crafted into components, modules and other items.",Ectopolymers.png,common,1148,0,0,1148,0
4616,18584,3740,119,Novis Compounds,"Novis Compounds are refined and crafted into components, modules and other items.",Novis_Compound.png,uncommon,2981,0,0,2981,0
4616,18591,3740,105,Silicates,"Silicates are refined and crafted into components, modules and other items.",Silicates.png,abundant,4334,0,0,4334,0
4618,1040,3742,105,Silicates,"Silicates are refined and crafted into components, modules and other items.",Silicates.png,abundant,4062,0,0,4062,0
4618,18712,3742,117,Yprasium,"Yprasium is refined and crafted into components, modules and other items.",Yprasium.png,uncommon,1034,0,0,1034,0
4619,256,3743,123,Neolysium,"Neolysium is refined and crafted into components, modules and other items.",Neolysium.png,uncommon,2524,0,0,2524,0
4619,671,3743,107,H2O,"H2O is refined and crafted into components, modules and other items.",H20.png,abundant,5902,0,0,5902,0
4619,3661,3743,54,Hyperspecular Crystals,"Hyperspecular Crystals are refined and crafted into components, modules and other items.",Hyperspecular_Crystals.png,uncommon,1225,0,0,1225,0
4619,3662,3743,54,Hyperspecular Crystals,"Hyperspecular Crystals are refined and crafted into components, modules and other items.",Hyperspecular_Crystals.png,uncommon,1198,0,0,1198,0
4619,322,9843,113,Aerogens,"Aerogens are refined and crafted into components, modules and other items.",Aerogens.png,common,2565,0,0,2565,0
4619,323,9843,112,Amphoteric Substances,"Amphoteric Substances are refined and crafted into components, modules and other items.",Amphoteric_Substances.png,common,2029,0,0,2029,0
4619,19241,9843,42,Base Minerals,"Base Minerals are refined and crafted into components, modules and other items.",Base_Mineral.png,abundant,4549,0,0,4549,0
4625,9062,3749,113,Aerogens,"Aerogens are refined and crafted into components, modules and other items.",Aerogens.png,common,2655,0,0,2655,0
4627,2187,3751,126,Bruma Particles,"Bruma Particles are refined and crafted into components, modules and other items.",Bruma_Particle.png,rare,1608,0,0,1608,0
4627,2188,3751,54,Hyperspecular Crystals,"Hyperspecular Crystals are refined and crafted into components, modules and other items.",Hyperspecular_Crystals.png,uncommon,2477,0,0,2477,0
4627,2446,3751,107,H2O,"H2O is refined and crafted into components, modules and other items.",H20.png,abundant,5422,0,0,5422,0
4627,3663,3751,128,Tchaikovium,"Tchaikovium is refined and crafted into components, modules and other items.",Tchaikovium.png,rare,718,718,0,0,718
4627,4407,9851,109,Titanium,"Titanium is refined and crafted into components, modules and other items.",Titanium.png,common,2655,0,0,2655,0
4627,4537,9851,42,Base Minerals,"Base Minerals are refined and crafted into components, modules and other items.",Base_Mineral.png,abundant,5845,0,0,5845,0
4627,4558,9851,126,Bruma Particles,"Bruma Particles are refined and crafted into components, modules and other items.",Bruma_Particle.png,rare,794,0,0,794,0
4629,4413,3753,128,Tchaikovium,"Tchaikovium is refined and crafted into components, modules and other items.",Tchaikovium.png,rare,764,0,0,764,0
4629,4867,3753,120,Metamagnetic Ore,"Metamagnetic Ore is refined and crafted into components, modules and other items.",Metamagnetic_Ore.png,uncommon,2694,0,0,2694,0
4629,10665,3753,107,H2O,"H2O is refined and crafted into components, modules and other items.",H20.png,abundant,4120,0,0,4120,0
4629,4414,9853,127,Microorganisms,"Microorganisms are refined and crafted into components, modules and other items.",Microorganism.png,rare,758,0,0,758,0
4629,9812,9853,106,Elastomers,"Elastomers are refined and crafted into components, modules and other items.",Elastomers.png,abundant,5343,0,0,5343,0
4629,15742,9853,110,Plutonium,"Plutonium is refined and crafted into components, modules and other items.",Plutonium.png,common,2792,0,0,2792,0
4632,3834,3756,54,Hyperspecular Crystals,"Hyperspecular Crystals are refined and crafted into components, modules and other items.",Hyperspecular_Crystals.png,uncommon,1496,0,0,1496,0
4632,3835,3756,113,Aerogens,"Aerogens are refined and crafted into components, modules and other items.",Aerogens.png,common,2380,0,0,2380,0
4632,3836,3756,113,Aerogens,"Aerogens are refined and crafted into components, modules and other items.",Aerogens.png,common,5116,0,0,5116,0
4636,3468,3760,106,Elastomers,"Elastomers are refined and crafted into components, modules and other items.",Elastomers.png,abundant,5912,0,0,5912,0
4636,4221,3760,41,Xensium,"Xensium is refined and crafted into components, modules and other items.",Xensium.png,uncommon,2551,0,0,2551,0
4636,4282,3760,52,Organic Compounds,"Organic Compounds are refined and crafted into components, modules and other items.",Organic_Compound.png,common,1139,0,0,1139,0
4636,20065,9860,41,Xensium,"Xensium is refined and crafted into components, modules and other items.",Xensium.png,uncommon,2933,0,0,2933,0
4642,342,3766,41,Xensium,"Xensium is refined and crafted into components, modules and other items.",Xensium.png,uncommon,1090,0,0,1090,0
4642,2114,3766,121,Hypoatomic Substances,"Hypoatomic Substances are refined and crafted into components, modules and other items.",Hypoatomic_Substances.png,uncommon,2385,0,0,2385,0
4642,2115,3766,107,H2O,"H2O is refined and crafted into components, modules and other items.",H20.png,abundant,4957,0,0,4957,0
4642,1035,9866,107,H2O,"H2O is refined and crafted into components, modules and other items.",H20.png,abundant,2659,0,0,2659,0
4642,2116,9866,127,Microorganisms,"Microorganisms are refined and crafted into components, modules and other items.",Microorganism.png,rare,688,0,0,688,0
4642,3556,9866,42,Base Minerals,"Base Minerals are refined and crafted into components, modules and other items.",Base_Mineral.png,abundant,5882,0,0,5882,0
4645,1911,3769,114,Ectopolymers,"Ectopolymers are refined and crafted into components, modules and other items.",Ectopolymers.png,common,5847,585,0,5262,585
4645,1976,3769,128,Tchaikovium,"Tchaikovium is refined and crafted into components, modules and other items.",Tchaikovium.png,rare,850,0,0,850,0
4645,2287,3769,120,Metamagnetic Ore,"Metamagnetic Ore is refined and crafted into components, modules and other items.",Metamagnetic_Ore.png,uncommon,2481,622,0,1859,622
4647,3056,3771,41,Xensium,"Xensium is refined and crafted into components, modules and other items.",Xensium.png,uncommon,1120,0,0,1120,0
4647,3057,3771,41,Xensium,"Xensium is refined and crafted into components, modules and other items.",Xensium.png,uncommon,2308,0,0,2308,0
4647,3058,3771,41,Xensium,"Xensium is refined and crafted into components, modules and other items.",Xensium.png,uncommon,4861,0,0,4861,0
4653,470,3777,106,Elastomers,"Elastomers are refined and crafted into components, modules and other items.",Elastomers.png,abundant,5161,1034,0,4127,1034
4653,471,3777,112,Amphoteric Substances,"Amphoteric Substances are refined and crafted into components, modules and other items.",Amphoteric_Substances.png,common,2461,616,0,1845,616
4653,472,3777,123,Neolysium,"Neolysium is refined and crafted into components, modules and other items.",Neolysium.png,uncommon,2224,278,0,1946,278
4653,488,3777,54,Hyperspecular Crystals,"Hyperspecular Crystals are refined and crafted into components, modules and other items.",Hyperspecular_Crystals.png,uncommon,1439,1439,0,0,1439
4653,852,9877,105,Silicates,"Silicates are refined and crafted into components, modules and other items.",Silicates.png,abundant,4035,0,0,4035,0
4653,857,9877,114,Ectopolymers,"Ectopolymers are refined and crafted into components, modules and other items.",Ectopolymers.png,common,2219,0,0,2219,0
4653,879,9877,53,Ignis Ore,"Ignis Ore is refined and crafted into components, modules and other items.",Ignis_Ore.png,rare,753,0,0,753,0
4658,14887,3782,105,Silicates,"Silicates are refined and crafted into components, modules and other items.",Silicates.png,abundant,2474,0,0,2474,0
4658,14888,3782,107,H2O,"H2O is refined and crafted into components, modules and other items.",H20.png,abundant,4132,0,0,4132,0
4661,2066,3785,126,Bruma Particles,"Bruma Particles are refined and crafted into components, modules and other items.",Bruma_Particle.png,rare,754,0,0,754,0
4661,2513,3785,123,Neolysium,"Neolysium is refined and crafted into components, modules and other items.",Neolysium.png,uncommon,2239,840,0,1399,840
4661,2580,3785,112,Amphoteric Substances,"Amphoteric Substances are refined and crafted into components, modules and other items.",Amphoteric_Substances.png,common,5655,1132,0,4523,1132
4665,716,3789,123,Neolysium,"Neolysium is refined and crafted into components, modules and other items.",Neolysium.png,uncommon,4676,0,0,4676,0
4665,717,3789,109,Titanium,"Titanium is refined and crafted into components, modules and other items.",Titanium.png,common,2329,0,0,2329,0
4668,11914,3792,110,Plutonium,"Plutonium is refined and crafted into components, modules and other items.",Plutonium.png,common,5176,0,0,5176,0
4668,1467,9892,118,Platinyx,"Platinyx is refined and crafted into components, modules and other items.",Platinyx.png,uncommon,1015,0,0,1015,0
4668,4853,9892,42,Base Minerals,"Base Minerals are refined and crafted into components, modules and other items.",Base_Mineral.png,abundant,2766,0,0,2766,0
4668,7498,9892,42,Base Minerals,"Base Minerals are refined and crafted into components, modules and other items.",Base_Mineral.png,abundant,4804,0,0,4804,0
4673,1301,3797,120,Metamagnetic Ore,"Metamagnetic Ore is refined and crafted into components, modules and other items.",Metamagnetic_Ore.png,uncommon,1357,0,0,1357,0
4673,2117,3797,112,Amphoteric Substances,"Amphoteric Substances are refined and crafted into components, modules and other items.",Amphoteric_Substances.png,common,2038,0,0,2038,0
4673,2118,3797,105,Silicates,"Silicates are refined and crafted into components, modules and other items.",Silicates.png,abundant,5869,0,0,5869,0
4673,2119,9897,123,Neolysium,"Neolysium is refined and crafted into components, modules and other items.",Neolysium.png,uncommon,2636,0,0,2636,0
4673,2120,9897,123,Neolysium,"Neolysium is refined and crafted into components, modules and other items.",Neolysium.png,uncommon,2663,0,0,2663,0
4673,3567,9897,123,Neolysium,"Neolysium is refined and crafted into components, modules and other items.",Neolysium.png,uncommon,1193,0,0,1193,0
4673,3568,9897,42,Base Minerals,"Base Minerals are refined and crafted into components, modules and other items.",Base_Mineral.png,abundant,5894,0,0,5894,0
4682,2934,3806,105,Silicates,"Silicates are refined and crafted into components, modules and other items.",Silicates.png,abundant,5024,0,0,5024,0
4682,3576,3806,113,Aerogens,"Aerogens are refined and crafted into components, modules and other items.",Aerogens.png,common,1379,0,0,1379,0
4682,4222,3806,112,Amphoteric Substances,"Amphoteric Substances are refined and crafted into components, modules and other items.",Amphoteric_Substances.png,common,2944,0,0,2944,0
4682,4734,9906,112,Amphoteric Substances,"Amphoteric Substances are refined and crafted into components, modules and other items.",Amphoteric_Substances.png,common,2112,0,0,2112,0
4682,6535,9906,42,Base Minerals,"Base Minerals are refined and crafted into components, modules and other items.",Base_Mineral.png,abundant,5781,0,0,5781,0
4685,2121,3809,53,Ignis Ore,"Ignis Ore is refined and crafted into components, modules and other items.",Ignis_Ore.png,rare,679,272,0,407,272
4685,2122,3809,109,Titanium,"Titanium is refined and crafted into components, modules and other items.",Titanium.png,common,2922,1098,0,1824,1098
4685,2123,3809,105,Silicates,"Silicates are refined and crafted into components, modules and other items.",Silicates.png,abundant,4700,0,0,4700,0
4685,4161,9909,109,Titanium,"Titanium is refined and crafted into components, modules and other items.",Titanium.png,common,1140,0,0,1140,0
4685,4162,9909,53,Ignis Ore,"Ignis Ore is refined and crafted into components, modules and other items.",Ignis_Ore.png,rare,874,0,0,874,0
4685,4163,9909,105,Silicates,"Silicates are refined and crafted into components, modules and other items.",Silicates.png,abundant,2629,0,0,2629,0
4685,4164,9909,106,Elastomers,"Elastomers are refined and crafted into components, modules and other items.",Elastomers.png,abundant,5912,1776,0,4136,1776
4687,2210,3811,120,Metamagnetic Ore,"Metamagnetic Ore is refined and crafted into components, modules and other items.",Metamagnetic_Ore.png,uncommon,1184,0,0,1184,0
4687,2211,3811,42,Base Minerals,"Base Minerals are refined and crafted into components, modules and other items.",Base_Mineral.png,abundant,2364,0,0,2364,0
4687,2212,3811,105,Silicates,"Silicates are refined and crafted into components, modules and other items.",Silicates.png,abundant,4749,0,0,4749,0
4692,3837,3816,110,Plutonium,"Plutonium is refined and crafted into components, modules and other items.",Plutonium.png,common,1135,0,0,1135,0
4692,3838,3816,118,Platinyx,"Platinyx is refined and crafted into components, modules and other items.",Platinyx.png,uncommon,2312,0,0,2312,0
4692,3839,3816,107,H2O,"H2O is refined and crafted into components, modules and other items.",H20.png,abundant,4680,0,0,4680,0
4695,2565,3819,110,Plutonium,"Plutonium is refined and crafted into components, modules and other items.",Plutonium.png,common,1287,0,0,1287,0
4695,2727,3819,128,Tchaikovium,"Tchaikovium is refined and crafted into components, modules and other items.",Tchaikovium.png,rare,1882,0,0,1882,0
4695,2728,3819,107,H2O,"H2O is refined and crafted into components, modules and other items.",H20.png,abundant,5973,0,0,5973,0
4695,4668,9919,105,Silicates,"Silicates are refined and crafted into components, modules and other items.",Silicates.png,abundant,4293,0,0,4293,0
4695,4669,9919,110,Plutonium,"Plutonium is refined and crafted into components, modules and other items.",Plutonium.png,common,2947,0,0,2947,0
4695,4750,9919,120,Metamagnetic Ore,"Metamagnetic Ore is refined and crafted into components, modules and other items.",Metamagnetic_Ore.png,uncommon,1060,0,0,1060,0
4698,3059,3822,114,Ectopolymers,"Ectopolymers are refined and crafted into components, modules and other items.",Ectopolymers.png,common,2000,0,0,2000,0
4698,3060,3822,114,Ectopolymers,"Ectopolymers are refined and crafted into components, modules and other items.",Ectopolymers.png,common,2064,0,0,2064,0
4698,3061,3822,106,Elastomers,"Elastomers are refined and crafted into components, modules and other items.",Elastomers.png,abundant,4680,0,0,4680,0
4698,3062,3822,121,Hypoatomic Substances,"Hypoatomic Substances are refined and crafted into components, modules and other items.",Hypoatomic_Substances.png,uncommon,1435,0,0,1435,0
4699,501,3823,110,Plutonium,"Plutonium is refined and crafted into components, modules and other items.",Plutonium.png,common,2828,0,0,2828,0
4699,502,3823,42,Base Minerals,"Base Minerals are refined and crafted into components, modules and other items.",Base_Mineral.png,abundant,2125,0,0,2125,0
4699,503,3823,106,Elastomers,"Elastomers are refined and crafted into components, modules and other items.",Elastomers.png,abundant,5747,0,0,5747,0
4699,504,3823,52,Organic Compounds,"Organic Compounds are refined and crafted into components, modules and other items.",Organic_Compound.png,common,5578,1116,0,4462,1116
4699,3364,3823,117,Yprasium,"Yprasium is refined and crafted into components, modules and other items.",Yprasium.png,uncommon,1084,0,0,1084,0
4699,3429,9923,117,Yprasium,"Yprasium is refined and crafted into components, modules and other items.",Yprasium.png,uncommon,2476,0,0,2476,0
4700,2102,3824,53,Ignis Ore,"Ignis Ore is refined and crafted into components, modules and other items.",Ignis_Ore.png,rare,828,0,0,828,0
4700,2103,3824,106,Elastomers,"Elastomers are refined and crafted into components, modules and other items.",Elastomers.png,abundant,2180,0,0,2180,0
4700,2104,3824,42,Base Minerals,"Base Minerals are refined and crafted into components, modules and other items.",Base_Mineral.png,abundant,5218,0,0,5218,0
4700,3032,9924,128,Tchaikovium,"Tchaikovium is refined and crafted into components, modules and other items.",Tchaikovium.png,rare,711,0,0,711,0
4700,5183,9924,109,Titanium,"Titanium is refined and crafted into components, modules and other items.",Titanium.png,common,4392,0,0,4392,0
4700,6139,9924,109,Titanium,"Titanium is refined and crafted into components, modules and other items.",Titanium.png,common,2888,0,0,2888,0
4701,2716,3825,106,Elastomers,"Elastomers are refined and crafted into components, modules and other items.",Elastomers.png,abundant,4148,0,0,4148,0
4701,3141,3825,105,Silicates,"Silicates are refined and crafted into components, modules and other items.",Silicates.png,abundant,2896,0,0,2896,0
4701,3665,3825,128,Tchaikovium,"Tchaikovium is refined and crafted into components, modules and other items.",Tchaikovium.png,rare,822,660,0,162,660
4701,3664,9925,105,Silicates,"Silicates are refined and crafted into components, modules and other items.",Silicates.png,abundant,2281,0,0,2281,0
4701,4559,9925,112,Amphoteric Substances,"Amphoteric Substances are refined and crafted into components, modules and other items.",Amphoteric_Substances.png,common,5826,0,0,5826,0
4701,4593,9925,128,Tchaikovium,"Tchaikovium is refined and crafted into components, modules and other items.",Tchaikovium.png,rare,694,0,0,694,0
4703,3258,3827,128,Tchaikovium,"Tchaikovium is refined and crafted into components, modules and other items.",Tchaikovium.png,rare,657,0,0,657,0
4703,3259,3827,40,Polymetals,"Polymetals are refined and crafted into components, modules and other items.",Polymetals.png,common,2671,0,0,2671,0
4703,3260,3827,106,Elastomers,"Elastomers are refined and crafted into components, modules and other items.",Elastomers.png,abundant,5969,0,0,5969,0
4710,642,3834,119,Novis Compounds,"Novis Compounds are refined and crafted into components, modules and other items.",Novis_Compound.png,uncommon,5205,0,0,5205,0
4710,3898,3834,114,Ectopolymers,"Ectopolymers are refined and crafted into components, modules and other items.",Ectopolymers.png,common,2415,0,0,2415,0
4710,16734,3834,127,Microorganisms,"Microorganisms are refined and crafted into components, modules and other items.",Microorganism.png,rare,816,0,0,816,0
4710,2308,9934,42,Base Minerals,"Base Minerals are refined and crafted into components, modules and other items.",Base_Mineral.png,abundant,2617,328,0,2289,328
4710,3899,9934,128,Tchaikovium,"Tchaikovium is refined and crafted into components, modules and other items.",Tchaikovium.png,rare,745,0,0,745,0
4714,3635,3838,118,Platinyx,"Platinyx is refined and crafted into components, modules and other items.",Platinyx.png,uncommon,1225,0,0,1225,0
4714,3636,3838,117,Yprasium,"Yprasium is refined and crafted into components, modules and other items.",Yprasium.png,uncommon,1301,0,0,1301,0
4714,3637,3838,114,Ectopolymers,"Ectopolymers are refined and crafted into components, modules and other items.",Ectopolymers.png,common,2372,0,0,2372,0
4714,3638,3838,105,Silicates,"Silicates are refined and crafted into components, modules and other items.",Silicates.png,abundant,5522,0,0,5522,0
4718,3927,3842,114,Ectopolymers,"Ectopolymers are refined and crafted into components, modules and other items.",Ectopolymers.png,common,1124,225,0,899,225
4719,9063,3843,109,Titanium,"Titanium is refined and crafted into components, modules and other items.",Titanium.png,common,2415,0,0,2415,0
4722,3639,3846,117,Yprasium,"Yprasium is refined and crafted into components, modules and other items.",Yprasium.png,uncommon,1257,0,0,1257,0
4722,3640,3846,121,Hypoatomic Substances,"Hypoatomic Substances are refined and crafted into components, modules and other items.",Hypoatomic_Substances.png,uncommon,2977,0,0,2977,0
4722,3641,3846,106,Elastomers,"Elastomers are refined and crafted into components, modules and other items.",Elastomers.png,abundant,5207,0,0,5207,0
4726,13436,3850,128,Tchaikovium,"Tchaikovium is refined and crafted into components, modules and other items.",Tchaikovium.png,rare,849,0,0,849,0
4726,13437,3850,41,Xensium,"Xensium is refined and crafted into components, modules and other items.",Xensium.png,uncommon,2087,0,0,2087,0
4726,13438,3850,106,Elastomers,"Elastomers are refined and crafted into components, modules and other items.",Elastomers.png,abundant,5190,0,0,5190,0
4726,13439,9950,128,Tchaikovium,"Tchaikovium is refined and crafted into components, modules and other items.",Tchaikovium.png,rare,699,0,0,699,0
4726,13440,9950,113,Aerogens,"Aerogens are refined and crafted into components, modules and other items.",Aerogens.png,common,2827,0,0,2827,0
4726,16798,9950,105,Silicates,"Silicates are refined and crafted into components, modules and other items.",Silicates.png,abundant,5979,0,0,5979,0
4727,332,3851,123,Neolysium,"Neolysium is refined and crafted into components, modules and other items.",Neolysium.png,uncommon,1422,0,0,1422,0
4727,333,3851,52,Organic Compounds,"Organic Compounds are refined and crafted into components, modules and other items.",Organic_Compound.png,common,2139,536,0,1603,536
4727,334,3851,106,Elastomers,"Elastomers are refined and crafted into components, modules and other items.",Elastomers.png,abundant,5263,527,0,4736,527
4727,335,9951,41,Xensium,"Xensium is refined and crafted into components, modules and other items.",Xensium.png,uncommon,1052,0,0,1052,0
4727,336,9951,52,Organic Compounds,"Organic Compounds are refined and crafted into components, modules and other items.",Organic_Compound.png,common,1117,0,0,1117,0
4727,506,9951,128,Tchaikovium,"Tchaikovium is refined and crafted into components, modules and other items.",Tchaikovium.png,rare,1596,200,0,1396,200
4727,5512,9951,106,Elastomers,"Elastomers are refined and crafted into components, modules and other items.",Elastomers.png,abundant,5842,0,0,5842,0
4732,989,3856,41,Xensium,"Xensium is refined and crafted into components, modules and other items.",Xensium.png,uncommon,1343,1343,0,0,1343
4732,1026,3856,106,Elastomers,"Elastomers are refined and crafted into components, modules and other items.",Elastomers.png,abundant,5217,522,0,4695,522
4732,1027,3856,107,H2O,"H2O is refined and crafted into components, modules and other items.",H20.png,abundant,5471,548,0,4923,548
4732,1145,3856,107,H2O,"H2O is refined and crafted into components, modules and other items.",H20.png,abundant,2448,306,0,2142,306
4732,2150,9956,42,Base Minerals,"Base Minerals are refined and crafted into components, modules and other items.",Base_Mineral.png,abundant,5941,595,0,5346,595
4732,2406,9956,119,Novis Compounds,"Novis Compounds are refined and crafted into components, modules and other items.",Novis_Compound.png,uncommon,1466,294,0,1172,294
4732,2424,9956,127,Microorganisms,"Microorganisms are refined and crafted into components, modules and other items.",Microorganism.png,rare,1689,1689,0,0,1689
4734,4082,3858,110,Plutonium,"Plutonium is refined and crafted into components, modules and other items.",Plutonium.png,common,2563,0,0,2563,0
4734,4083,3858,42,Base Minerals,"Base Minerals are refined and crafted into components, modules and other items.",Base_Mineral.png,abundant,4733,0,0,4733,0
4734,6634,3858,128,Tchaikovium,"Tchaikovium is refined and crafted into components, modules and other items.",Tchaikovium.png,rare,832,0,0,832,0
4734,6635,3858,128,Tchaikovium,"Tchaikovium is refined and crafted into components, modules and other items.",Tchaikovium.png,rare,666,0,0,666,0
4734,6636,9958,128,Tchaikovium,"Tchaikovium is refined and crafted into components, modules and other items.",Tchaikovium.png,rare,733,147,0,586,147
4734,6637,9958,110,Plutonium,"Plutonium is refined and crafted into components, modules and other items.",Plutonium.png,common,1367,0,0,1367,0
4734,8075,9958,42,Base Minerals,"Base Minerals are refined and crafted into components, modules and other items.",Base_Mineral.png,abundant,2486,0,0,2486,0
4734,12541,9958,106,Elastomers,"Elastomers are refined and crafted into components, modules and other items.",Elastomers.png,abundant,5188,0,0,5188,0
4738,15775,3862,105,Silicates,"Silicates are refined and crafted into components, modules and other items.",Silicates.png,abundant,2424,0,0,2424,0
4738,16502,3862,105,Silicates,"Silicates are refined and crafted into components, modules and other items.",Silicates.png,abundant,4487,0,0,4487,0
4742,3950,3866,110,Plutonium,"Plutonium is refined and crafted into components, modules and other items.",Plutonium.png,common,2826,0,0,2826,0
4742,527,9966,42,Base Minerals,"Base Minerals are refined and crafted into components, modules and other items.",Base_Mineral.png,abundant,2419,0,0,2419,0
4745,2151,3869,107,H2O,"H2O is refined and crafted into components, modules and other items.",H20.png,abundant,4322,0,0,4322,0
4745,2230,3869,126,Bruma Particles,"Bruma Particles are refined and crafted into components, modules and other items.",Bruma_Particle.png,rare,829,0,0,829,0
4745,2282,3869,42,Base Minerals,"Base Minerals are refined and crafted into components, modules and other items.",Base_Mineral.png,abundant,2963,0,0,2963,0
4745,4065,9969,40,Polymetals,"Polymetals are refined and crafted into components, modules and other items.",Polymetals.png,common,1148,0,0,1148,0
4745,4066,9969,112,Amphoteric Substances,"Amphoteric Substances are refined and crafted into components, modules and other items.",Amphoteric_Substances.png,common,2251,0,0,2251,0
4745,4067,9969,112,Amphoteric Substances,"Amphoteric Substances are refined and crafted into components, modules and other items.",Amphoteric_Substances.png,common,5102,0,0,5102,0
4746,2736,3870,106,Elastomers,"Elastomers are refined and crafted into components, modules and other items.",Elastomers.png,abundant,4878,0,0,4878,0
4746,4420,3870,127,Microorganisms,"Microorganisms are refined and crafted into components, modules and other items.",Microorganism.png,rare,887,0,0,887,0
4746,9815,3870,107,H2O,"H2O is refined and crafted into components, modules and other items.",H20.png,abundant,2294,0,0,2294,0
4746,9408,9970,115,Nanofluids,"Nanofluids are refined and crafted into components, modules and other items.",Nanofluids.png,common,2891,0,0,2891,0
4749,3017,3873,114,Ectopolymers,"Ectopolymers are refined and crafted into components, modules and other items.",Ectopolymers.png,common,1145,0,0,1145,0
4749,4648,3873,105,Silicates,"Silicates are refined and crafted into components, modules and other items.",Silicates.png,abundant,4824,0,0,4824,0
4749,12214,3873,114,Ectopolymers,"Ectopolymers are refined and crafted into components, modules and other items.",Ectopolymers.png,common,2818,0,0,2818,0
4751,3642,3875,118,Platinyx,"Platinyx is refined and crafted into components, modules and other items.",Platinyx.png,uncommon,1417,0,0,1417,0
4751,3643,3875,107,H2O,"H2O is refined and crafted into components, modules and other items.",H20.png,abundant,2104,0,0,2104,0
4751,3644,3875,107,H2O,"H2O is refined and crafted into components, modules and other items.",H20.png,abundant,5369,0,0,5369,0
4757,277,3881,106,Elastomers,"Elastomers are refined and crafted into components, modules and other items.",Elastomers.png,abundant,5374,0,0,5374,0
4757,289,3881,54,Hyperspecular Crystals,"Hyperspecular Crystals are refined and crafted into components, modules and other items.",Hyperspecular_Crystals.png,uncommon,2476,0,0,2476,0
4757,321,3881,114,Ectopolymers,"Ectopolymers are refined and crafted into components, modules and other items.",Ectopolymers.png,common,1328,0,0,1328,0
4757,18071,9981,110,Plutonium,"Plutonium is refined and crafted into components, modules and other items.",Plutonium.png,common,1186,0,0,1186,0
4757,18072,9981,54,Hyperspecular Crystals,"Hyperspecular Crystals are refined and crafted into components, modules and other items.",Hyperspecular_Crystals.png,uncommon,2459,0,0,2459,0
4757,18073,9981,42,Base Minerals,"Base Minerals are refined and crafted into components, modules and other items.",Base_Mineral.png,abundant,5550,0,0,5550,0
4759,185,3883,109,Titanium,"Titanium is refined and crafted into components, modules and other items.",Titanium.png,common,5734,0,0,5734,0
4759,186,3883,112,Amphoteric Substances,"Amphoteric Substances are refined and crafted into components, modules and other items.",Amphoteric_Substances.png,common,2472,0,0,2472,0
4759,629,3883,53,Ignis Ore,"Ignis Ore is refined and crafted into components, modules and other items.",Ignis_Ore.png,rare,781,0,0,781,0
4759,630,3883,109,Titanium,"Titanium is refined and crafted into components, modules and other items.",Titanium.png,common,1418,0,0,1418,0
4759,631,9983,119,Novis Compounds,"Novis Compounds are refined and crafted into components, modules and other items.",Novis_Compound.png,uncommon,2363,0,0,2363,0
4762,18592,3886,126,Bruma Particles,"Bruma Particles are refined and crafted into components, modules and other items.",Bruma_Particle.png,rare,831,0,0,831,0
4762,18680,3886,121,Hypoatomic Substances,"Hypoatomic Substances are refined and crafted into components, modules and other items.",Hypoatomic_Substances.png,uncommon,2348,0,0,2348,0
4762,18681,3886,105,Silicates,"Silicates are refined and crafted into components, modules and other items.",Silicates.png,abundant,4972,0,0,4972,0
4764,18683,3888,52,Organic Compounds,"Organic Compounds are refined and crafted into components, modules and other items.",Organic_Compound.png,common,1035,0,0,1035,0
4764,18684,3888,106,Elastomers,"Elastomers are refined and crafted into components, modules and other items.",Elastomers.png,abundant,2881,0,0,2881,0
4764,18687,3888,42,Base Minerals,"Base Minerals are refined and crafted into components, modules and other items.",Base_Mineral.png,abundant,4141,0,0,4141,0
4765,1545,3889,40,Polymetals,"Polymetals are refined and crafted into components, modules and other items.",Polymetals.png,common,1049,0,0,1049,0
4765,1888,3889,110,Plutonium,"Plutonium is refined and crafted into components, modules and other items.",Plutonium.png,common,2138,0,0,2138,0
4765,1961,3889,42,Base Minerals,"Base Minerals are refined and crafted into components, modules and other items.",Base_Mineral.png,abundant,4491,0,0,4491,0
4765,2564,9989,105,Silicates,"Silicates are refined and crafted into components, modules and other items.",Silicates.png,abundant,5659,0,0,5659,0
4765,3025,9989,41,Xensium,"Xensium is refined and crafted into components, modules and other items.",Xensium.png,uncommon,1235,0,0,1235,0
4765,3071,9989,120,Metamagnetic Ore,"Metamagnetic Ore is refined and crafted into components, modules and other items.",Metamagnetic_Ore.png,uncommon,2666,0,0,2666,0
4771,959,3895,42,Base Minerals,"Base Minerals are refined and crafted into components, modules and other items.",Base_Mineral.png,abundant,4831,0,0,4831,0
4776,15358,3900,115,Nanofluids,"Nanofluids are refined and crafted into components, modules and other items.",Nanofluids.png,common,4149,0,0,4149,0
4778,13638,3902,127,Microorganisms,"Microorganisms are refined and crafted into components, modules and other items.",Microorganism.png,rare,783,0,0,783,0
4778,14098,3902,107,H2O,"H2O is refined and crafted into components, modules and other items.",H20.png,abundant,4230,0,0,4230,0
4778,14099,3902,42,Base Minerals,"Base Minerals are refined and crafted into components, modules and other items.",Base_Mineral.png,abundant,5332,0,0,5332,0
4778,17730,3902,112,Amphoteric Substances,"Amphoteric Substances are refined and crafted into components, modules and other items.",Amphoteric_Substances.png,common,2340,0,0,2340,0
4782,3522,3906,106,Elastomers,"Elastomers are refined and crafted into components, modules and other items.",Elastomers.png,abundant,2419,0,0,2419,0
4782,3601,3906,126,Bruma Particles,"Bruma Particles are refined and crafted into components, modules and other items.",Bruma_Particle.png,rare,652,131,0,521,131
4782,4311,3906,107,H2O,"H2O is refined and crafted into components, modules and other items.",H20.png,abundant,4988,0,0,4988,0
4782,4652,10006,105,Silicates,"Silicates are refined and crafted into components, modules and other items.",Silicates.png,abundant,2564,0,0,2564,0
4784,1943,3908,121,Hypoatomic Substances,"Hypoatomic Substances are refined and crafted into components, modules and other items.",Hypoatomic_Substances.png,uncommon,1083,0,0,1083,0
4784,2236,3908,106,Elastomers,"Elastomers are refined and crafted into components, modules and other items.",Elastomers.png,abundant,2029,0,0,2029,0
4784,4360,3908,107,H2O,"H2O is refined and crafted into components, modules and other items.",H20.png,abundant,5735,0,0,5735,0
4786,2269,3910,114,Ectopolymers,"Ectopolymers are refined and crafted into components, modules and other items.",Ectopolymers.png,common,1142,0,0,1142,0
4786,2407,3910,52,Organic Compounds,"Organic Compounds are refined and crafted into components, modules and other items.",Organic_Compound.png,common,2630,0,0,2630,0
4786,2518,3910,105,Silicates,"Silicates are refined and crafted into components, modules and other items.",Silicates.png,abundant,5706,0,0,5706,0
4788,2124,3912,53,Ignis Ore,"Ignis Ore is refined and crafted into components, modules and other items.",Ignis_Ore.png,rare,659,0,0,659,0
4788,2125,3912,109,Titanium,"Titanium is refined and crafted into components, modules and other items.",Titanium.png,common,2279,0,0,2279,0
4788,2126,3912,105,Silicates,"Silicates are refined and crafted into components, modules and other items.",Silicates.png,abundant,4885,0,0,4885,0
4788,3569,10012,53,Ignis Ore,"Ignis Ore is refined and crafted into components, modules and other items.",Ignis_Ore.png,rare,896,0,0,896,0
4788,3570,10012,109,Titanium,"Titanium is refined and crafted into components, modules and other items.",Titanium.png,common,2120,0,0,2120,0
4788,3571,10012,42,Base Minerals,"Base Minerals are refined and crafted into components, modules and other items.",Base_Mineral.png,abundant,5123,0,0,5123,0
4794,3880,3918,105,Silicates,"Silicates are refined and crafted into components, modules and other items.",Silicates.png,abundant,5068,0,0,5068,0
4794,4289,3918,109,Titanium,"Titanium is refined and crafted into components, modules and other items.",Titanium.png,common,2270,0,0,2270,0
4794,4676,3918,53,Ignis Ore,"Ignis Ore is refined and crafted into components, modules and other items.",Ignis_Ore.png,rare,852,0,0,852,0
4794,3881,10018,126,Bruma Particles,"Bruma Particles are refined and crafted into components, modules and other items.",Bruma_Particle.png,rare,762,0,0,762,0
4794,3882,10018,126,Bruma Particles,"Bruma Particles are refined and crafted into components, modules and other items.",Bruma_Particle.png,rare,854,0,0,854,0
4794,6964,10018,105,Silicates,"Silicates are refined and crafted into components, modules and other items.",Silicates.png,abundant,2325,0,0,2325,0
4794,7515,10018,105,Silicates,"Silicates are refined and crafted into components, modules and other items.",Silicates.png,abundant,5909,0,0,5909,0
4794,7516,10018,107,H2O,"H2O is refined and crafted into components, modules and other items.",H20.png,abundant,4473,0,0,4473,0
4795,2127,3919,120,Metamagnetic Ore,"Metamagnetic Ore is refined and crafted into components, modules and other items.",Metamagnetic_Ore.png,uncommon,1233,0,0,1233,0
4795,2128,3919,109,Titanium,"Titanium is refined and crafted into components, modules and other items.",Titanium.png,common,1384,0,0,1384,0
4795,2129,3919,110,Plutonium,"Plutonium is refined and crafted into components, modules and other items.",Plutonium.png,common,2242,0,0,2242,0
4795,2130,3919,109,Titanium,"Titanium is refined and crafted into components, modules and other items.",Titanium.png,common,4609,0,0,4609,0
4795,3797,10019,53,Ignis Ore,"Ignis Ore is refined and crafted into components, modules and other items.",Ignis_Ore.png,rare,628,0,0,628,0
4795,3798,10019,105,Silicates,"Silicates are refined and crafted into components, modules and other items.",Silicates.png,abundant,2698,0,0,2698,0
4795,3799,10019,105,Silicates,"Silicates are refined and crafted into components, modules and other items.",Silicates.png,abundant,4898,0,0,4898,0
4801,343,3925,118,Platinyx,"Platinyx is refined and crafted into components, modules and other items.",Platinyx.png,uncommon,1467,0,0,1467,0
4801,2131,3925,110,Plutonium,"Plutonium is refined and crafted into components, modules and other items.",Plutonium.png,common,2031,0,0,2031,0
4801,2132,3925,42,Base Minerals,"Base Minerals are refined and crafted into components, modules and other items.",Base_Mineral.png,abundant,5902,0,0,5902,0
4801,1047,10025,107,H2O,"H2O is refined and crafted into components, modules and other items.",H20.png,abundant,2780,0,0,2780,0
4801,3800,10025,118,Platinyx,"Platinyx is refined and crafted into components, modules and other items.",Platinyx.png,uncommon,1199,0,0,1199,0
4801,3801,10025,40,Polymetals,"Polymetals are refined and crafted into components, modules and other items.",Polymetals.png,common,5273,0,0,5273,0
4802,4868,3926,53,Ignis Ore,"Ignis Ore is refined and crafted into components, modules and other items.",Ignis_Ore.png,rare,1490,0,0,1490,0
4802,10669,3926,42,Base Minerals,"Base Minerals are refined and crafted into components, modules and other items.",Base_Mineral.png,abundant,5041,0,0,5041,0
4802,15743,3926,53,Ignis Ore,"Ignis Ore is refined and crafted into components, modules and other items.",Ignis_Ore.png,rare,697,0,0,697,0
4802,4866,10026,120,Metamagnetic Ore,"Metamagnetic Ore is refined and crafted into components, modules and other items.",Metamagnetic_Ore.png,uncommon,1159,0,0,1159,0
4802,10670,10026,112,Amphoteric Substances,"Amphoteric Substances are refined and crafted into components, modules and other items.",Amphoteric_Substances.png,common,5379,0,0,5379,0
4804,9506,3928,107,H2O,"H2O is refined and crafted into components, modules and other items.",H20.png,abundant,5298,0,0,5298,0
4804,9817,3928,115,Nanofluids,"Nanofluids are refined and crafted into components, modules and other items.",Nanofluids.png,common,1115,0,0,1115,0
4804,11158,3928,121,Hypoatomic Substances,"Hypoatomic Substances are refined and crafted into components, modules and other items.",Hypoatomic_Substances.png,uncommon,2138,0,0,2138,0
4804,17988,10028,42,Base Minerals,"Base Minerals are refined and crafted into components, modules and other items.",Base_Mineral.png,abundant,4678,0,0,4678,0
4805,3645,3929,118,Platinyx,"Platinyx is refined and crafted into components, modules and other items.",Platinyx.png,uncommon,1329,0,0,1329,0
4805,3646,3929,52,Organic Compounds,"Organic Compounds are refined and crafted into components, modules and other items.",Organic_Compound.png,common,2835,0,0,2835,0
4805,3647,3929,107,H2O,"H2O is refined and crafted into components, modules and other items.",H20.png,abundant,5690,0,0,5690,0
4813,2229,3937,118,Platinyx,"Platinyx is refined and crafted into components, modules and other items.",Platinyx.png,uncommon,1138,912,0,226,912
4813,2770,3937,119,Novis Compounds,"Novis Compounds are refined and crafted into components, modules and other items.",Novis_Compound.png,uncommon,2876,360,0,2516,360
4813,2791,3937,106,Elastomers,"Elastomers are refined and crafted into components, modules and other items.",Elastomers.png,abundant,5624,0,0,5624,0
4813,4204,10037,54,Hyperspecular Crystals,"Hyperspecular Crystals are refined and crafted into components, modules and other items.",Hyperspecular_Crystals.png,uncommon,1272,255,0,1017,255
4813,4396,10037,106,Elastomers,"Elastomers are refined and crafted into components, modules and other items.",Elastomers.png,abundant,2408,0,0,2408,0
4813,5809,10037,42,Base Minerals,"Base Minerals are refined and crafted into components, modules and other items.",Base_Mineral.png,abundant,4166,0,0,4166,0
4818,3648,3942,109,Titanium,"Titanium is refined and crafted into components, modules and other items.",Titanium.png,common,1011,0,0,1011,0
4818,3649,3942,105,Silicates,"Silicates are refined and crafted into components, modules and other items.",Silicates.png,abundant,4289,0,0,4289,0
4818,3717,3942,123,Neolysium,"Neolysium is refined and crafted into components, modules and other items.",Neolysium.png,uncommon,2947,0,0,2947,0
4825,2194,3949,106,Elastomers,"Elastomers are refined and crafted into components, modules and other items.",Elastomers.png,abundant,5075,0,0,5075,0
4825,2276,3949,126,Bruma Particles,"Bruma Particles are refined and crafted into components, modules and other items.",Bruma_Particle.png,rare,887,0,0,887,0
4825,2284,3949,123,Neolysium,"Neolysium is refined and crafted into components, modules and other items.",Neolysium.png,uncommon,2585,0,0,2585,0
4825,4068,10049,53,Ignis Ore,"Ignis Ore is refined and crafted into components, modules and other items.",Ignis_Ore.png,rare,863,0,0,863,0
4825,4069,10049,105,Silicates,"Silicates are refined and crafted into components, modules and other items.",Silicates.png,abundant,2629,0,0,2629,0
4825,4070,10049,107,H2O,"H2O is refined and crafted into components, modules and other items.",H20.png,abundant,5399,0,0,5399,0
4825,4071,10049,105,Silicates,"Silicates are refined and crafted into components, modules and other items.",Silicates.png,abundant,5899,0,0,5899,0
4827,898,3951,105,Silicates,"Silicates are refined and crafted into components, modules and other items.",Silicates.png,abundant,5948,0,0,5948,0
4827,902,3951,119,Novis Compounds,"Novis Compounds are refined and crafted into components, modules and other items.",Novis_Compound.png,uncommon,2599,0,0,2599,0
4827,903,3951,119,Novis Compounds,"Novis Compounds are refined and crafted into components, modules and other items.",Novis_Compound.png,uncommon,2653,0,0,2653,0
4827,934,3951,119,Novis Compounds,"Novis Compounds are refined and crafted into components, modules and other items.",Novis_Compound.png,uncommon,1288,0,0,1288,0
4827,18074,10051,128,Tchaikovium,"Tchaikovium is refined and crafted into components, modules and other items.",Tchaikovium.png,rare,823,0,0,823,0
4827,18075,10051,114,Ectopolymers,"Ectopolymers are refined and crafted into components, modules and other items.",Ectopolymers.png,common,1441,0,0,1441,0
4827,18076,10051,54,Hyperspecular Crystals,"Hyperspecular Crystals are refined and crafted into components, modules and other items.",Hyperspecular_Crystals.png,uncommon,2720,0,0,2720,0
4827,18077,10051,42,Base Minerals,"Base Minerals are refined and crafted into components, modules and other items.",Base_Mineral.png,abundant,4557,0,0,4557,0
4830,18688,3954,41,Xensium,"Xensium is refined and crafted into components, modules and other items.",Xensium.png,uncommon,1264,0,0,1264,0
4830,18749,3954,41,Xensium,"Xensium is refined and crafted into components, modules and other items.",Xensium.png,uncommon,2188,0,0,2188,0
4830,18750,3954,115,Nanofluids,"Nanofluids are refined and crafted into components, modules and other items.",Nanofluids.png,common,4080,0,0,4080,0
4834,909,3958,40,Polymetals,"Polymetals are refined and crafted into components, modules and other items.",Polymetals.png,common,1276,0,0,1276,0
4834,1056,3958,110,Plutonium,"Plutonium is refined and crafted into components, modules and other items.",Plutonium.png,common,2149,0,0,2149,0
4834,1080,3958,110,Plutonium,"Plutonium is refined and crafted into components, modules and other items.",Plutonium.png,common,4818,0,0,4818,0
4834,3091,10058,112,Amphoteric Substances,"Amphoteric Substances are refined and crafted into components, modules and other items.",Amphoteric_Substances.png,common,1477,0,0,1477,0
4834,7030,10058,105,Silicates,"Silicates are refined and crafted into components, modules and other items.",Silicates.png,abundant,2410,0,0,2410,0
4834,7803,10058,105,Silicates,"Silicates are refined and crafted into components, modules and other items.",Silicates.png,abundant,4394,0,0,4394,0
4836,2133,3960,128,Tchaikovium,"Tchaikovium is refined and crafted into components, modules and other items.",Tchaikovium.png,rare,869,0,0,869,0
4836,2134,3960,106,Elastomers,"Elastomers are refined and crafted into components, modules and other items.",Elastomers.png,abundant,2250,0,0,2250,0
4836,2135,3960,109,Titanium,"Titanium is refined and crafted into components, modules and other items.",Titanium.png,common,2759,0,0,2759,0
4836,2136,3960,42,Base Minerals,"Base Minerals are refined and crafted into components, modules and other items.",Base_Mineral.png,abundant,5011,0,0,5011,0
4836,3540,10060,53,Ignis Ore,"Ignis Ore is refined and crafted into components, modules and other items.",Ignis_Ore.png,rare,668,0,0,668,0
4836,3541,10060,42,Base Minerals,"Base Minerals are refined and crafted into components, modules and other items.",Base_Mineral.png,abundant,2446,0,0,2446,0
4836,3542,10060,112,Amphoteric Substances,"Amphoteric Substances are refined and crafted into components, modules and other items.",Amphoteric_Substances.png,common,4728,0,0,4728,0
4841,7823,3965,109,Titanium,"Titanium is refined and crafted into components, modules and other items.",Titanium.png,common,2848,0,0,2848,0
4841,11980,3965,109,Titanium,"Titanium is refined and crafted into components, modules and other items.",Titanium.png,common,5014,0,0,5014,0
4841,11981,3965,42,Base Minerals,"Base Minerals are refined and crafted into components, modules and other items.",Base_Mineral.png,abundant,5049,0,0,5049,0
4841,15446,3965,126,Bruma Particles,"Bruma Particles are refined and crafted into components, modules and other items.",Bruma_Particle.png,rare,725,0,0,725,0
4841,4869,10065,126,Bruma Particles,"Bruma Particles are refined and crafted into components, modules and other items.",Bruma_Particle.png,rare,656,0,0,656,0
4841,10671,10065,112,Amphoteric Substances,"Amphoteric Substances are refined and crafted into components, modules and other items.",Amphoteric_Substances.png,common,5448,0,0,5448,0
4841,11982,10065,123,Neolysium,"Neolysium is refined and crafted into components, modules and other items.",Neolysium.png,uncommon,2579,0,0,2579,0
4850,18382,3974,126,Bruma Particles,"Bruma Particles are refined and crafted into components, modules and other items.",Bruma_Particle.png,rare,2814,0,0,2814,0
4850,18577,3974,117,Yprasium,"Yprasium is refined and crafted into components, modules and other items.",Yprasium.png,uncommon,1225,0,0,1225,0
4850,18585,3974,121,Hypoatomic Substances,"Hypoatomic Substances are refined and crafted into components, modules and other items.",Hypoatomic_Substances.png,uncommon,2941,0,0,2941,0
4859,3443,3983,112,Amphoteric Substances,"Amphoteric Substances are refined and crafted into components, modules and other items.",Amphoteric_Substances.png,common,5137,0,0,5137,0
4859,4538,3983,119,Novis Compounds,"Novis Compounds are refined and crafted into components, modules and other items.",Novis_Compound.png,uncommon,1191,0,0,1191,0
4859,4539,3983,117,Yprasium,"Yprasium is refined and crafted into components, modules and other items.",Yprasium.png,uncommon,2652,0,0,2652,0
4862,18753,3986,128,Tchaikovium,"Tchaikovium is refined and crafted into components, modules and other items.",Tchaikovium.png,rare,700,0,0,700,0
4862,18754,3986,112,Amphoteric Substances,"Amphoteric Substances are refined and crafted into components, modules and other items.",Amphoteric_Substances.png,common,2082,0,0,2082,0
4862,18755,3986,106,Elastomers,"Elastomers are refined and crafted into components, modules and other items.",Elastomers.png,abundant,5017,0,0,5017,0
4863,913,3987,53,Ignis Ore,"Ignis Ore is refined and crafted into components, modules and other items.",Ignis_Ore.png,rare,791,0,0,791,0
4863,914,3987,40,Polymetals,"Polymetals are refined and crafted into components, modules and other items.",Polymetals.png,common,2158,0,0,2158,0
4863,915,3987,106,Elastomers,"Elastomers are refined and crafted into components, modules and other items.",Elastomers.png,abundant,4744,0,0,4744,0
4863,916,3987,42,Base Minerals,"Base Minerals are refined and crafted into components, modules and other items.",Base_Mineral.png,abundant,4341,0,0,4341,0
4863,13434,10087,109,Titanium,"Titanium is refined and crafted into components, modules and other items.",Titanium.png,common,2417,0,0,2417,0
4863,15952,10087,105,Silicates,"Silicates are refined and crafted into components, modules and other items.",Silicates.png,abundant,5212,0,0,5212,0
4866,2137,3990,113,Aerogens,"Aerogens are refined and crafted into components, modules and other items.",Aerogens.png,common,1372,0,0,1372,0
4866,2138,3990,40,Polymetals,"Polymetals are refined and crafted into components, modules and other items.",Polymetals.png,common,2903,0,0,2903,0
4866,2139,3990,42,Base Minerals,"Base Minerals are refined and crafted into components, modules and other items.",Base_Mineral.png,abundant,4813,0,0,4813,0
4866,2140,3990,40,Polymetals,"Polymetals are refined and crafted into components, modules and other items.",Polymetals.png,common,5983,0,0,5983,0
4866,4155,10090,110,Plutonium,"Plutonium is refined and crafted into components, modules and other items.",Plutonium.png,common,1405,0,0,1405,0
4866,4156,10090,40,Polymetals,"Polymetals are refined and crafted into components, modules and other items.",Polymetals.png,common,2749,0,0,2749,0
4866,4157,10090,40,Polymetals,"Polymetals are refined and crafted into components, modules and other items.",Polymetals.png,common,5697,0,0,5697,0
4868,229,3992,106,Elastomers,"Elastomers are refined and crafted into components, modules and other items.",Elastomers.png,abundant,4752,0,0,4752,0
4868,233,3992,128,Tchaikovium,"Tchaikovium is refined and crafted into components, modules and other items.",Tchaikovium.png,rare,806,0,0,806,0
4868,234,3992,54,Hyperspecular Crystals,"Hyperspecular Crystals are refined and crafted into components, modules and other items.",Hyperspecular_Crystals.png,uncommon,1172,0,0,1172,0
4868,235,3992,113,Aerogens,"Aerogens are refined and crafted into components, modules and other items.",Aerogens.png,common,2704,0,0,2704,0
4868,4463,10092,114,Ectopolymers,"Ectopolymers are refined and crafted into components, modules and other items.",Ectopolymers.png,common,2639,0,0,2639,0
4868,4635,10092,128,Tchaikovium,"Tchaikovium is refined and crafted into components, modules and other items.",Tchaikovium.png,rare,3342,0,0,3342,0
4868,8265,10092,128,Tchaikovium,"Tchaikovium is refined and crafted into components, modules and other items.",Tchaikovium.png,rare,802,0,0,802,0
4869,1340,3993,41,Xensium,"Xensium is refined and crafted into components, modules and other items.",Xensium.png,uncommon,1223,0,0,1223,0
4869,1341,3993,123,Neolysium,"Neolysium is refined and crafted into components, modules and other items.",Neolysium.png,uncommon,2150,0,0,2150,0
4869,1342,3993,42,Base Minerals,"Base Minerals are refined and crafted into components, modules and other items.",Base_Mineral.png,abundant,5303,0,0,5303,0
4869,8581,10093,112,Amphoteric Substances,"Amphoteric Substances are refined and crafted into components, modules and other items.",Amphoteric_Substances.png,common,2084,0,0,2084,0
4869,8582,10093,120,Metamagnetic Ore,"Metamagnetic Ore is refined and crafted into components, modules and other items.",Metamagnetic_Ore.png,uncommon,2357,0,0,2357,0
4869,8583,10093,106,Elastomers,"Elastomers are refined and crafted into components, modules and other items.",Elastomers.png,abundant,5991,0,0,5991,0
4869,8584,10093,107,H2O,"H2O is refined and crafted into components, modules and other items.",H20.png,abundant,4279,0,0,4279,0
4871,3037,3995,115,Nanofluids,"Nanofluids are refined and crafted into components, modules and other items.",Nanofluids.png,common,1229,0,0,1229,0
4871,3367,3995,115,Nanofluids,"Nanofluids are refined and crafted into components, modules and other items.",Nanofluids.png,common,2170,0,0,2170,0
4871,7507,3995,106,Elastomers,"Elastomers are refined and crafted into components, modules and other items.",Elastomers.png,abundant,5220,522,0,4698,522
4878,32,4002,53,Ignis Ore,"Ignis Ore is refined and crafted into components, modules and other items.",Ignis_Ore.png,rare,783,783,0,0,783
4878,112,4002,105,Silicates,"Silicates are refined and crafted into components, modules and other items.",Silicates.png,abundant,4083,0,0,4083,0
4878,151,4002,112,Amphoteric Substances,"Amphoteric Substances are refined and crafted into components, modules and other items.",Amphoteric_Substances.png,common,2970,0,0,2970,0
4878,152,4002,107,H2O,"H2O is refined and crafted into components, modules and other items.",H20.png,abundant,2956,0,0,2956,0
4878,375,10102,115,Nanofluids,"Nanofluids are refined and crafted into components, modules and other items.",Nanofluids.png,common,1399,0,0,1399,0
4878,411,10102,53,Ignis Ore,"Ignis Ore is refined and crafted into components, modules and other items.",Ignis_Ore.png,rare,1369,1369,0,0,1369
4878,412,10102,42,Base Minerals,"Base Minerals are refined and crafted into components, modules and other items.",Base_Mineral.png,abundant,2450,0,0,2450,0
4878,1507,10102,105,Silicates,"Silicates are refined and crafted into components, modules and other items.",Silicates.png,abundant,4152,0,0,4152,0
4879,3063,4003,53,Ignis Ore,"Ignis Ore is refined and crafted into components, modules and other items.",Ignis_Ore.png,rare,605,0,0,605,0
4879,3064,4003,117,Yprasium,"Yprasium is refined and crafted into components, modules and other items.",Yprasium.png,uncommon,2967,0,0,2967,0
4879,3065,4003,52,Organic Compounds,"Organic Compounds are refined and crafted into components, modules and other items.",Organic_Compound.png,common,4101,0,0,4101,0
4881,3261,4005,115,Nanofluids,"Nanofluids are refined and crafted into components, modules and other items.",Nanofluids.png,common,1096,0,0,1096,0
4881,3262,4005,114,Ectopolymers,"Ectopolymers are refined and crafted into components, modules and other items.",Ectopolymers.png,common,2158,0,0,2158,0
4881,3263,4005,115,Nanofluids,"Nanofluids are refined and crafted into components, modules and other items.",Nanofluids.png,common,5635,0,0,5635,0
4881,3264,4005,52,Organic Compounds,"Organic Compounds are refined and crafted into components, modules and other items.",Organic_Compound.png,common,4726,0,0,4726,0
4891,7663,4015,107,H2O,"H2O is refined and crafted into components, modules and other items.",H20.png,abundant,5030,0,0,5030,0
4891,17166,4015,112,Amphoteric Substances,"Amphoteric Substances are refined and crafted into components, modules and other items.",Amphoteric_Substances.png,common,1477,0,0,1477,0
4891,18548,4015,107,H2O,"H2O is refined and crafted into components, modules and other items.",H20.png,abundant,2907,0,0,2907,0
4891,18549,4015,107,H2O,"H2O is refined and crafted into components, modules and other items.",H20.png,abundant,2920,0,0,2920,0
4894,2216,4018,128,Tchaikovium,"Tchaikovium is refined and crafted into components, modules and other items.",Tchaikovium.png,rare,620,0,0,620,0
4894,2217,4018,113,Aerogens,"Aerogens are refined and crafted into components, modules and other items.",Aerogens.png,common,2259,0,0,2259,0
4894,2494,4018,121,Hypoatomic Substances,"Hypoatomic Substances are refined and crafted into components, modules and other items.",Hypoatomic_Substances.png,uncommon,5308,0,0,5308,0
4894,2495,4018,115,Nanofluids,"Nanofluids are refined and crafted into components, modules and other items.",Nanofluids.png,common,5701,0,0,5701,0
4897,18756,4021,41,Xensium,"Xensium is refined and crafted into components, modules and other items.",Xensium.png,uncommon,1280,0,0,1280,0
4897,18844,4021,127,Microorganisms,"Microorganisms are refined and crafted into components, modules and other items.",Microorganism.png,rare,1370,0,0,1370,0
4897,18845,4021,106,Elastomers,"Elastomers are refined and crafted into components, modules and other items.",Elastomers.png,abundant,4139,0,0,4139,0
4899,1641,4023,126,Bruma Particles,"Bruma Particles are refined and crafted into components, modules and other items.",Bruma_Particle.png,rare,855,855,0,0,855
4899,1642,4023,42,Base Minerals,"Base Minerals are refined and crafted into components, modules and other items.",Base_Mineral.png,abundant,4951,0,0,4951,0
4899,3298,4023,113,Aerogens,"Aerogens are refined and crafted into components, modules and other items.",Aerogens.png,common,2255,0,0,2255,0
4899,14521,10123,54,Hyperspecular Crystals,"Hyperspecular Crystals are refined and crafted into components, modules and other items.",Hyperspecular_Crystals.png,uncommon,2567,0,0,2567,0
4899,15413,10123,109,Titanium,"Titanium is refined and crafted into components, modules and other items.",Titanium.png,common,1015,0,0,1015,0
4899,20962,10123,107,H2O,"H2O is refined and crafted into components, modules and other items.",H20.png,abundant,5374,0,0,5374,0
4900,3718,4024,126,Bruma Particles,"Bruma Particles are refined and crafted into components, modules and other items.",Bruma_Particle.png,rare,718,0,0,718,0
4900,3719,4024,113,Aerogens,"Aerogens are refined and crafted into components, modules and other items.",Aerogens.png,common,2175,0,0,2175,0
4900,3720,4024,42,Base Minerals,"Base Minerals are refined and crafted into components, modules and other items.",Base_Mineral.png,abundant,5782,0,0,5782,0
4909,18555,4033,112,Amphoteric Substances,"Amphoteric Substances are refined and crafted into components, modules and other items.",Amphoteric_Substances.png,common,1225,0,0,1225,0
4909,18558,4033,127,Microorganisms,"Microorganisms are refined and crafted into components, modules and other items.",Microorganism.png,rare,1878,0,0,1878,0
4909,18559,4033,54,Hyperspecular Crystals,"Hyperspecular Crystals are refined and crafted into components, modules and other items.",Hyperspecular_Crystals.png,uncommon,2366,0,0,2366,0
4909,18560,4033,42,Base Minerals,"Base Minerals are refined and crafted into components, modules and other items.",Base_Mineral.png,abundant,5649,0,0,5649,0
4916,7504,4040,42,Base Minerals,"Base Minerals are refined and crafted into components, modules and other items.",Base_Mineral.png,abundant,2726,0,0,2726,0
4916,7797,4040,120,Metamagnetic Ore,"Metamagnetic Ore is refined and crafted into components, modules and other items.",Metamagnetic_Ore.png,uncommon,1459,0,0,1459,0
4916,7806,4040,42,Base Minerals,"Base Minerals are refined and crafted into components, modules and other items.",Base_Mineral.png,abundant,4516,0,0,4516,0
4921,5315,4045,120,Metamagnetic Ore,"Metamagnetic Ore is refined and crafted into components, modules and other items.",Metamagnetic_Ore.png,uncommon,2811,0,0,2811,0
4921,5316,4045,123,Neolysium,"Neolysium is refined and crafted into components, modules and other items.",Neolysium.png,uncommon,1409,0,0,1409,0
4921,5317,4045,105,Silicates,"Silicates are refined and crafted into components, modules and other items.",Silicates.png,abundant,5227,0,0,5227,0
4922,421,4046,54,Hyperspecular Crystals,"Hyperspecular Crystals are refined and crafted into components, modules and other items.",Hyperspecular_Crystals.png,uncommon,2573,0,0,2573,0
4922,491,4046,106,Elastomers,"Elastomers are refined and crafted into components, modules and other items.",Elastomers.png,abundant,4507,0,0,4507,0
4922,526,4046,54,Hyperspecular Crystals,"Hyperspecular Crystals are refined and crafted into components, modules and other items.",Hyperspecular_Crystals.png,uncommon,1267,0,0,1267,0
4922,18078,10146,127,Microorganisms,"Microorganisms are refined and crafted into components, modules and other items.",Microorganism.png,rare,745,0,0,745,0
4922,18079,10146,110,Plutonium,"Plutonium is refined and crafted into components, modules and other items.",Plutonium.png,common,2355,0,0,2355,0
4922,18080,10146,42,Base Minerals,"Base Minerals are refined and crafted into components, modules and other items.",Base_Mineral.png,abundant,5573,0,0,5573,0
4927,1796,4051,123,Neolysium,"Neolysium is refined and crafted into components, modules and other items.",Neolysium.png,uncommon,1479,0,0,1479,0
4927,1797,4051,113,Aerogens,"Aerogens are refined and crafted into components, modules and other items.",Aerogens.png,common,2337,0,0,2337,0
4927,1798,4051,105,Silicates,"Silicates are refined and crafted into components, modules and other items.",Silicates.png,abundant,5001,0,0,5001,0
4932,18217,4056,123,Neolysium,"Neolysium is refined and crafted into components, modules and other items.",Neolysium.png,uncommon,1447,0,0,1447,0
4933,2714,4057,40,Polymetals,"Polymetals are refined and crafted into components, modules and other items.",Polymetals.png,common,5702,0,0,5702,0
4933,2715,4057,106,Elastomers,"Elastomers are refined and crafted into components, modules and other items.",Elastomers.png,abundant,5171,0,0,5171,0
4933,3338,4057,117,Yprasium,"Yprasium is refined and crafted into components, modules and other items.",Yprasium.png,uncommon,2134,0,0,2134,0
4933,3884,4057,127,Microorganisms,"Microorganisms are refined and crafted into components, modules and other items.",Microorganism.png,rare,889,889,0,0,889
4933,4380,10157,105,Silicates,"Silicates are refined and crafted into components, modules and other items.",Silicates.png,abundant,2625,0,0,2625,0
4933,4587,10157,118,Platinyx,"Platinyx is refined and crafted into components, modules and other items.",Platinyx.png,uncommon,4250,0,0,4250,0
4933,4588,10157,126,Bruma Particles,"Bruma Particles are refined and crafted into components, modules and other items.",Bruma_Particle.png,rare,687,0,0,687,0
4942,2351,4066,53,Ignis Ore,"Ignis Ore is refined and crafted into components, modules and other items.",Ignis_Ore.png,rare,644,0,0,644,0
4942,2352,4066,113,Aerogens,"Aerogens are refined and crafted into components, modules and other items.",Aerogens.png,common,5450,0,0,5450,0
4946,218,4070,107,H2O,"H2O is refined and crafted into components, modules and other items.",H20.png,abundant,5171,0,0,5171,0
4946,231,4070,119,Novis Compounds,"Novis Compounds are refined and crafted into components, modules and other items.",Novis_Compound.png,uncommon,1048,0,0,1048,0
4946,243,4070,105,Silicates,"Silicates are refined and crafted into components, modules and other items.",Silicates.png,abundant,2920,0,0,2920,0
4947,8756,4071,53,Ignis Ore,"Ignis Ore is refined and crafted into components, modules and other items.",Ignis_Ore.png,rare,875,0,0,875,0
4947,8757,4071,120,Metamagnetic Ore,"Metamagnetic Ore is refined and crafted into components, modules and other items.",Metamagnetic_Ore.png,uncommon,2512,0,0,2512,0
4947,8758,10171,109,Titanium,"Titanium is refined and crafted into components, modules and other items.",Titanium.png,common,4523,0,0,4523,0
4949,2157,4073,128,Tchaikovium,"Tchaikovium is refined and crafted into components, modules and other items.",Tchaikovium.png,rare,634,0,0,634,0
4949,2158,4073,40,Polymetals,"Polymetals are refined and crafted into components, modules and other items.",Polymetals.png,common,2006,0,0,2006,0
4949,2159,4073,106,Elastomers,"Elastomers are refined and crafted into components, modules and other items.",Elastomers.png,abundant,5411,0,0,5411,0
4949,2160,4073,107,H2O,"H2O is refined and crafted into components, modules and other items.",H20.png,abundant,5059,0,0,5059,0
4949,3558,10173,118,Platinyx,"Platinyx is refined and crafted into components, modules and other items.",Platinyx.png,uncommon,1484,0,0,1484,0
4949,3559,10173,40,Polymetals,"Polymetals are refined and crafted into components, modules and other items.",Polymetals.png,common,2112,0,0,2112,0
4949,3560,10173,106,Elastomers,"Elastomers are refined and crafted into components, modules and other items.",Elastomers.png,abundant,5849,0,0,5849,0
4951,183,4075,52,Organic Compounds,"Organic Compounds are refined and crafted into components, modules and other items.",Organic_Compound.png,common,1142,0,0,1142,0
4951,326,4075,105,Silicates,"Silicates are refined and crafted into components, modules and other items.",Silicates.png,abundant,5074,0,0,5074,0
4951,566,4075,112,Amphoteric Substances,"Amphoteric Substances are refined and crafted into components, modules and other items.",Amphoteric_Substances.png,common,2093,0,0,2093,0
4955,18,4079,112,Amphoteric Substances,"Amphoteric Substances are refined and crafted into components, modules and other items.",Amphoteric_Substances.png,common,1237,0,0,1237,0
4955,29,4079,123,Neolysium,"Neolysium is refined and crafted into components, modules and other items.",Neolysium.png,uncommon,2279,0,0,2279,0
4955,30,4079,123,Neolysium,"Neolysium is refined and crafted into components, modules and other items.",Neolysium.png,uncommon,2252,0,0,2252,0
4955,220,4079,105,Silicates,"Silicates are refined and crafted into components, modules and other items.",Silicates.png,abundant,5150,1030,0,4120,1030
4955,221,4079,42,Base Minerals,"Base Minerals are refined and crafted into components, modules and other items.",Base_Mineral.png,abundant,5189,519,0,4670,519
4955,726,10179,117,Yprasium,"Yprasium is refined and crafted into components, modules and other items.",Yprasium.png,uncommon,1481,0,0,1481,0
4955,771,10179,109,Titanium,"Titanium is refined and crafted into components, modules and other items.",Titanium.png,common,2783,2088,0,695,2088
4955,4272,10179,105,Silicates,"Silicates are refined and crafted into components, modules and other items.",Silicates.png,abundant,4524,0,0,4524,0
4955,4273,10179,112,Amphoteric Substances,"Amphoteric Substances are refined and crafted into components, modules and other items.",Amphoteric_Substances.png,common,5496,0,0,5496,0
4959,10796,4083,126,Bruma Particles,"Bruma Particles are refined and crafted into components, modules and other items.",Bruma_Particle.png,rare,827,0,0,827,0
4959,11188,4083,110,Plutonium,"Plutonium is refined and crafted into components, modules and other items.",Plutonium.png,common,2713,0,0,2713,0
4959,13435,4083,106,Elastomers,"Elastomers are refined and crafted into components, modules and other items.",Elastomers.png,abundant,4223,0,0,4223,0
4959,17990,10183,113,Aerogens,"Aerogens are refined and crafted into components, modules and other items.",Aerogens.png,common,5290,0,0,5290,0
4967,2712,4091,113,Aerogens,"Aerogens are refined and crafted into components, modules and other items.",Aerogens.png,common,5556,0,0,5556,0
4967,2713,4091,106,Elastomers,"Elastomers are refined and crafted into components, modules and other items.",Elastomers.png,abundant,5199,0,0,5199,0
4967,3339,4091,105,Silicates,"Silicates are refined and crafted into components, modules and other items.",Silicates.png,abundant,2759,0,0,2759,0
4967,3883,4091,126,Bruma Particles,"Bruma Particles are refined and crafted into components, modules and other items.",Bruma_Particle.png,rare,746,0,0,746,0
4967,3886,10191,126,Bruma Particles,"Bruma Particles are refined and crafted into components, modules and other items.",Bruma_Particle.png,rare,1373,0,0,1373,0
4967,4530,10191,106,Elastomers,"Elastomers are refined and crafted into components, modules and other items.",Elastomers.png,abundant,5671,0,0,5671,0
4967,4586,10191,123,Neolysium,"Neolysium is refined and crafted into components, modules and other items.",Neolysium.png,uncommon,1233,0,0,1233,0
4970,1373,4094,113,Aerogens,"Aerogens are refined and crafted into components, modules and other items.",Aerogens.png,common,2480,0,0,2480,0
4970,2859,4094,41,Xensium,"Xensium is refined and crafted into components, modules and other items.",Xensium.png,uncommon,1404,0,0,1404,0
4970,2860,4094,107,H2O,"H2O is refined and crafted into components, modules and other items.",H20.png,abundant,5216,0,0,5216,0
4975,15810,4099,42,Base Minerals,"Base Minerals are refined and crafted into components, modules and other items.",Base_Mineral.png,abundant,2474,0,0,2474,0
4975,16866,4099,42,Base Minerals,"Base Minerals are refined and crafted into components, modules and other items.",Base_Mineral.png,abundant,5493,0,0,5493,0
4979,1240,4103,114,Ectopolymers,"Ectopolymers are refined and crafted into components, modules and other items.",Ectopolymers.png,common,1413,0,0,1413,0
4979,1241,4103,110,Plutonium,"Plutonium is refined and crafted into components, modules and other items.",Plutonium.png,common,1206,0,0,1206,0
4979,1260,4103,119,Novis Compounds,"Novis Compounds are refined and crafted into components, modules and other items.",Novis_Compound.png,uncommon,2878,0,0,2878,0
4979,1261,4103,42,Base Minerals,"Base Minerals are refined and crafted into components, modules and other items.",Base_Mineral.png,abundant,5860,0,0,5860,0
4979,18081,10203,127,Microorganisms,"Microorganisms are refined and crafted into components, modules and other items.",Microorganism.png,rare,716,0,0,716,0
4979,18082,10203,107,H2O,"H2O is refined and crafted into components, modules and other items.",H20.png,abundant,2920,0,0,2920,0
4979,18083,10203,114,Ectopolymers,"Ectopolymers are refined and crafted into components, modules and other items.",Ectopolymers.png,common,4918,0,0,4918,0
4981,17795,4105,112,Amphoteric Substances,"Amphoteric Substances are refined and crafted into components, modules and other items.",Amphoteric_Substances.png,common,1142,0,0,1142,0
4981,17991,4105,112,Amphoteric Substances,"Amphoteric Substances are refined and crafted into components, modules and other items.",Amphoteric_Substances.png,common,5025,0,0,5025,0
4982,12904,4106,115,Nanofluids,"Nanofluids are refined and crafted into components, modules and other items.",Nanofluids.png,common,2693,0,0,2693,0
4982,12905,4106,42,Base Minerals,"Base Minerals are refined and crafted into components, modules and other items.",Base_Mineral.png,abundant,4138,0,0,4138,0
4982,12906,4106,114,Ectopolymers,"Ectopolymers are refined and crafted into components, modules and other items.",Ectopolymers.png,common,5348,0,0,5348,0
4982,14126,4106,114,Ectopolymers,"Ectopolymers are refined and crafted into components, modules and other items.",Ectopolymers.png,common,1429,0,0,1429,0
4984,18910,4108,127,Microorganisms,"Microorganisms are refined and crafted into components, modules and other items.",Microorganism.png,rare,602,0,0,602,0
4984,18911,4108,40,Polymetals,"Polymetals are refined and crafted into components, modules and other items.",Polymetals.png,common,2596,0,0,2596,0
4984,19042,4108,40,Polymetals,"Polymetals are refined and crafted into components, modules and other items.",Polymetals.png,common,5781,0,0,5781,0
4984,19043,4108,107,H2O,"H2O is refined and crafted into components, modules and other items.",H20.png,abundant,4992,0,0,4992,0
4988,2039,4112,112,Amphoteric Substances,"Amphoteric Substances are refined and crafted into components, modules and other items.",Amphoteric_Substances.png,common,1262,0,0,1262,0
4988,3713,4112,117,Yprasium,"Yprasium is refined and crafted into components, modules and other items.",Yprasium.png,uncommon,2108,0,0,2108,0
4988,9279,4112,42,Base Minerals,"Base Minerals are refined and crafted into components, modules and other items.",Base_Mineral.png,abundant,4792,0,0,4792,0
4988,9280,10212,112,Amphoteric Substances,"Amphoteric Substances are refined and crafted into components, modules and other items.",Amphoteric_Substances.png,common,4019,0,0,4019,0
4992,2767,4116,54,Hyperspecular Crystals,"Hyperspecular Crystals are refined and crafted into components, modules and other items.",Hyperspecular_Crystals.png,uncommon,1030,0,0,1030,0
4992,2768,4116,110,Plutonium,"Plutonium is refined and crafted into components, modules and other items.",Plutonium.png,common,2036,0,0,2036,0
4992,2769,4116,42,Base Minerals,"Base Minerals are refined and crafted into components, modules and other items.",Base_Mineral.png,abundant,4161,0,0,4161,0
4992,3765,10216,128,Tchaikovium,"Tchaikovium is refined and crafted into components, modules and other items.",Tchaikovium.png,rare,678,0,0,678,0
4992,3766,10216,109,Titanium,"Titanium is refined and crafted into components, modules and other items.",Titanium.png,common,2519,0,0,2519,0
4992,3767,10216,42,Base Minerals,"Base Minerals are refined and crafted into components, modules and other items.",Base_Mineral.png,abundant,5422,0,0,5422,0
4993,1374,4117,115,Nanofluids,"Nanofluids are refined and crafted into components, modules and other items.",Nanofluids.png,common,2894,0,0,2894,0
4993,1375,4117,115,Nanofluids,"Nanofluids are refined and crafted into components, modules and other items.",Nanofluids.png,common,2732,0,0,2732,0
4993,2627,4117,53,Ignis Ore,"Ignis Ore is refined and crafted into components, modules and other items.",Ignis_Ore.png,rare,873,0,0,873,0
4993,2628,4117,41,Xensium,"Xensium is refined and crafted into components, modules and other items.",Xensium.png,uncommon,1013,0,0,1013,0
4993,2629,4117,115,Nanofluids,"Nanofluids are refined and crafted into components, modules and other items.",Nanofluids.png,common,4496,0,0,4496,0
4994,2709,4118,42,Base Minerals,"Base Minerals are refined and crafted into components, modules and other items.",Base_Mineral.png,abundant,5581,0,0,5581,0
4994,3142,4118,121,Hypoatomic Substances,"Hypoatomic Substances are refined and crafted into components, modules and other items.",Hypoatomic_Substances.png,uncommon,2138,0,0,2138,0
4994,3893,4118,126,Bruma Particles,"Bruma Particles are refined and crafted into components, modules and other items.",Bruma_Particle.png,rare,768,0,0,768,0
4994,2710,10218,113,Aerogens,"Aerogens are refined and crafted into components, modules and other items.",Aerogens.png,common,2759,0,0,2759,0
4994,2711,10218,41,Xensium,"Xensium is refined and crafted into components, modules and other items.",Xensium.png,uncommon,2941,0,0,2941,0
4994,4428,10218,127,Microorganisms,"Microorganisms are refined and crafted into components, modules and other items.",Microorganism.png,rare,836,0,0,836,0
4994,4531,10218,105,Silicates,"Silicates are refined and crafted into components, modules and other items.",Silicates.png,abundant,5605,0,0,5605,0
4997,1919,4121,42,Base Minerals,"Base Minerals are refined and crafted into components, modules and other items.",Base_Mineral.png,abundant,4998,0,0,4998,0
4997,1920,4121,120,Metamagnetic Ore,"Metamagnetic Ore is refined and crafted into components, modules and other items.",Metamagnetic_Ore.png,uncommon,1377,0,0,1377,0
4997,2068,4121,110,Plutonium,"Plutonium is refined and crafted into components, modules and other items.",Plutonium.png,common,2996,0,0,2996,0
5006,1220,4130,41,Xensium,"Xensium is refined and crafted into components, modules and other items.",Xensium.png,uncommon,4567,0,0,4567,0
5006,1552,4130,41,Xensium,"Xensium is refined and crafted into components, modules and other items.",Xensium.png,uncommon,2618,0,0,2618,0
5006,3894,4130,41,Xensium,"Xensium is refined and crafted into components, modules and other items.",Xensium.png,uncommon,1389,0,0,1389,0
5006,4345,10230,127,Microorganisms,"Microorganisms are refined and crafted into components, modules and other items.",Microorganism.png,rare,875,875,0,0,875
5006,4347,10230,107,H2O,"H2O is refined and crafted into components, modules and other items.",H20.png,abundant,2158,0,0,2158,0
5006,4594,10230,107,H2O,"H2O is refined and crafted into components, modules and other items.",H20.png,abundant,4892,0,0,4892,0
5008,188,4132,121,Hypoatomic Substances,"Hypoatomic Substances are refined and crafted into components, modules and other items.",Hypoatomic_Substances.png,uncommon,1131,0,0,1131,0
5008,617,4132,105,Silicates,"Silicates are refined and crafted into components, modules and other items.",Silicates.png,abundant,5885,0,0,5885,0
5008,1485,4132,113,Aerogens,"Aerogens are refined and crafted into components, modules and other items.",Aerogens.png,common,2730,0,0,2730,0
5008,1486,10232,118,Platinyx,"Platinyx is refined and crafted into components, modules and other items.",Platinyx.png,uncommon,1264,0,0,1264,0
5008,3307,10232,126,Bruma Particles,"Bruma Particles are refined and crafted into components, modules and other items.",Bruma_Particle.png,rare,1304,1304,0,0,1304
5008,3315,10232,115,Nanofluids,"Nanofluids are refined and crafted into components, modules and other items.",Nanofluids.png,common,4829,4829,0,0,4829
5011,3721,4135,118,Platinyx,"Platinyx is refined and crafted into components, modules and other items.",Platinyx.png,uncommon,1113,0,0,1113,0
5011,3722,4135,127,Microorganisms,"Microorganisms are refined and crafted into components, modules and other items.",Microorganism.png,rare,1527,0,0,1527,0
5011,3723,4135,42,Base Minerals,"Base Minerals are refined and crafted into components, modules and other items.",Base_Mineral.png,abundant,5282,0,0,5282,0
5013,373,4137,106,Elastomers,"Elastomers are refined and crafted into components, modules and other items.",Elastomers.png,abundant,5645,0,0,5645,0
5013,391,4137,114,Ectopolymers,"Ectopolymers are refined and crafted into components, modules and other items.",Ectopolymers.png,common,2064,0,0,2064,0
5013,395,4137,114,Ectopolymers,"Ectopolymers are refined and crafted into components, modules and other items.",Ectopolymers.png,common,1167,0,0,1167,0
5013,396,4137,115,Nanofluids,"Nanofluids are refined and crafted into components, modules and other items.",Nanofluids.png,common,1274,0,0,1274,0
5013,4072,10237,53,Ignis Ore,"Ignis Ore is refined and crafted into components, modules and other items.",Ignis_Ore.png,rare,698,0,0,698,0
5013,4073,10237,53,Ignis Ore,"Ignis Ore is refined and crafted into components, modules and other items.",Ignis_Ore.png,rare,856,0,0,856,0
5013,4074,10237,42,Base Minerals,"Base Minerals are refined and crafted into components, modules and other items.",Base_Mineral.png,abundant,2549,0,0,2549,0
5013,4075,10237,105,Silicates,"Silicates are refined and crafted into components, modules and other items.",Silicates.png,abundant,4401,0,0,4401,0
5015,14127,4139,106,Elastomers,"Elastomers are refined and crafted into components, modules and other items.",Elastomers.png,abundant,4074,0,0,4074,0
5015,14489,4139,118,Platinyx,"Platinyx is refined and crafted into components, modules and other items.",Platinyx.png,uncommon,2221,0,0,2221,0
5015,15809,4139,53,Ignis Ore,"Ignis Ore is refined and crafted into components, modules and other items.",Ignis_Ore.png,rare,680,0,0,680,0
5016,3724,4140,40,Polymetals,"Polymetals are refined and crafted into components, modules and other items.",Polymetals.png,common,1102,0,0,1102,0
5016,3725,4140,118,Platinyx,"Platinyx is refined and crafted into components, modules and other items.",Platinyx.png,uncommon,2854,0,0,2854,0
5016,3726,4140,106,Elastomers,"Elastomers are refined and crafted into components, modules and other items.",Elastomers.png,abundant,5229,0,0,5229,0
5021,8070,4145,126,Bruma Particles,"Bruma Particles are refined and crafted into components, modules and other items.",Bruma_Particle.png,rare,708,0,0,708,0
5021,10429,4145,113,Aerogens,"Aerogens are refined and crafted into components, modules and other items.",Aerogens.png,common,2382,0,0,2382,0
5021,10430,4145,106,Elastomers,"Elastomers are refined and crafted into components, modules and other items.",Elastomers.png,abundant,4512,0,0,4512,0
5021,17227,10245,115,Nanofluids,"Nanofluids are refined and crafted into components, modules and other items.",Nanofluids.png,common,4449,0,0,4449,0
5021,17228,10245,106,Elastomers,"Elastomers are refined and crafted into components, modules and other items.",Elastomers.png,abundant,2629,0,0,2629,0
5021,18032,10245,121,Hypoatomic Substances,"Hypoatomic Substances are refined and crafted into components, modules and other items.",Hypoatomic_Substances.png,uncommon,1288,0,0,1288,0
5022,906,4146,52,Organic Compounds,"Organic Compounds are refined and crafted into components, modules and other items.",Organic_Compound.png,common,2844,0,0,2844,0
5022,935,4146,106,Elastomers,"Elastomers are refined and crafted into components, modules and other items.",Elastomers.png,abundant,4416,0,0,4416,0
5022,986,4146,41,Xensium,"Xensium is refined and crafted into components, modules and other items.",Xensium.png,uncommon,1348,0,0,1348,0
5023,1376,4147,52,Organic Compounds,"Organic Compounds are refined and crafted into components, modules and other items.",Organic_Compound.png,common,2922,0,0,2922,0
5023,2625,4147,114,Ectopolymers,"Ectopolymers are refined and crafted into components, modules and other items.",Ectopolymers.png,common,1017,0,0,1017,0
5023,2626,4147,107,H2O,"H2O is refined and crafted into components, modules and other items.",H20.png,abundant,5437,0,0,5437,0
5032,3727,4156,127,Microorganisms,"Microorganisms are refined and crafted into components, modules and other items.",Microorganism.png,rare,848,0,0,848,0
5032,3728,4156,52,Organic Compounds,"Organic Compounds are refined and crafted into components, modules and other items.",Organic_Compound.png,common,2842,0,0,2842,0
5032,3729,4156,107,H2O,"H2O is refined and crafted into components, modules and other items.",H20.png,abundant,4926,0,0,4926,0
5034,2161,4158,52,Organic Compounds,"Organic Compounds are refined and crafted into components, modules and other items.",Organic_Compound.png,common,1393,0,0,1393,0
5034,2162,4158,52,Organic Compounds,"Organic Compounds are refined and crafted into components, modules and other items.",Organic_Compound.png,common,2210,0,0,2210,0
5034,2766,4158,107,H2O,"H2O is refined and crafted into components, modules and other items.",H20.png,abundant,4655,0,0,4655,0
5034,4149,10258,114,Ectopolymers,"Ectopolymers are refined and crafted into components, modules and other items.",Ectopolymers.png,common,1147,0,0,1147,0
5034,4150,10258,105,Silicates,"Silicates are refined and crafted into components, modules and other items.",Silicates.png,abundant,2871,0,0,2871,0
5034,4151,10258,107,H2O,"H2O is refined and crafted into components, modules and other items.",H20.png,abundant,4267,0,0,4267,0
5036,15182,4160,53,Ignis Ore,"Ignis Ore is refined and crafted into components, modules and other items.",Ignis_Ore.png,rare,614,0,0,614,0
5037,1873,4161,54,Hyperspecular Crystals,"Hyperspecular Crystals are refined and crafted into components, modules and other items.",Hyperspecular_Crystals.png,uncommon,1190,0,0,1190,0
5037,1918,4161,42,Base Minerals,"Base Minerals are refined and crafted into components, modules and other items.",Base_Mineral.png,abundant,5629,0,0,5629,0
5037,2067,4161,42,Base Minerals,"Base Minerals are refined and crafted into components, modules and other items.",Base_Mineral.png,abundant,2017,0,0,2017,0
5052,13639,4176,128,Tchaikovium,"Tchaikovium is refined and crafted into components, modules and other items.",Tchaikovium.png,rare,601,0,0,601,0
5052,14100,4176,42,Base Minerals,"Base Minerals are refined and crafted into components, modules and other items.",Base_Mineral.png,abundant,5527,0,0,5527,0
5059,482,4183,126,Bruma Particles,"Bruma Particles are refined and crafted into components, modules and other items.",Bruma_Particle.png,rare,1665,1665,0,0,1665
5059,654,4183,106,Elastomers,"Elastomers are refined and crafted into components, modules and other items.",Elastomers.png,abundant,4242,0,0,4242,0
5059,659,4183,127,Microorganisms,"Microorganisms are refined and crafted into components, modules and other items.",Microorganism.png,rare,823,0,0,823,0
5062,4361,4186,112,Amphoteric Substances,"Amphoteric Substances are refined and crafted into components, modules and other items.",Amphoteric_Substances.png,common,4403,0,0,4403,0
5062,4362,4186,54,Hyperspecular Crystals,"Hyperspecular Crystals are refined and crafted into components, modules and other items.",Hyperspecular_Crystals.png,uncommon,1116,0,0,1116,0
5062,4363,4186,107,H2O,"H2O is refined and crafted into components, modules and other items.",H20.png,abundant,2797,0,0,2797,0
5064,2729,4188,42,Base Minerals,"Base Minerals are refined and crafted into components, modules and other items.",Base_Mineral.png,abundant,2065,0,0,2065,0
5064,3136,4188,128,Tchaikovium,"Tchaikovium is refined and crafted into components, modules and other items.",Tchaikovium.png,rare,891,0,0,891,0
5064,4490,4188,105,Silicates,"Silicates are refined and crafted into components, modules and other items.",Silicates.png,abundant,4474,0,0,4474,0
5064,2811,10288,118,Platinyx,"Platinyx is refined and crafted into components, modules and other items.",Platinyx.png,uncommon,1369,0,0,1369,0
5064,4434,10288,120,Metamagnetic Ore,"Metamagnetic Ore is refined and crafted into components, modules and other items.",Metamagnetic_Ore.png,uncommon,2618,0,0,2618,0
5064,4435,10288,107,H2O,"H2O is refined and crafted into components, modules and other items.",H20.png,abundant,4502,0,0,4502,0
5066,8055,4190,109,Titanium,"Titanium is refined and crafted into components, modules and other items.",Titanium.png,common,2411,0,0,2411,0
5072,14622,4196,128,Tchaikovium,"Tchaikovium is refined and crafted into components, modules and other items.",Tchaikovium.png,rare,781,0,0,781,0
5072,14623,4196,114,Ectopolymers,"Ectopolymers are refined and crafted into components, modules and other items.",Ectopolymers.png,common,2264,0,0,2264,0
5072,14624,4196,42,Base Minerals,"Base Minerals are refined and crafted into components, modules and other items.",Base_Mineral.png,abundant,3000,0,0,3000,0
5072,14625,4196,106,Elastomers,"Elastomers are refined and crafted into components, modules and other items.",Elastomers.png,abundant,4720,0,0,4720,0
5077,1528,4201,42,Base Minerals,"Base Minerals are refined and crafted into components, modules and other items.",Base_Mineral.png,abundant,4979,0,0,4979,0
5077,1529,4201,106,Elastomers,"Elastomers are refined and crafted into components, modules and other items.",Elastomers.png,abundant,4651,0,0,4651,0
5077,3926,4201,54,Hyperspecular Crystals,"Hyperspecular Crystals are refined and crafted into components, modules and other items.",Hyperspecular_Crystals.png,uncommon,2888,0,0,2888,0
5077,4256,4201,54,Hyperspecular Crystals,"Hyperspecular Crystals are refined and crafted into components, modules and other items.",Hyperspecular_Crystals.png,uncommon,1420,0,0,1420,0
5077,4758,10301,110,Plutonium,"Plutonium is refined and crafted into components, modules and other items.",Plutonium.png,common,2131,0,0,2131,0
5077,7511,10301,110,Plutonium,"Plutonium is refined and crafted into components, modules and other items.",Plutonium.png,common,4542,0,0,4542,0
5077,8189,10301,119,Novis Compounds,"Novis Compounds are refined and crafted into components, modules and other items.",Novis_Compound.png,uncommon,1404,0,0,1404,0
5081,16503,4205,54,Hyperspecular Crystals,"Hyperspecular Crystals are refined and crafted into components, modules and other items.",Hyperspecular_Crystals.png,uncommon,2070,0,0,2070,0
5081,17797,4205,114,Ectopolymers,"Ectopolymers are refined and crafted into components, modules and other items.",Ectopolymers.png,common,5410,0,0,5410,0
5082,3730,4206,126,Bruma Particles,"Bruma Particles are refined and crafted into components, modules and other items.",Bruma_Particle.png,rare,855,0,0,855,0
5082,3731,4206,114,Ectopolymers,"Ectopolymers are refined and crafted into components, modules and other items.",Ectopolymers.png,common,2594,0,0,2594,0
5082,3732,4206,105,Silicates,"Silicates are refined and crafted into components, modules and other items.",Silicates.png,abundant,4804,0,0,4804,0
5084,17461,4208,123,Neolysium,"Neolysium is refined and crafted into components, modules and other items.",Neolysium.png,uncommon,2582,0,0,2582,0
5087,1759,4211,53,Ignis Ore,"Ignis Ore is refined and crafted into components, modules and other items.",Ignis_Ore.png,rare,829,0,0,829,0
5087,1764,4211,120,Metamagnetic Ore,"Metamagnetic Ore is refined and crafted into components, modules and other items.",Metamagnetic_Ore.png,uncommon,2137,0,0,2137,0
5087,1765,4211,120,Metamagnetic Ore,"Metamagnetic Ore is refined and crafted into components, modules and other items.",Metamagnetic_Ore.png,uncommon,2490,0,0,2490,0
5087,2482,4211,107,H2O,"H2O is refined and crafted into components, modules and other items.",H20.png,abundant,4458,0,0,4458,0
5087,10232,10311,40,Polymetals,"Polymetals are refined and crafted into components, modules and other items.",Polymetals.png,common,2096,0,0,2096,0
5090,4370,4214,128,Tchaikovium,"Tchaikovium is refined and crafted into components, modules and other items.",Tchaikovium.png,rare,656,0,0,656,0
5090,4649,4214,42,Base Minerals,"Base Minerals are refined and crafted into components, modules and other items.",Base_Mineral.png,abundant,4552,0,0,4552,0
5090,12215,4214,128,Tchaikovium,"Tchaikovium is refined and crafted into components, modules and other items.",Tchaikovium.png,rare,1809,0,0,1809,0
5094,1585,4218,110,Plutonium,"Plutonium is refined and crafted into components, modules and other items.",Plutonium.png,common,1078,0,0,1078,0
5094,1586,4218,115,Nanofluids,"Nanofluids are refined and crafted into components, modules and other items.",Nanofluids.png,common,5701,0,0,5701,0
5094,1932,4218,114,Ectopolymers,"Ectopolymers are refined and crafted into components, modules and other items.",Ectopolymers.png,common,2472,0,0,2472,0
5094,1933,4218,114,Ectopolymers,"Ectopolymers are refined and crafted into components, modules and other items.",Ectopolymers.png,common,2031,0,0,2031,0
5094,1587,10318,54,Hyperspecular Crystals,"Hyperspecular Crystals are refined and crafted into components, modules and other items.",Hyperspecular_Crystals.png,uncommon,1212,0,0,1212,0
5094,2362,10318,42,Base Minerals,"Base Minerals are refined and crafted into components, modules and other items.",Base_Mineral.png,abundant,5506,0,0,5506,0
5094,2485,10318,119,Novis Compounds,"Novis Compounds are refined and crafted into components, modules and other items.",Novis_Compound.png,uncommon,2933,367,0,2566,367
5098,178,4222,54,Hyperspecular Crystals,"Hyperspecular Crystals are refined and crafted into components, modules and other items.",Hyperspecular_Crystals.png,uncommon,1177,0,0,1177,0
5098,179,4222,52,Organic Compounds,"Organic Compounds are refined and crafted into components, modules and other items.",Organic_Compound.png,common,5593,0,0,5593,0
5098,428,4222,40,Polymetals,"Polymetals are refined and crafted into components, modules and other items.",Polymetals.png,common,2059,0,0,2059,0
5098,1487,10322,53,Ignis Ore,"Ignis Ore is refined and crafted into components, modules and other items.",Ignis_Ore.png,rare,885,885,0,0,885
5098,3327,10322,105,Silicates,"Silicates are refined and crafted into components, modules and other items.",Silicates.png,abundant,4481,0,0,4481,0
5098,4142,10322,117,Yprasium,"Yprasium is refined and crafted into components, modules and other items.",Yprasium.png,uncommon,2998,0,0,2998,0
5100,53,4224,106,Elastomers,"Elastomers are refined and crafted into components, modules and other items.",Elastomers.png,abundant,4579,0,0,4579,0
5100,12874,4224,117,Yprasium,"Yprasium is refined and crafted into components, modules and other items.",Yprasium.png,uncommon,2325,0,0,2325,0
5100,12875,4224,109,Titanium,"Titanium is refined and crafted into components, modules and other items.",Titanium.png,common,2642,0,0,2642,0
5100,17855,4224,53,Ignis Ore,"Ignis Ore is refined and crafted into components, modules and other items.",Ignis_Ore.png,rare,773,0,0,773,0
5103,5380,4227,40,Polymetals,"Polymetals are refined and crafted into components, modules and other items.",Polymetals.png,common,5071,0,0,5071,0
5103,5381,4227,107,H2O,"H2O is refined and crafted into components, modules and other items.",H20.png,abundant,4939,0,0,4939,0
5103,5384,4227,40,Polymetals,"Polymetals are refined and crafted into components, modules and other items.",Polymetals.png,common,2750,0,0,2750,0
5103,5385,4227,127,Microorganisms,"Microorganisms are refined and crafted into components, modules and other items.",Microorganism.png,rare,661,0,0,661,0
5107,1377,4231,115,Nanofluids,"Nanofluids are refined and crafted into components, modules and other items.",Nanofluids.png,common,2840,0,0,2840,0
5107,1378,4231,107,H2O,"H2O is refined and crafted into components, modules and other items.",H20.png,abundant,2316,0,0,2316,0
5107,2623,4231,126,Bruma Particles,"Bruma Particles are refined and crafted into components, modules and other items.",Bruma_Particle.png,rare,683,0,0,683,0
5107,2624,4231,42,Base Minerals,"Base Minerals are refined and crafted into components, modules and other items.",Base_Mineral.png,abundant,4758,0,0,4758,0
5108,3733,4232,52,Organic Compounds,"Organic Compounds are refined and crafted into components, modules and other items.",Organic_Compound.png,common,1058,0,0,1058,0
5108,3734,4232,115,Nanofluids,"Nanofluids are refined and crafted into components, modules and other items.",Nanofluids.png,common,2259,0,0,2259,0
5108,3735,4232,115,Nanofluids,"Nanofluids are refined and crafted into components, modules and other items.",Nanofluids.png,common,4359,0,0,4359,0
5111,3909,4235,115,Nanofluids,"Nanofluids are refined and crafted into components, modules and other items.",Nanofluids.png,common,2338,0,0,2338,0
5111,4287,4235,128,Tchaikovium,"Tchaikovium is refined and crafted into components, modules and other items.",Tchaikovium.png,rare,787,0,0,787,0
5111,8752,4235,113,Aerogens,"Aerogens are refined and crafted into components, modules and other items.",Aerogens.png,common,5457,0,0,5457,0
5111,15186,10335,126,Bruma Particles,"Bruma Particles are refined and crafted into components, modules and other items.",Bruma_Particle.png,rare,684,0,0,684,0
5111,15187,10335,117,Yprasium,"Yprasium is refined and crafted into components, modules and other items.",Yprasium.png,uncommon,2963,0,0,2963,0
5111,15188,10335,105,Silicates,"Silicates are refined and crafted into components, modules and other items.",Silicates.png,abundant,4416,0,0,4416,0
5113,1563,4237,128,Tchaikovium,"Tchaikovium is refined and crafted into components, modules and other items.",Tchaikovium.png,rare,776,0,0,776,0
5113,1564,4237,42,Base Minerals,"Base Minerals are refined and crafted into components, modules and other items.",Base_Mineral.png,abundant,4053,0,0,4053,0
5113,1688,4237,123,Neolysium,"Neolysium is refined and crafted into components, modules and other items.",Neolysium.png,uncommon,2476,0,0,2476,0
5113,18084,10337,119,Novis Compounds,"Novis Compounds are refined and crafted into components, modules and other items.",Novis_Compound.png,uncommon,1192,0,0,1192,0
5113,18085,10337,119,Novis Compounds,"Novis Compounds are refined and crafted into components, modules and other items.",Novis_Compound.png,uncommon,2444,0,0,2444,0
5113,18086,10337,106,Elastomers,"Elastomers are refined and crafted into components, modules and other items.",Elastomers.png,abundant,4212,0,0,4212,0
5114,19044,4238,112,Amphoteric Substances,"Amphoteric Substances are refined and crafted into components, modules and other items.",Amphoteric_Substances.png,common,1222,0,0,1222,0
5114,19075,4238,40,Polymetals,"Polymetals are refined and crafted into components, modules and other items.",Polymetals.png,common,2016,0,0,2016,0
5114,19076,4238,106,Elastomers,"Elastomers are refined and crafted into components, modules and other items.",Elastomers.png,abundant,5136,0,0,5136,0
5117,2619,4241,123,Neolysium,"Neolysium is refined and crafted into components, modules and other items.",Neolysium.png,uncommon,1284,0,0,1284,0
5117,2620,4241,112,Amphoteric Substances,"Amphoteric Substances are refined and crafted into components, modules and other items.",Amphoteric_Substances.png,common,2617,0,0,2617,0
5117,2621,4241,105,Silicates,"Silicates are refined and crafted into components, modules and other items.",Silicates.png,abundant,4353,0,0,4353,0
5117,2622,4241,105,Silicates,"Silicates are refined and crafted into components, modules and other items.",Silicates.png,abundant,5892,0,0,5892,0
5121,16747,4245,119,Novis Compounds,"Novis Compounds are refined and crafted into components, modules and other items.",Novis_Compound.png,uncommon,1070,0,0,1070,0
5121,16748,4245,114,Ectopolymers,"Ectopolymers are refined and crafted into components, modules and other items.",Ectopolymers.png,common,2763,0,0,2763,0
5121,16749,4245,114,Ectopolymers,"Ectopolymers are refined and crafted into components, modules and other items.",Ectopolymers.png,common,4085,0,0,4085,0
5126,8449,4250,52,Organic Compounds,"Organic Compounds are refined and crafted into components, modules and other items.",Organic_Compound.png,common,2035,0,0,2035,0
5126,8452,4250,41,Xensium,"Xensium is refined and crafted into components, modules and other items.",Xensium.png,uncommon,1329,0,0,1329,0
5126,8515,4250,105,Silicates,"Silicates are refined and crafted into components, modules and other items.",Silicates.png,abundant,4178,0,0,4178,0
5126,8317,10350,127,Microorganisms,"Microorganisms are refined and crafted into components, modules and other items.",Microorganism.png,rare,657,0,0,657,0
5126,8416,10350,127,Microorganisms,"Microorganisms are refined and crafted into components, modules and other items.",Microorganism.png,rare,1777,0,0,1777,0
5126,8451,10350,107,H2O,"H2O is refined and crafted into components, modules and other items.",H20.png,abundant,4197,0,0,4197,0
5129,927,4253,41,Xensium,"Xensium is refined and crafted into components, modules and other items.",Xensium.png,uncommon,1420,0,0,1420,0
5129,1057,4253,42,Base Minerals,"Base Minerals are refined and crafted into components, modules and other items.",Base_Mineral.png,abundant,2637,0,0,2637,0
5129,1088,4253,107,H2O,"H2O is refined and crafted into components, modules and other items.",H20.png,abundant,5469,0,0,5469,0
5129,3116,10353,40,Polymetals,"Polymetals are refined and crafted into components, modules and other items.",Polymetals.png,common,1262,0,0,1262,0
5129,7228,10353,41,Xensium,"Xensium is refined and crafted into components, modules and other items.",Xensium.png,uncommon,2967,0,0,2967,0
5129,7921,10353,107,H2O,"H2O is refined and crafted into components, modules and other items.",H20.png,abundant,4547,0,0,4547,0
5130,3736,4254,127,Microorganisms,"Microorganisms are refined and crafted into components, modules and other items.",Microorganism.png,rare,689,0,0,689,0
5130,3737,4254,52,Organic Compounds,"Organic Compounds are refined and crafted into components, modules and other items.",Organic_Compound.png,common,2207,0,0,2207,0
5130,3738,4254,42,Base Minerals,"Base Minerals are refined and crafted into components, modules and other items.",Base_Mineral.png,abundant,5551,0,0,5551,0
5130,3739,4254,52,Organic Compounds,"Organic Compounds are refined and crafted into components, modules and other items.",Organic_Compound.png,common,4920,0,0,4920,0
5131,419,4255,42,Base Minerals,"Base Minerals are refined and crafted into components, modules and other items.",Base_Mineral.png,abundant,5010,0,0,5010,0
5131,552,4255,126,Bruma Particles,"Bruma Particles are refined and crafted into components, modules and other items.",Bruma_Particle.png,rare,710,0,0,710,0
5131,4643,4255,115,Nanofluids,"Nanofluids are refined and crafted into components, modules and other items.",Nanofluids.png,common,2744,0,0,2744,0
5131,4784,10355,115,Nanofluids,"Nanofluids are refined and crafted into components, modules and other items.",Nanofluids.png,common,2874,0,0,2874,0
5131,4785,10355,105,Silicates,"Silicates are refined and crafted into components, modules and other items.",Silicates.png,abundant,2079,0,0,2079,0
5131,8068,10355,126,Bruma Particles,"Bruma Particles are refined and crafted into components, modules and other items.",Bruma_Particle.png,rare,758,0,0,758,0
5131,8069,10355,126,Bruma Particles,"Bruma Particles are refined and crafted into components, modules and other items.",Bruma_Particle.png,rare,3184,0,0,3184,0
5135,17734,4259,42,Base Minerals,"Base Minerals are refined and crafted into components, modules and other items.",Base_Mineral.png,abundant,5152,0,0,5152,0
5135,17953,4259,106,Elastomers,"Elastomers are refined and crafted into components, modules and other items.",Elastomers.png,abundant,2090,0,0,2090,0
5144,2510,4268,117,Yprasium,"Yprasium is refined and crafted into components, modules and other items.",Yprasium.png,uncommon,1153,0,0,1153,0
5144,2563,4268,52,Organic Compounds,"Organic Compounds are refined and crafted into components, modules and other items.",Organic_Compound.png,common,2833,0,0,2833,0
5147,16765,4271,115,Nanofluids,"Nanofluids are refined and crafted into components, modules and other items.",Nanofluids.png,common,1302,0,0,1302,0
5147,16766,4271,115,Nanofluids,"Nanofluids are refined and crafted into components, modules and other items.",Nanofluids.png,common,2396,0,0,2396,0
5147,16767,4271,106,Elastomers,"Elastomers are refined and crafted into components, modules and other items.",Elastomers.png,abundant,4793,0,0,4793,0
5150,3265,4274,119,Novis Compounds,"Novis Compounds are refined and crafted into components, modules and other items.",Novis_Compound.png,uncommon,1141,0,0,1141,0
5150,3266,4274,106,Elastomers,"Elastomers are refined and crafted into components, modules and other items.",Elastomers.png,abundant,2739,0,0,2739,0
5150,3267,4274,112,Amphoteric Substances,"Amphoteric Substances are refined and crafted into components, modules and other items.",Amphoteric_Substances.png,common,4861,0,0,4861,0
5153,3906,4277,113,Aerogens,"Aerogens are refined and crafted into components, modules and other items.",Aerogens.png,common,1247,0,0,1247,0
5153,3907,4277,106,Elastomers,"Elastomers are refined and crafted into components, modules and other items.",Elastomers.png,abundant,2094,0,0,2094,0
5153,3944,4277,107,H2O,"H2O is refined and crafted into components, modules and other items.",H20.png,abundant,5892,0,0,5892,0
5159,3268,4283,127,Microorganisms,"Microorganisms are refined and crafted into components, modules and other items.",Microorganism.png,rare,662,0,0,662,0
5159,3269,4283,52,Organic Compounds,"Organic Compounds are refined and crafted into components, modules and other items.",Organic_Compound.png,common,2407,0,0,2407,0
5159,3270,4283,106,Elastomers,"Elastomers are refined and crafted into components, modules and other items.",Elastomers.png,abundant,5440,0,0,5440,0
5161,18114,4285,126,Bruma Particles,"Bruma Particles are refined and crafted into components, modules and other items.",Bruma_Particle.png,rare,672,0,0,672,0
5161,18115,4285,110,Plutonium,"Plutonium is refined and crafted into components, modules and other items.",Plutonium.png,common,2948,0,0,2948,0
5161,18525,4285,105,Silicates,"Silicates are refined and crafted into components, modules and other items.",Silicates.png,abundant,4083,0,0,4083,0
5161,18526,4285,106,Elastomers,"Elastomers are refined and crafted into components, modules and other items.",Elastomers.png,abundant,4755,0,0,4755,0
5170,714,4294,106,Elastomers,"Elastomers are refined and crafted into components, modules and other items.",Elastomers.png,abundant,4632,0,0,4632,0
5170,715,4294,112,Amphoteric Substances,"Amphoteric Substances are refined and crafted into components, modules and other items.",Amphoteric_Substances.png,common,2323,0,0,2323,0
5171,7499,10395,127,Microorganisms,"Microorganisms are refined and crafted into components, modules and other items.",Microorganism.png,rare,705,0,0,705,0
5177,11487,4301,42,Base Minerals,"Base Minerals are refined and crafted into components, modules and other items.",Base_Mineral.png,abundant,5516,0,0,5516,0
5177,11488,4301,42,Base Minerals,"Base Minerals are refined and crafted into components, modules and other items.",Base_Mineral.png,abundant,2119,0,0,2119,0
5177,12146,4301,123,Neolysium,"Neolysium is refined and crafted into components, modules and other items.",Neolysium.png,uncommon,1450,0,0,1450,0
5178,12908,4302,109,Titanium,"Titanium is refined and crafted into components, modules and other items.",Titanium.png,common,2633,0,0,2633,0
5178,14490,4302,105,Silicates,"Silicates are refined and crafted into components, modules and other items.",Silicates.png,abundant,4654,0,0,4654,0
5178,17856,4302,53,Ignis Ore,"Ignis Ore is refined and crafted into components, modules and other items.",Ignis_Ore.png,rare,666,0,0,666,0
5195,1379,4319,42,Base Minerals,"Base Minerals are refined and crafted into components, modules and other items.",Base_Mineral.png,abundant,2595,0,0,2595,0
5195,2617,4319,123,Neolysium,"Neolysium is refined and crafted into components, modules and other items.",Neolysium.png,uncommon,1487,0,0,1487,0
5195,2618,4319,112,Amphoteric Substances,"Amphoteric Substances are refined and crafted into components, modules and other items.",Amphoteric_Substances.png,common,4289,0,0,4289,0
5199,1611,4323,110,Plutonium,"Plutonium is refined and crafted into components, modules and other items.",Plutonium.png,common,1017,0,0,1017,0
5199,2018,4323,42,Base Minerals,"Base Minerals are refined and crafted into components, modules and other items.",Base_Mineral.png,abundant,2556,0,0,2556,0
5199,2019,4323,40,Polymetals,"Polymetals are refined and crafted into components, modules and other items.",Polymetals.png,common,4052,0,0,4052,0
5199,2353,10423,128,Tchaikovium,"Tchaikovium is refined and crafted into components, modules and other items.",Tchaikovium.png,rare,677,0,0,677,0
5199,2822,10423,110,Plutonium,"Plutonium is refined and crafted into components, modules and other items.",Plutonium.png,common,2523,0,0,2523,0
5199,2829,10423,110,Plutonium,"Plutonium is refined and crafted into components, modules and other items.",Plutonium.png,common,5869,0,0,5869,0
5200,18294,4324,126,Bruma Particles,"Bruma Particles are refined and crafted into components, modules and other items.",Bruma_Particle.png,rare,846,0,0,846,0
5200,18295,4324,115,Nanofluids,"Nanofluids are refined and crafted into components, modules and other items.",Nanofluids.png,common,2282,0,0,2282,0
5200,18296,4324,106,Elastomers,"Elastomers are refined and crafted into components, modules and other items.",Elastomers.png,abundant,4837,0,0,4837,0
5202,3581,4326,54,Hyperspecular Crystals,"Hyperspecular Crystals are refined and crafted into components, modules and other items.",Hyperspecular_Crystals.png,uncommon,1111,0,0,1111,0
5202,3582,4326,52,Organic Compounds,"Organic Compounds are refined and crafted into components, modules and other items.",Organic_Compound.png,common,2566,0,0,2566,0
5202,3583,4326,42,Base Minerals,"Base Minerals are refined and crafted into components, modules and other items.",Base_Mineral.png,abundant,5259,0,0,5259,0
5202,3584,4326,113,Aerogens,"Aerogens are refined and crafted into components, modules and other items.",Aerogens.png,common,4927,0,0,4927,0
5208,3006,4332,105,Silicates,"Silicates are refined and crafted into components, modules and other items.",Silicates.png,abundant,5402,0,0,5402,0
5208,3941,4332,117,Yprasium,"Yprasium is refined and crafted into components, modules and other items.",Yprasium.png,uncommon,2109,0,0,2109,0
5208,8254,4332,126,Bruma Particles,"Bruma Particles are refined and crafted into components, modules and other items.",Bruma_Particle.png,rare,860,0,0,860,0
5208,8944,10432,105,Silicates,"Silicates are refined and crafted into components, modules and other items.",Silicates.png,abundant,4143,0,0,4143,0
5208,14688,10432,126,Bruma Particles,"Bruma Particles are refined and crafted into components, modules and other items.",Bruma_Particle.png,rare,1512,0,0,1512,0
5208,14851,10432,113,Aerogens,"Aerogens are refined and crafted into components, modules and other items.",Aerogens.png,common,1132,0,0,1132,0
5211,3192,4335,112,Amphoteric Substances,"Amphoteric Substances are refined and crafted into components, modules and other items.",Amphoteric_Substances.png,common,1408,0,0,1408,0
5211,3193,4335,41,Xensium,"Xensium is refined and crafted into components, modules and other items.",Xensium.png,uncommon,1114,0,0,1114,0
5211,3194,4335,112,Amphoteric Substances,"Amphoteric Substances are refined and crafted into components, modules and other items.",Amphoteric_Substances.png,common,2878,0,0,2878,0
5211,3195,4335,107,H2O,"H2O is refined and crafted into components, modules and other items.",H20.png,abundant,5024,0,0,5024,0
5211,3196,4335,106,Elastomers,"Elastomers are refined and crafted into components, modules and other items.",Elastomers.png,abundant,5176,0,0,5176,0
5215,673,4339,113,Aerogens,"Aerogens are refined and crafted into components, modules and other items.",Aerogens.png,common,2366,0,0,2366,0
5215,676,4339,105,Silicates,"Silicates are refined and crafted into components, modules and other items.",Silicates.png,abundant,5320,0,0,5320,0
5215,5710,4339,123,Neolysium,"Neolysium is refined and crafted into components, modules and other items.",Neolysium.png,uncommon,1435,0,0,1435,0
5215,674,10439,109,Titanium,"Titanium is refined and crafted into components, modules and other items.",Titanium.png,common,2556,0,0,2556,0
5215,735,10439,118,Platinyx,"Platinyx is refined and crafted into components, modules and other items.",Platinyx.png,uncommon,1437,0,0,1437,0
5215,4637,10439,42,Base Minerals,"Base Minerals are refined and crafted into components, modules and other items.",Base_Mineral.png,abundant,5197,0,0,5197,0
5218,1953,4342,120,Metamagnetic Ore,"Metamagnetic Ore is refined and crafted into components, modules and other items.",Metamagnetic_Ore.png,uncommon,1153,462,0,691,462
5218,2377,4342,109,Titanium,"Titanium is refined and crafted into components, modules and other items.",Titanium.png,common,2512,942,0,1570,942
5218,2511,4342,105,Silicates,"Silicates are refined and crafted into components, modules and other items.",Silicates.png,abundant,5341,0,0,5341,0
5226,830,4350,128,Tchaikovium,"Tchaikovium is refined and crafted into components, modules and other items.",Tchaikovium.png,rare,677,0,0,677,0
5226,831,4350,128,Tchaikovium,"Tchaikovium is refined and crafted into components, modules and other items.",Tchaikovium.png,rare,1324,0,0,1324,0
5231,1091,4355,41,Xensium,"Xensium is refined and crafted into components, modules and other items.",Xensium.png,uncommon,1147,0,0,1147,0
5231,1602,4355,40,Polymetals,"Polymetals are refined and crafted into components, modules and other items.",Polymetals.png,common,4579,0,0,4579,0
5231,1603,4355,40,Polymetals,"Polymetals are refined and crafted into components, modules and other items.",Polymetals.png,common,5584,0,0,5584,0
5231,1975,4355,106,Elastomers,"Elastomers are refined and crafted into components, modules and other items.",Elastomers.png,abundant,2797,0,0,2797,0
5231,1612,10455,41,Xensium,"Xensium is refined and crafted into components, modules and other items.",Xensium.png,uncommon,1316,0,0,1316,0
5231,1954,10455,106,Elastomers,"Elastomers are refined and crafted into components, modules and other items.",Elastomers.png,abundant,2119,0,0,2119,0
5231,9670,10455,114,Ectopolymers,"Ectopolymers are refined and crafted into components, modules and other items.",Ectopolymers.png,common,5274,0,0,5274,0
5236,40,4360,120,Metamagnetic Ore,"Metamagnetic Ore is refined and crafted into components, modules and other items.",Metamagnetic_Ore.png,uncommon,1081,0,0,1081,0
5242,1003,4366,53,Ignis Ore,"Ignis Ore is refined and crafted into components, modules and other items.",Ignis_Ore.png,rare,650,0,0,650,0
5242,1058,4366,112,Amphoteric Substances,"Amphoteric Substances are refined and crafted into components, modules and other items.",Amphoteric_Substances.png,common,2166,0,0,2166,0
5242,1089,4366,105,Silicates,"Silicates are refined and crafted into components, modules and other items.",Silicates.png,abundant,4475,0,0,4475,0
5242,3125,10466,53,Ignis Ore,"Ignis Ore is refined and crafted into components, modules and other items.",Ignis_Ore.png,rare,893,0,0,893,0
5242,7393,10466,113,Aerogens,"Aerogens are refined and crafted into components, modules and other items.",Aerogens.png,common,2743,0,0,2743,0
5242,8193,10466,106,Elastomers,"Elastomers are refined and crafted into components, modules and other items.",Elastomers.png,abundant,5224,0,0,5224,0
5254,3197,4378,123,Neolysium,"Neolysium is refined and crafted into components, modules and other items.",Neolysium.png,uncommon,1425,0,0,1425,0
5254,3198,4378,109,Titanium,"Titanium is refined and crafted into components, modules and other items.",Titanium.png,common,1052,0,0,1052,0
5254,3199,4378,106,Elastomers,"Elastomers are refined and crafted into components, modules and other items.",Elastomers.png,abundant,2288,0,0,2288,0
5254,3200,4378,105,Silicates,"Silicates are refined and crafted into components, modules and other items.",Silicates.png,abundant,4666,0,0,4666,0
5258,13640,4382,52,Organic Compounds,"Organic Compounds are refined and crafted into components, modules and other items.",Organic_Compound.png,common,1436,0,0,1436,0
5258,15149,4382,105,Silicates,"Silicates are refined and crafted into components, modules and other items.",Silicates.png,abundant,4699,0,0,4699,0
5261,4201,4385,107,H2O,"H2O is refined and crafted into components, modules and other items.",H20.png,abundant,4436,0,0,4436,0
5261,4395,4385,120,Metamagnetic Ore,"Metamagnetic Ore is refined and crafted into components, modules and other items.",Metamagnetic_Ore.png,uncommon,1447,0,0,1447,0
5261,4488,4385,120,Metamagnetic Ore,"Metamagnetic Ore is refined and crafted into components, modules and other items.",Metamagnetic_Ore.png,uncommon,2846,0,0,2846,0
5261,4436,10485,114,Ectopolymers,"Ectopolymers are refined and crafted into components, modules and other items.",Ectopolymers.png,common,1053,0,0,1053,0
5261,4437,10485,106,Elastomers,"Elastomers are refined and crafted into components, modules and other items.",Elastomers.png,abundant,4357,0,0,4357,0
5261,4458,10485,114,Ectopolymers,"Ectopolymers are refined and crafted into components, modules and other items.",Ectopolymers.png,common,2159,0,0,2159,0
5263,397,4387,41,Xensium,"Xensium is refined and crafted into components, modules and other items.",Xensium.png,uncommon,1093,0,0,1093,0
5263,398,4387,127,Microorganisms,"Microorganisms are refined and crafted into components, modules and other items.",Microorganism.png,rare,1646,1236,0,410,1236
5263,399,4387,40,Polymetals,"Polymetals are refined and crafted into components, modules and other items.",Polymetals.png,common,4444,445,0,3999,445
5263,400,4387,105,Silicates,"Silicates are refined and crafted into components, modules and other items.",Silicates.png,abundant,5884,0,0,5884,0
5263,653,10487,127,Microorganisms,"Microorganisms are refined and crafted into components, modules and other items.",Microorganism.png,rare,806,0,0,806,0
5263,685,10487,112,Amphoteric Substances,"Amphoteric Substances are refined and crafted into components, modules and other items.",Amphoteric_Substances.png,common,2727,0,0,2727,0
5263,686,10487,42,Base Minerals,"Base Minerals are refined and crafted into components, modules and other items.",Base_Mineral.png,abundant,2502,313,0,2189,313
5263,1821,10487,106,Elastomers,"Elastomers are refined and crafted into components, modules and other items.",Elastomers.png,abundant,4538,0,0,4538,0
5264,3143,4388,109,Titanium,"Titanium is refined and crafted into components, modules and other items.",Titanium.png,common,2151,0,0,2151,0
5264,3655,4388,42,Base Minerals,"Base Minerals are refined and crafted into components, modules and other items.",Base_Mineral.png,abundant,4728,0,0,4728,0
5264,5711,4388,126,Bruma Particles,"Bruma Particles are refined and crafted into components, modules and other items.",Bruma_Particle.png,rare,880,880,0,0,880
5264,3656,10488,54,Hyperspecular Crystals,"Hyperspecular Crystals are refined and crafted into components, modules and other items.",Hyperspecular_Crystals.png,uncommon,2654,0,0,2654,0
5264,4460,10488,109,Titanium,"Titanium is refined and crafted into components, modules and other items.",Titanium.png,common,1408,0,0,1408,0
5264,4638,10488,107,H2O,"H2O is refined and crafted into components, modules and other items.",H20.png,abundant,5468,0,0,5468,0
5269,4477,4393,113,Aerogens,"Aerogens are refined and crafted into components, modules and other items.",Aerogens.png,common,1234,0,0,1234,0
5269,4478,4393,113,Aerogens,"Aerogens are refined and crafted into components, modules and other items.",Aerogens.png,common,4023,0,0,4023,0
5269,4491,4393,118,Platinyx,"Platinyx is refined and crafted into components, modules and other items.",Platinyx.png,uncommon,2191,0,0,2191,0
5269,4440,10493,54,Hyperspecular Crystals,"Hyperspecular Crystals are refined and crafted into components, modules and other items.",Hyperspecular_Crystals.png,uncommon,1070,0,0,1070,0
5269,4480,10493,113,Aerogens,"Aerogens are refined and crafted into components, modules and other items.",Aerogens.png,common,2960,0,0,2960,0
5269,4483,10493,42,Base Minerals,"Base Minerals are refined and crafted into components, modules and other items.",Base_Mineral.png,abundant,4304,0,0,4304,0
5274,8911,4398,112,Amphoteric Substances,"Amphoteric Substances are refined and crafted into components, modules and other items.",Amphoteric_Substances.png,common,5722,0,0,5722,0
5274,8978,4398,126,Bruma Particles,"Bruma Particles are refined and crafted into components, modules and other items.",Bruma_Particle.png,rare,630,0,0,630,0
5274,10684,4398,113,Aerogens,"Aerogens are refined and crafted into components, modules and other items.",Aerogens.png,common,2587,0,0,2587,0
5274,17924,10498,42,Base Minerals,"Base Minerals are refined and crafted into components, modules and other items.",Base_Mineral.png,abundant,4398,0,0,4398,0
5274,18554,10498,106,Elastomers,"Elastomers are refined and crafted into components, modules and other items.",Elastomers.png,abundant,2836,0,0,2836,0
5274,18589,10498,126,Bruma Particles,"Bruma Particles are refined and crafted into components, modules and other items.",Bruma_Particle.png,rare,806,0,0,806,0
5276,11453,4400,52,Organic Compounds,"Organic Compounds are refined and crafted into components, modules and other items.",Organic_Compound.png,common,1492,0,0,1492,0
5276,11551,4400,52,Organic Compounds,"Organic Compounds are refined and crafted into components, modules and other items.",Organic_Compound.png,common,2641,0,0,2641,0
5276,17735,4400,52,Organic Compounds,"Organic Compounds are refined and crafted into components, modules and other items.",Organic_Compound.png,common,4804,0,0,4804,0
5276,17934,10500,114,Ectopolymers,"Ectopolymers are refined and crafted into components, modules and other items.",Ectopolymers.png,common,5057,0,0,5057,0
5276,17939,10500,52,Organic Compounds,"Organic Compounds are refined and crafted into components, modules and other items.",Organic_Compound.png,common,2958,0,0,2958,0
5279,45,4403,126,Bruma Particles,"Bruma Particles are refined and crafted into components, modules and other items.",Bruma_Particle.png,rare,756,152,0,604,152
5279,154,4403,106,Elastomers,"Elastomers are refined and crafted into components, modules and other items.",Elastomers.png,abundant,4797,0,0,4797,0
5279,410,4403,109,Titanium,"Titanium is refined and crafted into components, modules and other items.",Titanium.png,common,2167,0,0,2167,0
5279,616,10503,127,Microorganisms,"Microorganisms are refined and crafted into components, modules and other items.",Microorganism.png,rare,804,0,0,804,0
5279,3342,10503,106,Elastomers,"Elastomers are refined and crafted into components, modules and other items.",Elastomers.png,abundant,4469,0,0,4469,0
5279,4251,10503,110,Plutonium,"Plutonium is refined and crafted into components, modules and other items.",Plutonium.png,common,2980,0,0,2980,0
5280,2163,4404,115,Nanofluids,"Nanofluids are refined and crafted into components, modules and other items.",Nanofluids.png,common,1414,0,0,1414,0
5280,2164,4404,41,Xensium,"Xensium is refined and crafted into components, modules and other items.",Xensium.png,uncommon,2330,0,0,2330,0
5280,2764,4404,121,Hypoatomic Substances,"Hypoatomic Substances are refined and crafted into components, modules and other items.",Hypoatomic_Substances.png,uncommon,5391,0,0,5391,0
5280,2765,4404,107,H2O,"H2O is refined and crafted into components, modules and other items.",H20.png,abundant,5176,0,0,5176,0
5280,3561,10504,52,Organic Compounds,"Organic Compounds are refined and crafted into components, modules and other items.",Organic_Compound.png,common,1431,0,0,1431,0
5280,3562,10504,40,Polymetals,"Polymetals are refined and crafted into components, modules and other items.",Polymetals.png,common,2402,0,0,2402,0
5280,3563,10504,115,Nanofluids,"Nanofluids are refined and crafted into components, modules and other items.",Nanofluids.png,common,4945,0,0,4945,0
5284,3585,4408,123,Neolysium,"Neolysium is refined and crafted into components, modules and other items.",Neolysium.png,uncommon,1483,0,0,1483,0
5284,3586,4408,41,Xensium,"Xensium is refined and crafted into components, modules and other items.",Xensium.png,uncommon,2649,0,0,2649,0
5284,3587,4408,112,Amphoteric Substances,"Amphoteric Substances are refined and crafted into components, modules and other items.",Amphoteric_Substances.png,common,4618,0,0,4618,0
5288,2516,4412,105,Silicates,"Silicates are refined and crafted into components, modules and other items.",Silicates.png,abundant,4116,0,0,4116,0
5288,8188,4412,40,Polymetals,"Polymetals are refined and crafted into components, modules and other items.",Polymetals.png,common,2719,0,0,2719,0
5288,8197,4412,120,Metamagnetic Ore,"Metamagnetic Ore is refined and crafted into components, modules and other items.",Metamagnetic_Ore.png,uncommon,1081,0,0,1081,0
5288,8206,10512,105,Silicates,"Silicates are refined and crafted into components, modules and other items.",Silicates.png,abundant,5025,0,0,5025,0
5288,8383,10512,40,Polymetals,"Polymetals are refined and crafted into components, modules and other items.",Polymetals.png,common,2737,0,0,2737,0
5288,14257,10512,128,Tchaikovium,"Tchaikovium is refined and crafted into components, modules and other items.",Tchaikovium.png,rare,880,0,0,880,0
5292,3904,4416,127,Microorganisms,"Microorganisms are refined and crafted into components, modules and other items.",Microorganism.png,rare,846,0,0,846,0
5292,3905,4416,41,Xensium,"Xensium is refined and crafted into components, modules and other items.",Xensium.png,uncommon,2163,0,0,2163,0
5292,3943,4416,106,Elastomers,"Elastomers are refined and crafted into components, modules and other items.",Elastomers.png,abundant,5886,0,0,5886,0
5292,20007,10516,52,Organic Compounds,"Organic Compounds are refined and crafted into components, modules and other items.",Organic_Compound.png,common,1170,0,0,1170,0
5293,38,4417,42,Base Minerals,"Base Minerals are refined and crafted into components, modules and other items.",Base_Mineral.png,abundant,4755,476,0,4279,476
5293,14884,4417,105,Silicates,"Silicates are refined and crafted into components, modules and other items.",Silicates.png,abundant,2537,0,0,2537,0
5293,14885,4417,42,Base Minerals,"Base Minerals are refined and crafted into components, modules and other items.",Base_Mineral.png,abundant,2092,0,0,2092,0
5297,4371,4421,115,Nanofluids,"Nanofluids are refined and crafted into components, modules and other items.",Nanofluids.png,common,1209,0,0,1209,0
5297,4650,4421,106,Elastomers,"Elastomers are refined and crafted into components, modules and other items.",Elastomers.png,abundant,5797,0,0,5797,0
5297,12216,4421,127,Microorganisms,"Microorganisms are refined and crafted into components, modules and other items.",Microorganism.png,rare,1405,0,0,1405,0
5301,3588,4425,112,Amphoteric Substances,"Amphoteric Substances are refined and crafted into components, modules and other items.",Amphoteric_Substances.png,common,1010,0,0,1010,0
5301,3589,4425,40,Polymetals,"Polymetals are refined and crafted into components, modules and other items.",Polymetals.png,common,2110,0,0,2110,0
5301,3590,4425,112,Amphoteric Substances,"Amphoteric Substances are refined and crafted into components, modules and other items.",Amphoteric_Substances.png,common,4583,0,0,4583,0
5306,3945,4430,115,Nanofluids,"Nanofluids are refined and crafted into components, modules and other items.",Nanofluids.png,common,1392,0,0,1392,0
5306,3946,4430,117,Yprasium,"Yprasium is refined and crafted into components, modules and other items.",Yprasium.png,uncommon,2821,0,0,2821,0
5306,3949,4430,105,Silicates,"Silicates are refined and crafted into components, modules and other items.",Silicates.png,abundant,5067,0,0,5067,0
5310,3090,4434,128,Tchaikovium,"Tchaikovium is refined and crafted into components, modules and other items.",Tchaikovium.png,rare,896,0,0,896,0
5310,3308,4434,120,Metamagnetic Ore,"Metamagnetic Ore is refined and crafted into components, modules and other items.",Metamagnetic_Ore.png,uncommon,2832,0,0,2832,0
5310,3316,4434,109,Titanium,"Titanium is refined and crafted into components, modules and other items.",Titanium.png,common,4980,0,0,4980,0
5310,14522,10534,107,H2O,"H2O is refined and crafted into components, modules and other items.",H20.png,abundant,2131,0,0,2131,0
5310,17161,10534,112,Amphoteric Substances,"Amphoteric Substances are refined and crafted into components, modules and other items.",Amphoteric_Substances.png,common,1407,0,0,1407,0
5310,17162,10534,120,Metamagnetic Ore,"Metamagnetic Ore is refined and crafted into components, modules and other items.",Metamagnetic_Ore.png,uncommon,1461,0,0,1461,0
5311,573,4435,113,Aerogens,"Aerogens are refined and crafted into components, modules and other items.",Aerogens.png,common,2189,0,0,2189,0
5311,632,4435,106,Elastomers,"Elastomers are refined and crafted into components, modules and other items.",Elastomers.png,abundant,4737,474,0,4263,474
5311,16703,4435,117,Yprasium,"Yprasium is refined and crafted into components, modules and other items.",Yprasium.png,uncommon,1351,0,0,1351,0
5311,648,10535,115,Nanofluids,"Nanofluids are refined and crafted into components, modules and other items.",Nanofluids.png,common,2613,0,0,2613,0
5311,2063,10535,117,Yprasium,"Yprasium is refined and crafted into components, modules and other items.",Yprasium.png,uncommon,1226,0,0,1226,0
5311,16705,10535,107,H2O,"H2O is refined and crafted into components, modules and other items.",H20.png,abundant,4904,0,0,4904,0
5312,18418,4436,105,Silicates,"Silicates are refined and crafted into components, modules and other items.",Silicates.png,abundant,5540,0,0,5540,0
5312,18419,4436,105,Silicates,"Silicates are refined and crafted into components, modules and other items.",Silicates.png,abundant,4964,0,0,4964,0
5312,8680,10536,117,Yprasium,"Yprasium is refined and crafted into components, modules and other items.",Yprasium.png,uncommon,1120,0,0,1120,0
5312,8681,10536,53,Ignis Ore,"Ignis Ore is refined and crafted into components, modules and other items.",Ignis_Ore.png,rare,610,0,0,610,0
5312,15907,10536,52,Organic Compounds,"Organic Compounds are refined and crafted into components, modules and other items.",Organic_Compound.png,common,2856,0,0,2856,0
5312,16666,10536,117,Yprasium,"Yprasium is refined and crafted into components, modules and other items.",Yprasium.png,uncommon,4455,0,0,4455,0
5313,11,4437,53,Ignis Ore,"Ignis Ore is refined and crafted into components, modules and other items.",Ignis_Ore.png,rare,750,750,0,0,750
5313,12,4437,127,Microorganisms,"Microorganisms are refined and crafted into components, modules and other items.",Microorganism.png,rare,834,834,0,0,834
5313,106,4437,52,Organic Compounds,"Organic Compounds are refined and crafted into components, modules and other items.",Organic_Compound.png,common,2652,332,0,2320,332
5313,107,4437,114,Ectopolymers,"Ectopolymers are refined and crafted into components, modules and other items.",Ectopolymers.png,common,5265,527,0,4738,527
5313,1746,10537,42,Base Minerals,"Base Minerals are refined and crafted into components, modules and other items.",Base_Mineral.png,abundant,5823,583,0,5240,583
5313,2392,10537,114,Ectopolymers,"Ectopolymers are refined and crafted into components, modules and other items.",Ectopolymers.png,common,1253,251,0,1002,251
5313,2393,10537,41,Xensium,"Xensium is refined and crafted into components, modules and other items.",Xensium.png,uncommon,2236,2236,0,0,2236
5315,1004,4439,109,Titanium,"Titanium is refined and crafted into components, modules and other items.",Titanium.png,common,1251,0,0,1251,0
5315,1071,4439,40,Polymetals,"Polymetals are refined and crafted into components, modules and other items.",Polymetals.png,common,2633,0,0,2633,0
5315,1072,4439,105,Silicates,"Silicates are refined and crafted into components, modules and other items.",Silicates.png,abundant,2828,0,0,2828,0
5315,1090,4439,42,Base Minerals,"Base Minerals are refined and crafted into components, modules and other items.",Base_Mineral.png,abundant,4755,0,0,4755,0
5315,3133,10539,53,Ignis Ore,"Ignis Ore is refined and crafted into components, modules and other items.",Ignis_Ore.png,rare,763,0,0,763,0
5315,7591,10539,42,Base Minerals,"Base Minerals are refined and crafted into components, modules and other items.",Base_Mineral.png,abundant,2684,0,0,2684,0
5315,8275,10539,112,Amphoteric Substances,"Amphoteric Substances are refined and crafted into components, modules and other items.",Amphoteric_Substances.png,common,4702,0,0,4702,0
5316,1315,4440,40,Polymetals,"Polymetals are refined and crafted into components, modules and other items.",Polymetals.png,common,2688,0,0,2688,0
5316,1935,4440,106,Elastomers,"Elastomers are refined and crafted into components, modules and other items.",Elastomers.png,abundant,5812,0,0,5812,0
5316,1946,4440,127,Microorganisms,"Microorganisms are refined and crafted into components, modules and other items.",Microorganism.png,rare,706,0,0,706,0
5331,17992,4455,120,Metamagnetic Ore,"Metamagnetic Ore is refined and crafted into components, modules and other items.",Metamagnetic_Ore.png,uncommon,2564,0,0,2564,0
5331,18254,4455,112,Amphoteric Substances,"Amphoteric Substances are refined and crafted into components, modules and other items.",Amphoteric_Substances.png,common,5471,0,0,5471,0
5331,18356,4455,112,Amphoteric Substances,"Amphoteric Substances are refined and crafted into components, modules and other items.",Amphoteric_Substances.png,common,1312,0,0,1312,0
5338,18586,4462,42,Base Minerals,"Base Minerals are refined and crafted into components, modules and other items.",Base_Mineral.png,abundant,2773,0,0,2773,0
5338,20530,10562,106,Elastomers,"Elastomers are refined and crafted into components, modules and other items.",Elastomers.png,abundant,2835,0,0,2835,0
5343,1388,4467,110,Plutonium,"Plutonium is refined and crafted into components, modules and other items.",Plutonium.png,common,2390,0,0,2390,0
5343,2614,4467,119,Novis Compounds,"Novis Compounds are refined and crafted into components, modules and other items.",Novis_Compound.png,uncommon,1111,0,0,1111,0
5343,2615,4467,128,Tchaikovium,"Tchaikovium is refined and crafted into components, modules and other items.",Tchaikovium.png,rare,713,0,0,713,0
5343,2616,4467,42,Base Minerals,"Base Minerals are refined and crafted into components, modules and other items.",Base_Mineral.png,abundant,4657,0,0,4657,0
5345,3591,4469,54,Hyperspecular Crystals,"Hyperspecular Crystals are refined and crafted into components, modules and other items.",Hyperspecular_Crystals.png,uncommon,1063,0,0,1063,0
5345,3592,4469,114,Ectopolymers,"Ectopolymers are refined and crafted into components, modules and other items.",Ectopolymers.png,common,2030,0,0,2030,0
5345,3593,4469,42,Base Minerals,"Base Minerals are refined and crafted into components, modules and other items.",Base_Mineral.png,abundant,5329,0,0,5329,0
5350,4421,4474,117,Yprasium,"Yprasium is refined and crafted into components, modules and other items.",Yprasium.png,uncommon,1228,0,0,1228,0
5350,11189,4474,107,H2O,"H2O is refined and crafted into components, modules and other items.",H20.png,abundant,4836,0,0,4836,0
5350,13267,4474,115,Nanofluids,"Nanofluids are refined and crafted into components, modules and other items.",Nanofluids.png,common,2544,0,0,2544,0
5350,13268,10574,121,Hypoatomic Substances,"Hypoatomic Substances are refined and crafted into components, modules and other items.",Hypoatomic_Substances.png,uncommon,1222,0,0,1222,0
5350,13269,10574,117,Yprasium,"Yprasium is refined and crafted into components, modules and other items.",Yprasium.png,uncommon,2462,0,0,2462,0
5350,15189,10574,113,Aerogens,"Aerogens are refined and crafted into components, modules and other items.",Aerogens.png,common,5820,0,0,5820,0
5353,18881,4477,105,Silicates,"Silicates are refined and crafted into components, modules and other items.",Silicates.png,abundant,5702,0,0,5702,0
5353,20003,4477,126,Bruma Particles,"Bruma Particles are refined and crafted into components, modules and other items.",Bruma_Particle.png,rare,650,0,0,650,0
5357,4644,4481,126,Bruma Particles,"Bruma Particles are refined and crafted into components, modules and other items.",Bruma_Particle.png,rare,801,0,0,801,0
5357,4645,4481,106,Elastomers,"Elastomers are refined and crafted into components, modules and other items.",Elastomers.png,abundant,5747,0,0,5747,0
5357,4655,4481,113,Aerogens,"Aerogens are refined and crafted into components, modules and other items.",Aerogens.png,common,2408,0,0,2408,0
5357,8071,10581,127,Microorganisms,"Microorganisms are refined and crafted into components, modules and other items.",Microorganism.png,rare,785,0,0,785,0
5357,8072,10581,115,Nanofluids,"Nanofluids are refined and crafted into components, modules and other items.",Nanofluids.png,common,2986,0,0,2986,0
5357,8073,10581,106,Elastomers,"Elastomers are refined and crafted into components, modules and other items.",Elastomers.png,abundant,4685,0,0,4685,0
5358,3594,4482,115,Nanofluids,"Nanofluids are refined and crafted into components, modules and other items.",Nanofluids.png,common,1035,0,0,1035,0
5358,3595,4482,121,Hypoatomic Substances,"Hypoatomic Substances are refined and crafted into components, modules and other items.",Hypoatomic_Substances.png,uncommon,2402,0,0,2402,0
5358,3596,4482,121,Hypoatomic Substances,"Hypoatomic Substances are refined and crafted into components, modules and other items.",Hypoatomic_Substances.png,uncommon,5878,0,0,5878,0
5367,7506,4491,41,Xensium,"Xensium is refined and crafted into components, modules and other items.",Xensium.png,uncommon,2627,0,0,2627,0
5367,8218,4491,40,Polymetals,"Polymetals are refined and crafted into components, modules and other items.",Polymetals.png,common,1093,0,0,1093,0
5367,8550,4491,107,H2O,"H2O is refined and crafted into components, modules and other items.",H20.png,abundant,4070,0,0,4070,0
5369,3902,4493,126,Bruma Particles,"Bruma Particles are refined and crafted into components, modules and other items.",Bruma_Particle.png,rare,741,0,0,741,0
5371,2949,4495,119,Novis Compounds,"Novis Compounds are refined and crafted into components, modules and other items.",Novis_Compound.png,uncommon,1066,214,0,852,214
5371,2950,4495,54,Hyperspecular Crystals,"Hyperspecular Crystals are refined and crafted into components, modules and other items.",Hyperspecular_Crystals.png,uncommon,1118,0,0,1118,0
5371,3511,4495,106,Elastomers,"Elastomers are refined and crafted into components, modules and other items.",Elastomers.png,abundant,2062,0,0,2062,0
5371,7521,4495,114,Ectopolymers,"Ectopolymers are refined and crafted into components, modules and other items.",Ectopolymers.png,common,5610,1122,0,4488,1122
5373,3038,4497,128,Tchaikovium,"Tchaikovium is refined and crafted into components, modules and other items.",Tchaikovium.png,rare,682,0,0,682,0
5373,3512,4497,105,Silicates,"Silicates are refined and crafted into components, modules and other items.",Silicates.png,abundant,2595,0,0,2595,0
5373,7522,4497,106,Elastomers,"Elastomers are refined and crafted into components, modules and other items.",Elastomers.png,abundant,5658,1132,0,4526,1132
5376,2537,4500,107,H2O,"H2O is refined and crafted into components, modules and other items.",H20.png,abundant,5261,0,0,5261,0
5376,8980,4500,123,Neolysium,"Neolysium is refined and crafted into components, modules and other items.",Neolysium.png,uncommon,1294,0,0,1294,0
5376,13927,4500,109,Titanium,"Titanium is refined and crafted into components, modules and other items.",Titanium.png,common,2055,0,0,2055,0
5376,15314,10600,42,Base Minerals,"Base Minerals are refined and crafted into components, modules and other items.",Base_Mineral.png,abundant,4914,0,0,4914,0
5376,15360,10600,54,Hyperspecular Crystals,"Hyperspecular Crystals are refined and crafted into components, modules and other items.",Hyperspecular_Crystals.png,uncommon,2820,0,0,2820,0
5376,15676,10600,109,Titanium,"Titanium is refined and crafted into components, modules and other items.",Titanium.png,common,1311,0,0,1311,0
5376,15677,10600,123,Neolysium,"Neolysium is refined and crafted into components, modules and other items.",Neolysium.png,uncommon,1008,0,0,1008,0
5389,4487,4513,117,Yprasium,"Yprasium is refined and crafted into components, modules and other items.",Yprasium.png,uncommon,1144,0,0,1144,0
5389,4492,4513,42,Base Minerals,"Base Minerals are refined and crafted into components, modules and other items.",Base_Mineral.png,abundant,5252,0,0,5252,0
5389,4545,4513,109,Titanium,"Titanium is refined and crafted into components, modules and other items.",Titanium.png,common,2077,0,0,2077,0
5389,4476,10613,53,Ignis Ore,"Ignis Ore is refined and crafted into components, modules and other items.",Ignis_Ore.png,rare,860,0,0,860,0
5389,4751,10613,115,Nanofluids,"Nanofluids are refined and crafted into components, modules and other items.",Nanofluids.png,common,2627,0,0,2627,0
5389,4752,10613,112,Amphoteric Substances,"Amphoteric Substances are refined and crafted into components, modules and other items.",Amphoteric_Substances.png,common,4907,0,0,4907,0
5390,4493,4514,118,Platinyx,"Platinyx is refined and crafted into components, modules and other items.",Platinyx.png,uncommon,1308,0,0,1308,0
5390,4494,4514,105,Silicates,"Silicates are refined and crafted into components, modules and other items.",Silicates.png,abundant,5209,0,0,5209,0
5390,4546,4514,119,Novis Compounds,"Novis Compounds are refined and crafted into components, modules and other items.",Novis_Compound.png,uncommon,2332,0,0,2332,0
5390,4547,4514,110,Plutonium,"Plutonium is refined and crafted into components, modules and other items.",Plutonium.png,common,2288,0,0,2288,0
5390,4579,10614,120,Metamagnetic Ore,"Metamagnetic Ore is refined and crafted into components, modules and other items.",Metamagnetic_Ore.png,uncommon,1057,0,0,1057,0
5390,4770,10614,110,Plutonium,"Plutonium is refined and crafted into components, modules and other items.",Plutonium.png,common,2727,0,0,2727,0
5390,4771,10614,107,H2O,"H2O is refined and crafted into components, modules and other items.",H20.png,abundant,5289,0,0,5289,0
5391,423,4515,40,Polymetals,"Polymetals are refined and crafted into components, modules and other items.",Polymetals.png,common,1494,0,0,1494,0
5391,2165,4515,112,Amphoteric Substances,"Amphoteric Substances are refined and crafted into components, modules and other items.",Amphoteric_Substances.png,common,2656,0,0,2656,0
5391,2763,4515,106,Elastomers,"Elastomers are refined and crafted into components, modules and other items.",Elastomers.png,abundant,4432,0,0,4432,0
5391,1048,10615,119,Novis Compounds,"Novis Compounds are refined and crafted into components, modules and other items.",Novis_Compound.png,uncommon,2178,0,0,2178,0
5391,4193,10615,112,Amphoteric Substances,"Amphoteric Substances are refined and crafted into components, modules and other items.",Amphoteric_Substances.png,common,1175,0,0,1175,0
5391,4278,10615,52,Organic Compounds,"Organic Compounds are refined and crafted into components, modules and other items.",Organic_Compound.png,common,4758,0,0,4758,0
5392,3201,4516,126,Bruma Particles,"Bruma Particles are refined and crafted into components, modules and other items.",Bruma_Particle.png,rare,838,0,0,838,0
5392,3202,4516,109,Titanium,"Titanium is refined and crafted into components, modules and other items.",Titanium.png,common,2868,0,0,2868,0
5392,3203,4516,42,Base Minerals,"Base Minerals are refined and crafted into components, modules and other items.",Base_Mineral.png,abundant,5311,0,0,5311,0
5394,3597,4518,115,Nanofluids,"Nanofluids are refined and crafted into components, modules and other items.",Nanofluids.png,common,1131,0,0,1131,0
5394,3598,4518,106,Elastomers,"Elastomers are refined and crafted into components, modules and other items.",Elastomers.png,abundant,5238,0,0,5238,0
5394,3615,4518,41,Xensium,"Xensium is refined and crafted into components, modules and other items.",Xensium.png,uncommon,2722,0,0,2722,0
5394,3616,4518,52,Organic Compounds,"Organic Compounds are refined and crafted into components, modules and other items.",Organic_Compound.png,common,2333,0,0,2333,0
5398,1955,4522,114,Ectopolymers,"Ectopolymers are refined and crafted into components, modules and other items.",Ectopolymers.png,common,2823,0,0,2823,0
5400,2166,4524,128,Tchaikovium,"Tchaikovium is refined and crafted into components, modules and other items.",Tchaikovium.png,rare,810,0,0,810,0
5400,2167,4524,113,Aerogens,"Aerogens are refined and crafted into components, modules and other items.",Aerogens.png,common,2171,0,0,2171,0
5400,2762,4524,42,Base Minerals,"Base Minerals are refined and crafted into components, modules and other items.",Base_Mineral.png,abundant,4794,0,0,4794,0
5400,3537,10624,126,Bruma Particles,"Bruma Particles are refined and crafted into components, modules and other items.",Bruma_Particle.png,rare,845,0,0,845,0
5400,3538,10624,42,Base Minerals,"Base Minerals are refined and crafted into components, modules and other items.",Base_Mineral.png,abundant,2527,0,0,2527,0
5400,3539,10624,42,Base Minerals,"Base Minerals are refined and crafted into components, modules and other items.",Base_Mineral.png,abundant,5724,0,0,5724,0
5401,3356,4525,123,Neolysium,"Neolysium is refined and crafted into components, modules and other items.",Neolysium.png,uncommon,1099,0,0,1099,0
5401,3878,4525,42,Base Minerals,"Base Minerals are refined and crafted into components, modules and other items.",Base_Mineral.png,abundant,4130,826,0,3304,826
5401,3572,10625,115,Nanofluids,"Nanofluids are refined and crafted into components, modules and other items.",Nanofluids.png,common,1241,0,0,1241,0
5401,3573,10625,109,Titanium,"Titanium is refined and crafted into components, modules and other items.",Titanium.png,common,2098,263,0,1835,263
5401,4202,10625,105,Silicates,"Silicates are refined and crafted into components, modules and other items.",Silicates.png,abundant,5859,0,0,5859,0
5403,1268,4527,52,Organic Compounds,"Organic Compounds are refined and crafted into components, modules and other items.",Organic_Compound.png,common,1266,0,0,1266,0
5403,1269,4527,106,Elastomers,"Elastomers are refined and crafted into components, modules and other items.",Elastomers.png,abundant,2778,0,0,2778,0
5403,1270,4527,42,Base Minerals,"Base Minerals are refined and crafted into components, modules and other items.",Base_Mineral.png,abundant,4545,0,0,4545,0
5403,18087,10627,114,Ectopolymers,"Ectopolymers are refined and crafted into components, modules and other items.",Ectopolymers.png,common,1268,0,0,1268,0
5403,18088,10627,114,Ectopolymers,"Ectopolymers are refined and crafted into components, modules and other items.",Ectopolymers.png,common,2685,0,0,2685,0
5403,18089,10627,110,Plutonium,"Plutonium is refined and crafted into components, modules and other items.",Plutonium.png,common,5600,0,0,5600,0
5406,15357,4530,107,H2O,"H2O is refined and crafted into components, modules and other items.",H20.png,abundant,4386,0,0,4386,0
5418,1389,4542,40,Polymetals,"Polymetals are refined and crafted into components, modules and other items.",Polymetals.png,common,2260,0,0,2260,0
5418,2611,4542,127,Microorganisms,"Microorganisms are refined and crafted into components, modules and other items.",Microorganism.png,rare,889,0,0,889,0
5418,2612,4542,106,Elastomers,"Elastomers are refined and crafted into components, modules and other items.",Elastomers.png,abundant,4863,0,0,4863,0
5418,2613,4542,53,Ignis Ore,"Ignis Ore is refined and crafted into components, modules and other items.",Ignis_Ore.png,rare,2685,0,0,2685,0
5419,2503,4543,128,Tchaikovium,"Tchaikovium is refined and crafted into components, modules and other items.",Tchaikovium.png,rare,800,0,0,800,0
5419,2504,4543,110,Plutonium,"Plutonium is refined and crafted into components, modules and other items.",Plutonium.png,common,2511,0,0,2511,0
5419,4886,4543,106,Elastomers,"Elastomers are refined and crafted into components, modules and other items.",Elastomers.png,abundant,4643,0,0,4643,0
5423,618,4547,42,Base Minerals,"Base Minerals are refined and crafted into components, modules and other items.",Base_Mineral.png,abundant,5704,0,0,5704,0
5423,1492,4547,52,Organic Compounds,"Organic Compounds are refined and crafted into components, modules and other items.",Organic_Compound.png,common,1338,0,0,1338,0
5423,4144,4547,110,Plutonium,"Plutonium is refined and crafted into components, modules and other items.",Plutonium.png,common,2918,0,0,2918,0
5423,14523,10647,112,Amphoteric Substances,"Amphoteric Substances are refined and crafted into components, modules and other items.",Amphoteric_Substances.png,common,2474,0,0,2474,0
5423,17163,10647,118,Platinyx,"Platinyx is refined and crafted into components, modules and other items.",Platinyx.png,uncommon,1054,0,0,1054,0
5428,20001,4552,107,H2O,"H2O is refined and crafted into components, modules and other items.",H20.png,abundant,4460,0,0,4460,0
5428,20002,4552,127,Microorganisms,"Microorganisms are refined and crafted into components, modules and other items.",Microorganism.png,rare,805,0,0,805,0
5435,2639,4559,109,Titanium,"Titanium is refined and crafted into components, modules and other items.",Titanium.png,common,2490,0,0,2490,0
5435,3654,4559,107,H2O,"H2O is refined and crafted into components, modules and other items.",H20.png,abundant,5415,0,0,5415,0
5435,5941,4559,109,Titanium,"Titanium is refined and crafted into components, modules and other items.",Titanium.png,common,1186,0,0,1186,0
5435,4215,10659,42,Base Minerals,"Base Minerals are refined and crafted into components, modules and other items.",Base_Mineral.png,abundant,2148,0,0,2148,0
5435,4459,10659,123,Neolysium,"Neolysium is refined and crafted into components, modules and other items.",Neolysium.png,uncommon,1298,0,0,1298,0
5435,4659,10659,52,Organic Compounds,"Organic Compounds are refined and crafted into components, modules and other items.",Organic_Compound.png,common,5787,0,0,5787,0
5443,19207,4567,117,Yprasium,"Yprasium is refined and crafted into components, modules and other items.",Yprasium.png,uncommon,1459,0,0,1459,0
5443,19208,4567,114,Ectopolymers,"Ectopolymers are refined and crafted into components, modules and other items.",Ectopolymers.png,common,1131,0,0,1131,0
5443,19209,4567,42,Base Minerals,"Base Minerals are refined and crafted into components, modules and other items.",Base_Mineral.png,abundant,2233,0,0,2233,0
5443,19372,4567,105,Silicates,"Silicates are refined and crafted into components, modules and other items.",Silicates.png,abundant,4919,0,0,4919,0
5449,2168,4573,117,Yprasium,"Yprasium is refined and crafted into components, modules and other items.",Yprasium.png,uncommon,1413,0,0,1413,0
5449,2169,4573,119,Novis Compounds,"Novis Compounds are refined and crafted into components, modules and other items.",Novis_Compound.png,uncommon,1422,0,0,1422,0
5449,2170,4573,119,Novis Compounds,"Novis Compounds are refined and crafted into components, modules and other items.",Novis_Compound.png,uncommon,2005,0,0,2005,0
5449,2761,4573,106,Elastomers,"Elastomers are refined and crafted into components, modules and other items.",Elastomers.png,abundant,5183,0,0,5183,0
5449,3564,10673,117,Yprasium,"Yprasium is refined and crafted into components, modules and other items.",Yprasium.png,uncommon,1457,0,0,1457,0
5449,3565,10673,126,Bruma Particles,"Bruma Particles are refined and crafted into components, modules and other items.",Bruma_Particle.png,rare,1332,0,0,1332,0
5449,3566,10673,105,Silicates,"Silicates are refined and crafted into components, modules and other items.",Silicates.png,abundant,5913,0,0,5913,0
5455,5843,4579,128,Tchaikovium,"Tchaikovium is refined and crafted into components, modules and other items.",Tchaikovium.png,rare,858,0,0,858,0
5455,5844,4579,118,Platinyx,"Platinyx is refined and crafted into components, modules and other items.",Platinyx.png,uncommon,2996,0,0,2996,0
5455,5845,4579,119,Novis Compounds,"Novis Compounds are refined and crafted into components, modules and other items.",Novis_Compound.png,uncommon,2070,0,0,2070,0
5455,5846,4579,42,Base Minerals,"Base Minerals are refined and crafted into components, modules and other items.",Base_Mineral.png,abundant,4103,0,0,4103,0
5455,16634,10679,110,Plutonium,"Plutonium is refined and crafted into components, modules and other items.",Plutonium.png,common,4834,0,0,4834,0
5455,16635,10679,120,Metamagnetic Ore,"Metamagnetic Ore is refined and crafted into components, modules and other items.",Metamagnetic_Ore.png,uncommon,2132,0,0,2132,0
5455,17757,10679,110,Plutonium,"Plutonium is refined and crafted into components, modules and other items.",Plutonium.png,common,1296,0,0,1296,0
5457,1506,4581,53,Ignis Ore,"Ignis Ore is refined and crafted into components, modules and other items.",Ignis_Ore.png,rare,884,531,0,353,531
5457,3117,4581,105,Silicates,"Silicates are refined and crafted into components, modules and other items.",Silicates.png,abundant,5464,0,0,5464,0
5457,1242,10681,105,Silicates,"Silicates are refined and crafted into components, modules and other items.",Silicates.png,abundant,4880,0,0,4880,0
5457,1243,10681,105,Silicates,"Silicates are refined and crafted into components, modules and other items.",Silicates.png,abundant,5840,0,0,5840,0
5457,1758,10681,114,Ectopolymers,"Ectopolymers are refined and crafted into components, modules and other items.",Ectopolymers.png,common,1028,0,0,1028,0
5457,2461,10681,127,Microorganisms,"Microorganisms are refined and crafted into components, modules and other items.",Microorganism.png,rare,1722,216,0,1506,216
5457,2462,10681,107,H2O,"H2O is refined and crafted into components, modules and other items.",H20.png,abundant,2536,0,0,2536,0
5461,1645,4585,53,Ignis Ore,"Ignis Ore is refined and crafted into components, modules and other items.",Ignis_Ore.png,rare,829,0,0,829,0
5461,1753,4585,107,H2O,"H2O is refined and crafted into components, modules and other items.",H20.png,abundant,4121,0,0,4121,0
5461,1754,4585,105,Silicates,"Silicates are refined and crafted into components, modules and other items.",Silicates.png,abundant,5167,0,0,5167,0
5461,1755,4585,110,Plutonium,"Plutonium is refined and crafted into components, modules and other items.",Plutonium.png,common,2833,0,0,2833,0
5463,2517,4587,40,Polymetals,"Polymetals are refined and crafted into components, modules and other items.",Polymetals.png,common,1029,0,0,1029,0
5465,1075,4589,113,Aerogens,"Aerogens are refined and crafted into components, modules and other items.",Aerogens.png,common,4417,442,0,3975,442
5465,1146,4589,54,Hyperspecular Crystals,"Hyperspecular Crystals are refined and crafted into components, modules and other items.",Hyperspecular_Crystals.png,uncommon,2708,2708,0,0,2708
5465,1293,4589,123,Neolysium,"Neolysium is refined and crafted into components, modules and other items.",Neolysium.png,uncommon,1421,1140,0,281,1140
5465,2385,10689,42,Base Minerals,"Base Minerals are refined and crafted into components, modules and other items.",Base_Mineral.png,abundant,5952,596,0,5356,596
5465,2423,10689,54,Hyperspecular Crystals,"Hyperspecular Crystals are refined and crafted into components, modules and other items.",Hyperspecular_Crystals.png,uncommon,1291,1291,0,0,1291
5465,2543,10689,113,Aerogens,"Aerogens are refined and crafted into components, modules and other items.",Aerogens.png,common,2553,0,0,2553,0
5465,2544,10689,54,Hyperspecular Crystals,"Hyperspecular Crystals are refined and crafted into components, modules and other items.",Hyperspecular_Crystals.png,uncommon,2679,1005,0,1674,1005
5480,3617,4604,113,Aerogens,"Aerogens are refined and crafted into components, modules and other items.",Aerogens.png,common,1234,0,0,1234,0
5480,3618,4604,106,Elastomers,"Elastomers are refined and crafted into components, modules and other items.",Elastomers.png,abundant,2934,0,0,2934,0
5480,3619,4604,113,Aerogens,"Aerogens are refined and crafted into components, modules and other items.",Aerogens.png,common,4884,0,0,4884,0
5487,82,4611,127,Microorganisms,"Microorganisms are refined and crafted into components, modules and other items.",Microorganism.png,rare,801,0,0,801,0
5487,405,4611,120,Metamagnetic Ore,"Metamagnetic Ore is refined and crafted into components, modules and other items.",Metamagnetic_Ore.png,uncommon,2660,0,0,2660,0
5487,406,4611,105,Silicates,"Silicates are refined and crafted into components, modules and other items.",Silicates.png,abundant,5191,0,0,5191,0
5487,615,10711,123,Neolysium,"Neolysium is refined and crafted into components, modules and other items.",Neolysium.png,uncommon,1059,0,0,1059,0
5487,4242,10711,42,Base Minerals,"Base Minerals are refined and crafted into components, modules and other items.",Base_Mineral.png,abundant,4655,0,0,4655,0
5487,4243,10711,114,Ectopolymers,"Ectopolymers are refined and crafted into components, modules and other items.",Ectopolymers.png,common,4328,0,0,4328,0
5487,4300,10711,42,Base Minerals,"Base Minerals are refined and crafted into components, modules and other items.",Base_Mineral.png,abundant,2263,0,0,2263,0
5488,832,4612,113,Aerogens,"Aerogens are refined and crafted into components, modules and other items.",Aerogens.png,common,1072,0,0,1072,0
5488,833,4612,121,Hypoatomic Substances,"Hypoatomic Substances are refined and crafted into components, modules and other items.",Hypoatomic_Substances.png,uncommon,2593,0,0,2593,0
5488,834,4612,113,Aerogens,"Aerogens are refined and crafted into components, modules and other items.",Aerogens.png,common,2224,0,0,2224,0
5493,3204,4617,123,Neolysium,"Neolysium is refined and crafted into components, modules and other items.",Neolysium.png,uncommon,1381,0,0,1381,0
5493,3205,4617,109,Titanium,"Titanium is refined and crafted into components, modules and other items.",Titanium.png,common,2611,0,0,2611,0
5493,3206,4617,114,Ectopolymers,"Ectopolymers are refined and crafted into components, modules and other items.",Ectopolymers.png,common,4598,0,0,4598,0
5498,3620,4622,52,Organic Compounds,"Organic Compounds are refined and crafted into components, modules and other items.",Organic_Compound.png,common,1203,0,0,1203,0
5498,3621,4622,107,H2O,"H2O is refined and crafted into components, modules and other items.",H20.png,abundant,2470,0,0,2470,0
5498,3622,4622,110,Plutonium,"Plutonium is refined and crafted into components, modules and other items.",Plutonium.png,common,5470,0,0,5470,0
5500,3623,4624,110,Plutonium,"Plutonium is refined and crafted into components, modules and other items.",Plutonium.png,common,1223,0,0,1223,0
5500,3624,4624,41,Xensium,"Xensium is refined and crafted into components, modules and other items.",Xensium.png,uncommon,2312,0,0,2312,0
5500,3625,4624,107,H2O,"H2O is refined and crafted into components, modules and other items.",H20.png,abundant,4035,0,0,4035,0
5502,2171,4626,40,Polymetals,"Polymetals are refined and crafted into components, modules and other items.",Polymetals.png,common,1188,0,0,1188,0
5502,2172,4626,126,Bruma Particles,"Bruma Particles are refined and crafted into components, modules and other items.",Bruma_Particle.png,rare,1770,0,0,1770,0
5502,2760,4626,105,Silicates,"Silicates are refined and crafted into components, modules and other items.",Silicates.png,abundant,5262,0,0,5262,0
5502,3773,10726,115,Nanofluids,"Nanofluids are refined and crafted into components, modules and other items.",Nanofluids.png,common,1212,0,0,1212,0
5502,3774,10726,115,Nanofluids,"Nanofluids are refined and crafted into components, modules and other items.",Nanofluids.png,common,2706,0,0,2706,0
5502,3775,10726,113,Aerogens,"Aerogens are refined and crafted into components, modules and other items.",Aerogens.png,common,5671,0,0,5671,0
5502,3776,10726,106,Elastomers,"Elastomers are refined and crafted into components, modules and other items.",Elastomers.png,abundant,5494,0,0,5494,0
5505,422,4629,114,Ectopolymers,"Ectopolymers are refined and crafted into components, modules and other items.",Ectopolymers.png,common,2512,0,0,2512,0
5505,490,4629,109,Titanium,"Titanium is refined and crafted into components, modules and other items.",Titanium.png,common,5575,0,0,5575,0
5505,525,4629,128,Tchaikovium,"Tchaikovium is refined and crafted into components, modules and other items.",Tchaikovium.png,rare,759,0,0,759,0
5505,18090,10729,112,Amphoteric Substances,"Amphoteric Substances are refined and crafted into components, modules and other items.",Amphoteric_Substances.png,common,1278,0,0,1278,0
5505,18091,10729,106,Elastomers,"Elastomers are refined and crafted into components, modules and other items.",Elastomers.png,abundant,2717,0,0,2717,0
5505,18092,10729,42,Base Minerals,"Base Minerals are refined and crafted into components, modules and other items.",Base_Mineral.png,abundant,5764,0,0,5764,0
5506,93,4630,107,H2O,"H2O is refined and crafted into components, modules and other items.",H20.png,abundant,4594,0,0,4594,0
5506,94,4630,107,H2O,"H2O is refined and crafted into components, modules and other items.",H20.png,abundant,2550,0,0,2550,0
5506,95,4630,107,H2O,"H2O is refined and crafted into components, modules and other items.",H20.png,abundant,2567,0,0,2567,0
5506,267,4630,54,Hyperspecular Crystals,"Hyperspecular Crystals are refined and crafted into components, modules and other items.",Hyperspecular_Crystals.png,uncommon,1444,0,0,1444,0
5506,3918,10730,109,Titanium,"Titanium is refined and crafted into components, modules and other items.",Titanium.png,common,2119,0,0,2119,0
5506,3919,10730,54,Hyperspecular Crystals,"Hyperspecular Crystals are refined and crafted into components, modules and other items.",Hyperspecular_Crystals.png,uncommon,1153,0,0,1153,0
5506,3920,10730,113,Aerogens,"Aerogens are refined and crafted into components, modules and other items.",Aerogens.png,common,1443,0,0,1443,0
5506,4462,10730,113,Aerogens,"Aerogens are refined and crafted into components, modules and other items.",Aerogens.png,common,5724,0,0,5724,0
5510,19808,4634,121,Hypoatomic Substances,"Hypoatomic Substances are refined and crafted into components, modules and other items.",Hypoatomic_Substances.png,uncommon,1405,0,0,1405,0
5510,19809,4634,127,Microorganisms,"Microorganisms are refined and crafted into components, modules and other items.",Microorganism.png,rare,1643,0,0,1643,0
5510,19810,4634,115,Nanofluids,"Nanofluids are refined and crafted into components, modules and other items.",Nanofluids.png,common,4804,0,0,4804,0
5510,19811,4634,107,H2O,"H2O is refined and crafted into components, modules and other items.",H20.png,abundant,5124,0,0,5124,0
5510,19812,10734,115,Nanofluids,"Nanofluids are refined and crafted into components, modules and other items.",Nanofluids.png,common,1325,0,0,1325,0
5510,19813,10734,128,Tchaikovium,"Tchaikovium is refined and crafted into components, modules and other items.",Tchaikovium.png,rare,1887,0,0,1887,0
5510,19814,10734,107,H2O,"H2O is refined and crafted into components, modules and other items.",H20.png,abundant,4482,0,0,4482,0
5513,2173,4637,110,Plutonium,"Plutonium is refined and crafted into components, modules and other items.",Plutonium.png,common,1462,0,0,1462,0
5513,2758,4637,120,Metamagnetic Ore,"Metamagnetic Ore is refined and crafted into components, modules and other items.",Metamagnetic_Ore.png,uncommon,2191,0,0,2191,0
5513,2759,4637,110,Plutonium,"Plutonium is refined and crafted into components, modules and other items.",Plutonium.png,common,5110,0,0,5110,0
5513,3549,10737,40,Polymetals,"Polymetals are refined and crafted into components, modules and other items.",Polymetals.png,common,1149,0,0,1149,0
5513,3550,10737,53,Ignis Ore,"Ignis Ore is refined and crafted into components, modules and other items.",Ignis_Ore.png,rare,714,0,0,714,0
5513,3551,10737,120,Metamagnetic Ore,"Metamagnetic Ore is refined and crafted into components, modules and other items.",Metamagnetic_Ore.png,uncommon,2089,0,0,2089,0
5513,3552,10737,105,Silicates,"Silicates are refined and crafted into components, modules and other items.",Silicates.png,abundant,4263,0,0,4263,0
5517,1005,4641,128,Tchaikovium,"Tchaikovium is refined and crafted into components, modules and other items.",Tchaikovium.png,rare,685,0,0,685,0
5517,1073,4641,105,Silicates,"Silicates are refined and crafted into components, modules and other items.",Silicates.png,abundant,2975,0,0,2975,0
5517,1092,4641,113,Aerogens,"Aerogens are refined and crafted into components, modules and other items.",Aerogens.png,common,5998,0,0,5998,0
5517,3294,10741,110,Plutonium,"Plutonium is refined and crafted into components, modules and other items.",Plutonium.png,common,1239,0,0,1239,0
5517,7802,10741,42,Base Minerals,"Base Minerals are refined and crafted into components, modules and other items.",Base_Mineral.png,abundant,2381,0,0,2381,0
5517,8551,10741,105,Silicates,"Silicates are refined and crafted into components, modules and other items.",Silicates.png,abundant,4937,0,0,4937,0
5518,1221,4642,123,Neolysium,"Neolysium is refined and crafted into components, modules and other items.",Neolysium.png,uncommon,4722,0,0,4722,0
5518,1553,4642,110,Plutonium,"Plutonium is refined and crafted into components, modules and other items.",Plutonium.png,common,2417,0,0,2417,0
5518,5942,4642,127,Microorganisms,"Microorganisms are refined and crafted into components, modules and other items.",Microorganism.png,rare,655,655,0,0,655
5518,1592,10742,107,H2O,"H2O is refined and crafted into components, modules and other items.",H20.png,abundant,5471,0,0,5471,0
5518,1593,10742,106,Elastomers,"Elastomers are refined and crafted into components, modules and other items.",Elastomers.png,abundant,5764,0,0,5764,0
5518,4214,10742,105,Silicates,"Silicates are refined and crafted into components, modules and other items.",Silicates.png,abundant,2246,0,0,2246,0
5518,6667,10742,128,Tchaikovium,"Tchaikovium is refined and crafted into components, modules and other items.",Tchaikovium.png,rare,873,873,0,0,873
5521,17167,4645,113,Aerogens,"Aerogens are refined and crafted into components, modules and other items.",Aerogens.png,common,1432,0,0,1432,0
5521,18550,4645,113,Aerogens,"Aerogens are refined and crafted into components, modules and other items.",Aerogens.png,common,2326,0,0,2326,0
5521,19870,4645,105,Silicates,"Silicates are refined and crafted into components, modules and other items.",Silicates.png,abundant,4682,0,0,4682,0
5528,4495,4652,106,Elastomers,"Elastomers are refined and crafted into components, modules and other items.",Elastomers.png,abundant,4798,0,0,4798,0
5528,4573,4652,128,Tchaikovium,"Tchaikovium is refined and crafted into components, modules and other items.",Tchaikovium.png,rare,749,0,0,749,0
5528,4574,4652,54,Hyperspecular Crystals,"Hyperspecular Crystals are refined and crafted into components, modules and other items.",Hyperspecular_Crystals.png,uncommon,2106,0,0,2106,0
5528,4575,4652,119,Novis Compounds,"Novis Compounds are refined and crafted into components, modules and other items.",Novis_Compound.png,uncommon,2476,0,0,2476,0
5528,4753,10752,128,Tchaikovium,"Tchaikovium is refined and crafted into components, modules and other items.",Tchaikovium.png,rare,899,0,0,899,0
5528,4772,10752,106,Elastomers,"Elastomers are refined and crafted into components, modules and other items.",Elastomers.png,abundant,4576,0,0,4576,0
5528,4800,10752,107,H2O,"H2O is refined and crafted into components, modules and other items.",H20.png,abundant,2490,0,0,2490,0
5529,3380,4653,54,Hyperspecular Crystals,"Hyperspecular Crystals are refined and crafted into components, modules and other items.",Hyperspecular_Crystals.png,uncommon,2324,0,0,2324,0
5542,2174,4666,40,Polymetals,"Polymetals are refined and crafted into components, modules and other items.",Polymetals.png,common,1209,0,0,1209,0
5542,2756,4666,121,Hypoatomic Substances,"Hypoatomic Substances are refined and crafted into components, modules and other items.",Hypoatomic_Substances.png,uncommon,2857,0,0,2857,0
5542,2757,4666,106,Elastomers,"Elastomers are refined and crafted into components, modules and other items.",Elastomers.png,abundant,4615,0,0,4615,0
5542,3777,10766,118,Platinyx,"Platinyx is refined and crafted into components, modules and other items.",Platinyx.png,uncommon,1492,0,0,1492,0
5542,3778,10766,114,Ectopolymers,"Ectopolymers are refined and crafted into components, modules and other items.",Ectopolymers.png,common,2999,0,0,2999,0
5542,3779,10766,107,H2O,"H2O is refined and crafted into components, modules and other items.",H20.png,abundant,4601,0,0,4601,0
5548,4111,4672,126,Bruma Particles,"Bruma Particles are refined and crafted into components, modules and other items.",Bruma_Particle.png,rare,692,0,0,692,0
5548,4112,4672,52,Organic Compounds,"Organic Compounds are refined and crafted into components, modules and other items.",Organic_Compound.png,common,2566,0,0,2566,0
5548,4113,4672,107,H2O,"H2O is refined and crafted into components, modules and other items.",H20.png,abundant,5703,0,0,5703,0
5552,3626,4676,128,Tchaikovium,"Tchaikovium is refined and crafted into components, modules and other items.",Tchaikovium.png,rare,746,0,0,746,0
5552,3627,4676,42,Base Minerals,"Base Minerals are refined and crafted into components, modules and other items.",Base_Mineral.png,abundant,2946,0,0,2946,0
5552,3628,4676,42,Base Minerals,"Base Minerals are refined and crafted into components, modules and other items.",Base_Mineral.png,abundant,4418,0,0,4418,0
5555,143,4679,41,Xensium,"Xensium is refined and crafted into components, modules and other items.",Xensium.png,uncommon,5190,0,0,5190,0
5555,1725,4679,119,Novis Compounds,"Novis Compounds are refined and crafted into components, modules and other items.",Novis_Compound.png,uncommon,2411,0,0,2411,0
5555,2315,4679,127,Microorganisms,"Microorganisms are refined and crafted into components, modules and other items.",Microorganism.png,rare,632,0,0,632,0
5555,2535,10779,41,Xensium,"Xensium is refined and crafted into components, modules and other items.",Xensium.png,uncommon,1318,0,0,1318,0
5555,3913,10779,119,Novis Compounds,"Novis Compounds are refined and crafted into components, modules and other items.",Novis_Compound.png,uncommon,2815,0,0,2815,0
5555,4296,10779,40,Polymetals,"Polymetals are refined and crafted into components, modules and other items.",Polymetals.png,common,5512,0,0,5512,0
5563,4595,4687,107,H2O,"H2O is refined and crafted into components, modules and other items.",H20.png,abundant,4376,0,0,4376,0
5563,4603,4687,127,Microorganisms,"Microorganisms are refined and crafted into components, modules and other items.",Microorganism.png,rare,724,0,0,724,0
5563,4604,4687,110,Plutonium,"Plutonium is refined and crafted into components, modules and other items.",Plutonium.png,common,1303,0,0,1303,0
5563,4671,4687,106,Elastomers,"Elastomers are refined and crafted into components, modules and other items.",Elastomers.png,abundant,2718,0,0,2718,0
5563,4672,4687,40,Polymetals,"Polymetals are refined and crafted into components, modules and other items.",Polymetals.png,common,2820,0,0,2820,0
5563,4571,10787,112,Amphoteric Substances,"Amphoteric Substances are refined and crafted into components, modules and other items.",Amphoteric_Substances.png,common,2083,0,0,2083,0
5563,4599,10787,105,Silicates,"Silicates are refined and crafted into components, modules and other items.",Silicates.png,abundant,5004,0,0,5004,0
5563,4600,10787,110,Plutonium,"Plutonium is refined and crafted into components, modules and other items.",Plutonium.png,common,4697,0,0,4697,0
5563,4673,10787,40,Polymetals,"Polymetals are refined and crafted into components, modules and other items.",Polymetals.png,common,1490,0,0,1490,0
5563,4674,10787,110,Plutonium,"Plutonium is refined and crafted into components, modules and other items.",Plutonium.png,common,1073,0,0,1073,0
5564,444,4688,53,Ignis Ore,"Ignis Ore is refined and crafted into components, modules and other items.",Ignis_Ore.png,rare,820,0,0,820,0
5564,446,4688,109,Titanium,"Titanium is refined and crafted into components, modules and other items.",Titanium.png,common,2428,0,0,2428,0
5564,447,4688,120,Metamagnetic Ore,"Metamagnetic Ore is refined and crafted into components, modules and other items.",Metamagnetic_Ore.png,uncommon,2342,0,0,2342,0
5564,450,4688,109,Titanium,"Titanium is refined and crafted into components, modules and other items.",Titanium.png,common,5026,0,0,5026,0
5564,451,4688,106,Elastomers,"Elastomers are refined and crafted into components, modules and other items.",Elastomers.png,abundant,4746,0,0,4746,0
5564,2323,10788,123,Neolysium,"Neolysium is refined and crafted into components, modules and other items.",Neolysium.png,uncommon,1155,0,0,1155,0
5564,2324,10788,112,Amphoteric Substances,"Amphoteric Substances are refined and crafted into components, modules and other items.",Amphoteric_Substances.png,common,1233,0,0,1233,0
5564,2381,10788,109,Titanium,"Titanium is refined and crafted into components, modules and other items.",Titanium.png,common,2554,0,0,2554,0
5564,3024,10788,112,Amphoteric Substances,"Amphoteric Substances are refined and crafted into components, modules and other items.",Amphoteric_Substances.png,common,4369,0,0,4369,0
5565,3207,4689,126,Bruma Particles,"Bruma Particles are refined and crafted into components, modules and other items.",Bruma_Particle.png,rare,609,0,0,609,0
5565,3208,4689,121,Hypoatomic Substances,"Hypoatomic Substances are refined and crafted into components, modules and other items.",Hypoatomic_Substances.png,uncommon,2853,0,0,2853,0
5565,3209,4689,115,Nanofluids,"Nanofluids are refined and crafted into components, modules and other items.",Nanofluids.png,common,5899,0,0,5899,0
5566,3629,4690,118,Platinyx,"Platinyx is refined and crafted into components, modules and other items.",Platinyx.png,uncommon,1418,0,0,1418,0
5566,3630,4690,121,Hypoatomic Substances,"Hypoatomic Substances are refined and crafted into components, modules and other items.",Hypoatomic_Substances.png,uncommon,2821,0,0,2821,0
5566,3631,4690,106,Elastomers,"Elastomers are refined and crafted into components, modules and other items.",Elastomers.png,abundant,4182,0,0,4182,0
5567,805,4691,128,Tchaikovium,"Tchaikovium is refined and crafted into components, modules and other items.",Tchaikovium.png,rare,863,0,0,863,0
5567,806,4691,115,Nanofluids,"Nanofluids are refined and crafted into components, modules and other items.",Nanofluids.png,common,2525,0,0,2525,0
5567,892,4691,110,Plutonium,"Plutonium is refined and crafted into components, modules and other items.",Plutonium.png,common,5222,0,0,5222,0
5567,18093,10791,128,Tchaikovium,"Tchaikovium is refined and crafted into components, modules and other items.",Tchaikovium.png,rare,798,0,0,798,0
5567,18094,10791,106,Elastomers,"Elastomers are refined and crafted into components, modules and other items.",Elastomers.png,abundant,2851,0,0,2851,0
5567,18095,10791,42,Base Minerals,"Base Minerals are refined and crafted into components, modules and other items.",Base_Mineral.png,abundant,4542,0,0,4542,0
5568,2175,4692,115,Nanofluids,"Nanofluids are refined and crafted into components, modules and other items.",Nanofluids.png,common,1380,0,0,1380,0
5568,2754,4692,52,Organic Compounds,"Organic Compounds are refined and crafted into components, modules and other items.",Organic_Compound.png,common,2093,0,0,2093,0
5568,2755,4692,42,Base Minerals,"Base Minerals are refined and crafted into components, modules and other items.",Base_Mineral.png,abundant,5587,0,0,5587,0
5568,3527,10792,127,Microorganisms,"Microorganisms are refined and crafted into components, modules and other items.",Microorganism.png,rare,847,0,0,847,0
5568,3528,10792,106,Elastomers,"Elastomers are refined and crafted into components, modules and other items.",Elastomers.png,abundant,2653,0,0,2653,0
5568,3529,10792,115,Nanofluids,"Nanofluids are refined and crafted into components, modules and other items.",Nanofluids.png,common,4859,0,0,4859,0
5571,3632,4695,41,Xensium,"Xensium is refined and crafted into components, modules and other items.",Xensium.png,uncommon,1442,0,0,1442,0
5571,3633,4695,127,Microorganisms,"Microorganisms are refined and crafted into components, modules and other items.",Microorganism.png,rare,1472,0,0,1472,0
5571,3634,4695,107,H2O,"H2O is refined and crafted into components, modules and other items.",H20.png,abundant,5988,0,0,5988,0
5583,17954,4707,105,Silicates,"Silicates are refined and crafted into components, modules and other items.",Silicates.png,abundant,4710,0,0,4710,0
5591,2278,4715,128,Tchaikovium,"Tchaikovium is refined and crafted into components, modules and other items.",Tchaikovium.png,rare,684,137,0,547,137
5591,2816,4715,42,Base Minerals,"Base Minerals are refined and crafted into components, modules and other items.",Base_Mineral.png,abundant,4359,0,0,4359,0
5591,4820,4715,107,H2O,"H2O is refined and crafted into components, modules and other items.",H20.png,abundant,2695,0,0,2695,0
5591,4821,10815,110,Plutonium,"Plutonium is refined and crafted into components, modules and other items.",Plutonium.png,common,1054,0,0,1054,0
5591,6106,10815,42,Base Minerals,"Base Minerals are refined and crafted into components, modules and other items.",Base_Mineral.png,abundant,5077,0,0,5077,0
5596,4372,4720,41,Xensium,"Xensium is refined and crafted into components, modules and other items.",Xensium.png,uncommon,1196,0,0,1196,0
5596,4835,4720,106,Elastomers,"Elastomers are refined and crafted into components, modules and other items.",Elastomers.png,abundant,5963,0,0,5963,0
5596,12217,4720,40,Polymetals,"Polymetals are refined and crafted into components, modules and other items.",Polymetals.png,common,2975,0,0,2975,0
5599,19815,4723,128,Tchaikovium,"Tchaikovium is refined and crafted into components, modules and other items.",Tchaikovium.png,rare,709,0,0,709,0
5599,19816,4723,128,Tchaikovium,"Tchaikovium is refined and crafted into components, modules and other items.",Tchaikovium.png,rare,653,0,0,653,0
5599,19817,4723,54,Hyperspecular Crystals,"Hyperspecular Crystals are refined and crafted into components, modules and other items.",Hyperspecular_Crystals.png,uncommon,2706,0,0,2706,0
5599,19818,4723,106,Elastomers,"Elastomers are refined and crafted into components, modules and other items.",Elastomers.png,abundant,4316,0,0,4316,0
5599,19819,10823,54,Hyperspecular Crystals,"Hyperspecular Crystals are refined and crafted into components, modules and other items.",Hyperspecular_Crystals.png,uncommon,1329,0,0,1329,0
5599,19820,10823,42,Base Minerals,"Base Minerals are refined and crafted into components, modules and other items.",Base_Mineral.png,abundant,2061,0,0,2061,0
5599,19821,10823,42,Base Minerals,"Base Minerals are refined and crafted into components, modules and other items.",Base_Mineral.png,abundant,4943,0,0,4943,0
5601,19822,4725,128,Tchaikovium,"Tchaikovium is refined and crafted into components, modules and other items.",Tchaikovium.png,rare,870,0,0,870,0
5601,19823,4725,119,Novis Compounds,"Novis Compounds are refined and crafted into components, modules and other items.",Novis_Compound.png,uncommon,1068,0,0,1068,0
5601,19824,4725,106,Elastomers,"Elastomers are refined and crafted into components, modules and other items.",Elastomers.png,abundant,5744,0,0,5744,0
5601,19825,4725,42,Base Minerals,"Base Minerals are refined and crafted into components, modules and other items.",Base_Mineral.png,abundant,2489,0,0,2489,0
5601,19826,10825,106,Elastomers,"Elastomers are refined and crafted into components, modules and other items.",Elastomers.png,abundant,4348,0,0,4348,0
5601,19827,10825,110,Plutonium,"Plutonium is refined and crafted into components, modules and other items.",Plutonium.png,common,4049,0,0,4049,0
5601,19828,10825,128,Tchaikovium,"Tchaikovium is refined and crafted into components, modules and other items.",Tchaikovium.png,rare,800,0,0,800,0
5601,19829,10825,110,Plutonium,"Plutonium is refined and crafted into components, modules and other items.",Plutonium.png,common,2368,0,0,2368,0
5602,9340,4726,126,Bruma Particles,"Bruma Particles are refined and crafted into components, modules and other items.",Bruma_Particle.png,rare,688,0,0,688,0
5602,9341,4726,107,H2O,"H2O is refined and crafted into components, modules and other items.",H20.png,abundant,2220,0,0,2220,0
5602,9342,4726,42,Base Minerals,"Base Minerals are refined and crafted into components, modules and other items.",Base_Mineral.png,abundant,4566,0,0,4566,0
5602,9343,10826,123,Neolysium,"Neolysium is refined and crafted into components, modules and other items.",Neolysium.png,uncommon,1233,0,0,1233,0
5602,9344,10826,109,Titanium,"Titanium is refined and crafted into components, modules and other items.",Titanium.png,common,2311,0,0,2311,0
5602,9345,10826,107,H2O,"H2O is refined and crafted into components, modules and other items.",H20.png,abundant,4455,0,0,4455,0
5603,18291,4727,120,Metamagnetic Ore,"Metamagnetic Ore is refined and crafted into components, modules and other items.",Metamagnetic_Ore.png,uncommon,1157,0,0,1157,0
5603,18292,4727,105,Silicates,"Silicates are refined and crafted into components, modules and other items.",Silicates.png,abundant,2201,0,0,2201,0
5603,18293,4727,112,Amphoteric Substances,"Amphoteric Substances are refined and crafted into components, modules and other items.",Amphoteric_Substances.png,common,5572,0,0,5572,0
5604,3421,4728,121,Hypoatomic Substances,"Hypoatomic Substances are refined and crafted into components, modules and other items.",Hypoatomic_Substances.png,uncommon,1369,0,0,1369,0
5604,3422,4728,121,Hypoatomic Substances,"Hypoatomic Substances are refined and crafted into components, modules and other items.",Hypoatomic_Substances.png,uncommon,2773,0,0,2773,0
5604,3423,4728,117,Yprasium,"Yprasium is refined and crafted into components, modules and other items.",Yprasium.png,uncommon,5891,0,0,5891,0
5607,10636,4731,110,Plutonium,"Plutonium is refined and crafted into components, modules and other items.",Plutonium.png,common,1137,0,0,1137,0
5607,10637,4731,42,Base Minerals,"Base Minerals are refined and crafted into components, modules and other items.",Base_Mineral.png,abundant,2370,0,0,2370,0
5608,4764,4732,126,Bruma Particles,"Bruma Particles are refined and crafted into components, modules and other items.",Bruma_Particle.png,rare,801,0,0,801,0
5608,4765,4732,113,Aerogens,"Aerogens are refined and crafted into components, modules and other items.",Aerogens.png,common,2719,0,0,2719,0
5608,4766,4732,106,Elastomers,"Elastomers are refined and crafted into components, modules and other items.",Elastomers.png,abundant,4319,0,0,4319,0
5608,4767,10832,113,Aerogens,"Aerogens are refined and crafted into components, modules and other items.",Aerogens.png,common,1239,0,0,1239,0
5608,4768,10832,117,Yprasium,"Yprasium is refined and crafted into components, modules and other items.",Yprasium.png,uncommon,2739,0,0,2739,0
5612,1076,4736,42,Base Minerals,"Base Minerals are refined and crafted into components, modules and other items.",Base_Mineral.png,abundant,5809,581,0,5228,581
5612,1181,4736,54,Hyperspecular Crystals,"Hyperspecular Crystals are refined and crafted into components, modules and other items.",Hyperspecular_Crystals.png,uncommon,2103,263,0,1840,263
5612,1582,4736,127,Microorganisms,"Microorganisms are refined and crafted into components, modules and other items.",Microorganism.png,rare,734,734,0,0,734
5612,2386,10836,109,Titanium,"Titanium is refined and crafted into components, modules and other items.",Titanium.png,common,4593,4593,0,0,4593
5612,2546,10836,113,Aerogens,"Aerogens are refined and crafted into components, modules and other items.",Aerogens.png,common,2890,362,0,2528,362
5612,2548,10836,53,Ignis Ore,"Ignis Ore is refined and crafted into components, modules and other items.",Ignis_Ore.png,rare,885,177,0,708,177
5618,987,4742,41,Xensium,"Xensium is refined and crafted into components, modules and other items.",Xensium.png,uncommon,2567,0,0,2567,0
5618,988,4742,106,Elastomers,"Elastomers are refined and crafted into components, modules and other items.",Elastomers.png,abundant,4684,0,0,4684,0
5618,1314,4742,115,Nanofluids,"Nanofluids are refined and crafted into components, modules and other items.",Nanofluids.png,common,1106,0,0,1106,0
5620,1138,4744,118,Platinyx,"Platinyx is refined and crafted into components, modules and other items.",Platinyx.png,uncommon,2153,0,0,2153,0
5620,1197,4744,118,Platinyx,"Platinyx is refined and crafted into components, modules and other items.",Platinyx.png,uncommon,1168,0,0,1168,0
5620,1198,4744,128,Tchaikovium,"Tchaikovium is refined and crafted into components, modules and other items.",Tchaikovium.png,rare,642,0,0,642,0
5620,1289,4744,105,Silicates,"Silicates are refined and crafted into components, modules and other items.",Silicates.png,abundant,5057,0,0,5057,0
5622,3039,4746,128,Tchaikovium,"Tchaikovium is refined and crafted into components, modules and other items.",Tchaikovium.png,rare,746,0,0,746,0
5622,3707,4746,54,Hyperspecular Crystals,"Hyperspecular Crystals are refined and crafted into components, modules and other items.",Hyperspecular_Crystals.png,uncommon,2824,1059,0,1765,1059
5622,7807,4746,106,Elastomers,"Elastomers are refined and crafted into components, modules and other items.",Elastomers.png,abundant,5738,0,0,5738,0
5622,7808,4746,105,Silicates,"Silicates are refined and crafted into components, modules and other items.",Silicates.png,abundant,5526,553,0,4973,553
5623,17759,4747,112,Amphoteric Substances,"Amphoteric Substances are refined and crafted into components, modules and other items.",Amphoteric_Substances.png,common,1485,0,0,1485,0
5623,18551,4747,40,Polymetals,"Polymetals are refined and crafted into components, modules and other items.",Polymetals.png,common,2224,0,0,2224,0
5623,19871,4747,105,Silicates,"Silicates are refined and crafted into components, modules and other items.",Silicates.png,abundant,5747,0,0,5747,0
5638,4373,4762,53,Ignis Ore,"Ignis Ore is refined and crafted into components, modules and other items.",Ignis_Ore.png,rare,892,0,0,892,0
5638,4374,4762,118,Platinyx,"Platinyx is refined and crafted into components, modules and other items.",Platinyx.png,uncommon,1377,0,0,1377,0
5642,1390,4766,117,Yprasium,"Yprasium is refined and crafted into components, modules and other items.",Yprasium.png,uncommon,2736,0,0,2736,0
5642,1391,4766,114,Ectopolymers,"Ectopolymers are refined and crafted into components, modules and other items.",Ectopolymers.png,common,2904,0,0,2904,0
5642,2609,4766,117,Yprasium,"Yprasium is refined and crafted into components, modules and other items.",Yprasium.png,uncommon,1389,0,0,1389,0
5642,2610,4766,114,Ectopolymers,"Ectopolymers are refined and crafted into components, modules and other items.",Ectopolymers.png,common,4516,0,0,4516,0
5646,11815,4770,53,Ignis Ore,"Ignis Ore is refined and crafted into components, modules and other items.",Ignis_Ore.png,rare,725,0,0,725,0
5646,11947,4770,114,Ectopolymers,"Ectopolymers are refined and crafted into components, modules and other items.",Ectopolymers.png,common,2068,0,0,2068,0
5646,17790,4770,113,Aerogens,"Aerogens are refined and crafted into components, modules and other items.",Aerogens.png,common,5984,0,0,5984,0
5646,18151,10870,107,H2O,"H2O is refined and crafted into components, modules and other items.",H20.png,abundant,4638,0,0,4638,0
5646,18152,10870,105,Silicates,"Silicates are refined and crafted into components, modules and other items.",Silicates.png,abundant,4479,0,0,4479,0
5650,2270,4774,40,Polymetals,"Polymetals are refined and crafted into components, modules and other items.",Polymetals.png,common,1237,0,0,1237,0
5650,2558,4774,119,Novis Compounds,"Novis Compounds are refined and crafted into components, modules and other items.",Novis_Compound.png,uncommon,2522,948,0,1574,948
5650,2583,4774,112,Amphoteric Substances,"Amphoteric Substances are refined and crafted into components, modules and other items.",Amphoteric_Substances.png,common,4807,0,0,4807,0
5650,2584,4774,106,Elastomers,"Elastomers are refined and crafted into components, modules and other items.",Elastomers.png,abundant,5083,0,0,5083,0
5662,7606,4786,127,Microorganisms,"Microorganisms are refined and crafted into components, modules and other items.",Microorganism.png,rare,634,0,0,634,0
5662,7607,4786,114,Ectopolymers,"Ectopolymers are refined and crafted into components, modules and other items.",Ectopolymers.png,common,4503,0,0,4503,0
5662,12972,4786,42,Base Minerals,"Base Minerals are refined and crafted into components, modules and other items.",Base_Mineral.png,abundant,2679,0,0,2679,0
5662,7608,10886,53,Ignis Ore,"Ignis Ore is refined and crafted into components, modules and other items.",Ignis_Ore.png,rare,765,0,0,765,0
5662,12970,10886,105,Silicates,"Silicates are refined and crafted into components, modules and other items.",Silicates.png,abundant,2645,0,0,2645,0
5662,12971,10886,114,Ectopolymers,"Ectopolymers are refined and crafted into components, modules and other items.",Ectopolymers.png,common,5886,0,0,5886,0
5674,20733,4798,113,Aerogens,"Aerogens are refined and crafted into components, modules and other items.",Aerogens.png,common,2695,0,0,2695,0
5679,17458,4803,106,Elastomers,"Elastomers are refined and crafted into components, modules and other items.",Elastomers.png,abundant,5998,0,0,5998,0
5679,17459,4803,115,Nanofluids,"Nanofluids are refined and crafted into components, modules and other items.",Nanofluids.png,common,2945,0,0,2945,0
5679,18514,4803,126,Bruma Particles,"Bruma Particles are refined and crafted into components, modules and other items.",Bruma_Particle.png,rare,664,0,0,664,0
5679,18515,4803,126,Bruma Particles,"Bruma Particles are refined and crafted into components, modules and other items.",Bruma_Particle.png,rare,784,0,0,784,0
5683,92,4807,53,Ignis Ore,"Ignis Ore is refined and crafted into components, modules and other items.",Ignis_Ore.png,rare,799,0,0,799,0
5687,236,4811,42,Base Minerals,"Base Minerals are refined and crafted into components, modules and other items.",Base_Mineral.png,abundant,4748,0,0,4748,0
5687,1525,4811,54,Hyperspecular Crystals,"Hyperspecular Crystals are refined and crafted into components, modules and other items.",Hyperspecular_Crystals.png,uncommon,2818,353,0,2465,353
5687,4308,4811,126,Bruma Particles,"Bruma Particles are refined and crafted into components, modules and other items.",Bruma_Particle.png,rare,884,0,0,884,0
5687,4309,10911,107,H2O,"H2O is refined and crafted into components, modules and other items.",H20.png,abundant,2693,0,0,2693,0
5687,4310,10911,109,Titanium,"Titanium is refined and crafted into components, modules and other items.",Titanium.png,common,5423,0,0,5423,0
5687,4343,10911,126,Bruma Particles,"Bruma Particles are refined and crafted into components, modules and other items.",Bruma_Particle.png,rare,896,0,0,896,0
5718,3424,4842,126,Bruma Particles,"Bruma Particles are refined and crafted into components, modules and other items.",Bruma_Particle.png,rare,638,0,0,638,0
5718,3425,4842,118,Platinyx,"Platinyx is refined and crafted into components, modules and other items.",Platinyx.png,uncommon,2836,0,0,2836,0
5718,3449,4842,110,Plutonium,"Plutonium is refined and crafted into components, modules and other items.",Plutonium.png,common,5300,0,0,5300,0
5719,16744,4843,110,Plutonium,"Plutonium is refined and crafted into components, modules and other items.",Plutonium.png,common,1354,0,0,1354,0
5719,16745,4843,106,Elastomers,"Elastomers are refined and crafted into components, modules and other items.",Elastomers.png,abundant,2433,0,0,2433,0
5719,16746,4843,107,H2O,"H2O is refined and crafted into components, modules and other items.",H20.png,abundant,5299,0,0,5299,0
5726,3450,4850,127,Microorganisms,"Microorganisms are refined and crafted into components, modules and other items.",Microorganism.png,rare,761,0,0,761,0
5726,3451,4850,107,H2O,"H2O is refined and crafted into components, modules and other items.",H20.png,abundant,2227,0,0,2227,0
5726,3452,4850,107,H2O,"H2O is refined and crafted into components, modules and other items.",H20.png,abundant,4110,0,0,4110,0
5740,4496,4864,105,Silicates,"Silicates are refined and crafted into components, modules and other items.",Silicates.png,abundant,5906,0,0,5906,0
5740,4576,4864,126,Bruma Particles,"Bruma Particles are refined and crafted into components, modules and other items.",Bruma_Particle.png,rare,871,0,0,871,0
5740,4577,4864,112,Amphoteric Substances,"Amphoteric Substances are refined and crafted into components, modules and other items.",Amphoteric_Substances.png,common,2740,0,0,2740,0
5740,4754,10964,112,Amphoteric Substances,"Amphoteric Substances are refined and crafted into components, modules and other items.",Amphoteric_Substances.png,common,1334,0,0,1334,0
5740,4822,10964,118,Platinyx,"Platinyx is refined and crafted into components, modules and other items.",Platinyx.png,uncommon,2101,0,0,2101,0
5740,4832,10964,107,H2O,"H2O is refined and crafted into components, modules and other items.",H20.png,abundant,5914,0,0,5914,0
5750,8351,4874,121,Hypoatomic Substances,"Hypoatomic Substances are refined and crafted into components, modules and other items.",Hypoatomic_Substances.png,uncommon,1398,0,0,1398,0
5750,11221,4874,105,Silicates,"Silicates are refined and crafted into components, modules and other items.",Silicates.png,abundant,4667,467,0,4200,467
5750,12681,4874,121,Hypoatomic Substances,"Hypoatomic Substances are refined and crafted into components, modules and other items.",Hypoatomic_Substances.png,uncommon,2065,0,0,2065,0
5750,9901,10974,110,Plutonium,"Plutonium is refined and crafted into components, modules and other items.",Plutonium.png,common,1249,0,0,1249,0
5750,10068,10974,105,Silicates,"Silicates are refined and crafted into components, modules and other items.",Silicates.png,abundant,4097,410,0,3687,410
5750,12938,10974,106,Elastomers,"Elastomers are refined and crafted into components, modules and other items.",Elastomers.png,abundant,2866,0,0,2866,0
5753,424,4877,128,Tchaikovium,"Tchaikovium is refined and crafted into components, modules and other items.",Tchaikovium.png,rare,791,0,0,791,0
5753,2750,4877,54,Hyperspecular Crystals,"Hyperspecular Crystals are refined and crafted into components, modules and other items.",Hyperspecular_Crystals.png,uncommon,2587,0,0,2587,0
5753,2751,4877,106,Elastomers,"Elastomers are refined and crafted into components, modules and other items.",Elastomers.png,abundant,4859,0,0,4859,0
5753,1085,10977,119,Novis Compounds,"Novis Compounds are refined and crafted into components, modules and other items.",Novis_Compound.png,uncommon,2702,0,0,2702,0
5753,2752,10977,119,Novis Compounds,"Novis Compounds are refined and crafted into components, modules and other items.",Novis_Compound.png,uncommon,1319,0,0,1319,0
5753,2753,10977,119,Novis Compounds,"Novis Compounds are refined and crafted into components, modules and other items.",Novis_Compound.png,uncommon,1218,0,0,1218,0
5753,4176,10977,42,Base Minerals,"Base Minerals are refined and crafted into components, modules and other items.",Base_Mineral.png,abundant,4989,0,0,4989,0
5755,20005,4879,105,Silicates,"Silicates are refined and crafted into components, modules and other items.",Silicates.png,abundant,4623,0,0,4623,0
5756,1392,4880,113,Aerogens,"Aerogens are refined and crafted into components, modules and other items.",Aerogens.png,common,2609,0,0,2609,0
5756,2607,4880,54,Hyperspecular Crystals,"Hyperspecular Crystals are refined and crafted into components, modules and other items.",Hyperspecular_Crystals.png,uncommon,1018,0,0,1018,0
5756,2608,4880,107,H2O,"H2O is refined and crafted into components, modules and other items.",H20.png,abundant,4855,0,0,4855,0
5757,4314,4881,114,Ectopolymers,"Ectopolymers are refined and crafted into components, modules and other items.",Ectopolymers.png,common,4892,0,0,4892,0
5757,4427,4881,54,Hyperspecular Crystals,"Hyperspecular Crystals are refined and crafted into components, modules and other items.",Hyperspecular_Crystals.png,uncommon,1459,0,0,1459,0
5757,17737,4881,110,Plutonium,"Plutonium is refined and crafted into components, modules and other items.",Plutonium.png,common,2113,0,0,2113,0
5765,2746,4889,123,Neolysium,"Neolysium is refined and crafted into components, modules and other items.",Neolysium.png,uncommon,1077,0,0,1077,0
5765,2747,4889,112,Amphoteric Substances,"Amphoteric Substances are refined and crafted into components, modules and other items.",Amphoteric_Substances.png,common,2748,0,0,2748,0
5765,2748,4889,105,Silicates,"Silicates are refined and crafted into components, modules and other items.",Silicates.png,abundant,5094,0,0,5094,0
5765,2749,10989,123,Neolysium,"Neolysium is refined and crafted into components, modules and other items.",Neolysium.png,uncommon,1443,0,0,1443,0
5765,4171,10989,109,Titanium,"Titanium is refined and crafted into components, modules and other items.",Titanium.png,common,2973,0,0,2973,0
5765,4172,10989,105,Silicates,"Silicates are refined and crafted into components, modules and other items.",Silicates.png,abundant,4209,0,0,4209,0
5772,11848,4896,126,Bruma Particles,"Bruma Particles are refined and crafted into components, modules and other items.",Bruma_Particle.png,rare,758,0,0,758,0
5772,12343,4896,115,Nanofluids,"Nanofluids are refined and crafted into components, modules and other items.",Nanofluids.png,common,2061,0,0,2061,0
5772,12344,4896,52,Organic Compounds,"Organic Compounds are refined and crafted into components, modules and other items.",Organic_Compound.png,common,5659,0,0,5659,0
5772,12345,4896,106,Elastomers,"Elastomers are refined and crafted into components, modules and other items.",Elastomers.png,abundant,5458,0,0,5458,0
5775,4114,4899,127,Microorganisms,"Microorganisms are refined and crafted into components, modules and other items.",Microorganism.png,rare,871,0,0,871,0
5775,4115,4899,41,Xensium,"Xensium is refined and crafted into components, modules and other items.",Xensium.png,uncommon,2894,0,0,2894,0
5775,4116,4899,107,H2O,"H2O is refined and crafted into components, modules and other items.",H20.png,abundant,5643,0,0,5643,0
5780,2552,4904,54,Hyperspecular Crystals,"Hyperspecular Crystals are refined and crafted into components, modules and other items.",Hyperspecular_Crystals.png,uncommon,1031,0,0,1031,0
5780,2553,4904,126,Bruma Particles,"Bruma Particles are refined and crafted into components, modules and other items.",Bruma_Particle.png,rare,746,0,0,746,0
5780,2554,4904,54,Hyperspecular Crystals,"Hyperspecular Crystals are refined and crafted into components, modules and other items.",Hyperspecular_Crystals.png,uncommon,2292,0,0,2292,0
5780,2689,4904,42,Base Minerals,"Base Minerals are refined and crafted into components, modules and other items.",Base_Mineral.png,abundant,4409,0,0,4409,0
5782,1081,4906,107,H2O,"H2O is refined and crafted into components, modules and other items.",H20.png,abundant,4454,446,0,4008,446
5782,1182,4906,113,Aerogens,"Aerogens are refined and crafted into components, modules and other items.",Aerogens.png,common,2298,288,0,2010,288
5782,1636,4906,126,Bruma Particles,"Bruma Particles are refined and crafted into components, modules and other items.",Bruma_Particle.png,rare,785,785,0,0,785
5782,2387,11006,112,Amphoteric Substances,"Amphoteric Substances are refined and crafted into components, modules and other items.",Amphoteric_Substances.png,common,5523,553,0,4970,553
5782,2547,11006,114,Ectopolymers,"Ectopolymers are refined and crafted into components, modules and other items.",Ectopolymers.png,common,2556,320,0,2236,320
5782,2549,11006,54,Hyperspecular Crystals,"Hyperspecular Crystals are refined and crafted into components, modules and other items.",Hyperspecular_Crystals.png,uncommon,1211,243,0,968,243
5783,2787,4907,117,Yprasium,"Yprasium is refined and crafted into components, modules and other items.",Yprasium.png,uncommon,1295,0,0,1295,0
5783,2788,4907,113,Aerogens,"Aerogens are refined and crafted into components, modules and other items.",Aerogens.png,common,2762,0,0,2762,0
5783,2789,4907,113,Aerogens,"Aerogens are refined and crafted into components, modules and other items.",Aerogens.png,common,2869,0,0,2869,0
5783,2790,4907,105,Silicates,"Silicates are refined and crafted into components, modules and other items.",Silicates.png,abundant,5569,0,0,5569,0
5785,18487,4909,110,Plutonium,"Plutonium is refined and crafted into components, modules and other items.",Plutonium.png,common,2428,0,0,2428,0
5786,4375,4910,114,Ectopolymers,"Ectopolymers are refined and crafted into components, modules and other items.",Ectopolymers.png,common,1004,0,0,1004,0
5786,4836,4910,52,Organic Compounds,"Organic Compounds are refined and crafted into components, modules and other items.",Organic_Compound.png,common,4814,0,0,4814,0
5786,12218,4910,127,Microorganisms,"Microorganisms are refined and crafted into components, modules and other items.",Microorganism.png,rare,1552,0,0,1552,0
5789,2741,4913,126,Bruma Particles,"Bruma Particles are refined and crafted into components, modules and other items.",Bruma_Particle.png,rare,791,0,0,791,0
5789,2742,4913,126,Bruma Particles,"Bruma Particles are refined and crafted into components, modules and other items.",Bruma_Particle.png,rare,1866,0,0,1866,0
5789,2743,4913,105,Silicates,"Silicates are refined and crafted into components, modules and other items.",Silicates.png,abundant,4275,0,0,4275,0
5789,2744,4913,113,Aerogens,"Aerogens are refined and crafted into components, modules and other items.",Aerogens.png,common,5451,0,0,5451,0
5789,2745,11013,113,Aerogens,"Aerogens are refined and crafted into components, modules and other items.",Aerogens.png,common,1149,0,0,1149,0
5789,4185,11013,113,Aerogens,"Aerogens are refined and crafted into components, modules and other items.",Aerogens.png,common,2571,0,0,2571,0
5789,4186,11013,107,H2O,"H2O is refined and crafted into components, modules and other items.",H20.png,abundant,5828,0,0,5828,0
5792,3210,4916,52,Organic Compounds,"Organic Compounds are refined and crafted into components, modules and other items.",Organic_Compound.png,common,1139,0,0,1139,0
5792,3211,4916,107,H2O,"H2O is refined and crafted into components, modules and other items.",H20.png,abundant,2912,0,0,2912,0
5792,3212,4916,40,Polymetals,"Polymetals are refined and crafted into components, modules and other items.",Polymetals.png,common,5363,0,0,5363,0
5799,4833,4923,114,Ectopolymers,"Ectopolymers are refined and crafted into components, modules and other items.",Ectopolymers.png,common,1388,0,0,1388,0
5799,4834,4923,105,Silicates,"Silicates are refined and crafted into components, modules and other items.",Silicates.png,abundant,4041,0,0,4041,0
5799,12739,4923,114,Ectopolymers,"Ectopolymers are refined and crafted into components, modules and other items.",Ectopolymers.png,common,2966,0,0,2966,0
5805,7558,4929,109,Titanium,"Titanium is refined and crafted into components, modules and other items.",Titanium.png,common,2324,0,0,2324,0
5805,8285,4929,53,Ignis Ore,"Ignis Ore is refined and crafted into components, modules and other items.",Ignis_Ore.png,rare,727,0,0,727,0
5805,9967,4929,112,Amphoteric Substances,"Amphoteric Substances are refined and crafted into components, modules and other items.",Amphoteric_Substances.png,common,5280,0,0,5280,0
5806,4548,4930,109,Titanium,"Titanium is refined and crafted into components, modules and other items.",Titanium.png,common,5109,0,0,5109,0
5806,4578,4930,126,Bruma Particles,"Bruma Particles are refined and crafted into components, modules and other items.",Bruma_Particle.png,rare,645,0,0,645,0
5806,4849,4930,42,Base Minerals,"Base Minerals are refined and crafted into components, modules and other items.",Base_Mineral.png,abundant,2831,0,0,2831,0
5806,4801,11030,113,Aerogens,"Aerogens are refined and crafted into components, modules and other items.",Aerogens.png,common,1432,0,0,1432,0
5806,4845,11030,109,Titanium,"Titanium is refined and crafted into components, modules and other items.",Titanium.png,common,2217,0,0,2217,0
5806,4854,11030,105,Silicates,"Silicates are refined and crafted into components, modules and other items.",Silicates.png,abundant,5835,0,0,5835,0
5807,3453,4931,119,Novis Compounds,"Novis Compounds are refined and crafted into components, modules and other items.",Novis_Compound.png,uncommon,1021,0,0,1021,0
5807,3454,4931,123,Neolysium,"Neolysium is refined and crafted into components, modules and other items.",Neolysium.png,uncommon,2227,0,0,2227,0
5807,3455,4931,106,Elastomers,"Elastomers are refined and crafted into components, modules and other items.",Elastomers.png,abundant,5679,0,0,5679,0
5810,3456,4934,53,Ignis Ore,"Ignis Ore is refined and crafted into components, modules and other items.",Ignis_Ore.png,rare,607,0,0,607,0
5810,3457,4934,109,Titanium,"Titanium is refined and crafted into components, modules and other items.",Titanium.png,common,2778,0,0,2778,0
5810,3458,4934,105,Silicates,"Silicates are refined and crafted into components, modules and other items.",Silicates.png,abundant,5192,0,0,5192,0
5812,3459,4936,117,Yprasium,"Yprasium is refined and crafted into components, modules and other items.",Yprasium.png,uncommon,1394,0,0,1394,0
5812,3460,4936,107,H2O,"H2O is refined and crafted into components, modules and other items.",H20.png,abundant,2553,0,0,2553,0
5812,3461,4936,115,Nanofluids,"Nanofluids are refined and crafted into components, modules and other items.",Nanofluids.png,common,5542,0,0,5542,0
5813,19872,4937,42,Base Minerals,"Base Minerals are refined and crafted into components, modules and other items.",Base_Mineral.png,abundant,4636,0,0,4636,0
5813,20965,4937,110,Plutonium,"Plutonium is refined and crafted into components, modules and other items.",Plutonium.png,common,1152,0,0,1152,0
5813,20966,4937,106,Elastomers,"Elastomers are refined and crafted into components, modules and other items.",Elastomers.png,abundant,2762,0,0,2762,0
5814,5347,4938,107,H2O,"H2O is refined and crafted into components, modules and other items.",H20.png,abundant,2595,0,0,2595,0
5814,5348,4938,42,Base Minerals,"Base Minerals are refined and crafted into components, modules and other items.",Base_Mineral.png,abundant,4921,0,0,4921,0
5814,5482,4938,127,Microorganisms,"Microorganisms are refined and crafted into components, modules and other items.",Microorganism.png,rare,785,0,0,785,0
5814,5483,4938,128,Tchaikovium,"Tchaikovium is refined and crafted into components, modules and other items.",Tchaikovium.png,rare,607,0,0,607,0
5814,17794,11038,118,Platinyx,"Platinyx is refined and crafted into components, modules and other items.",Platinyx.png,uncommon,1482,0,0,1482,0
5814,17989,11038,118,Platinyx,"Platinyx is refined and crafted into components, modules and other items.",Platinyx.png,uncommon,2155,0,0,2155,0
5814,18573,11038,106,Elastomers,"Elastomers are refined and crafted into components, modules and other items.",Elastomers.png,abundant,4359,0,0,4359,0
5819,34,4943,52,Organic Compounds,"Organic Compounds are refined and crafted into components, modules and other items.",Organic_Compound.png,common,2925,0,0,2925,0
5819,35,4943,107,H2O,"H2O is refined and crafted into components, modules and other items.",H20.png,abundant,2763,346,0,2417,346
5819,14128,4943,105,Silicates,"Silicates are refined and crafted into components, modules and other items.",Silicates.png,abundant,4852,0,0,4852,0
5820,1336,4944,118,Platinyx,"Platinyx is refined and crafted into components, modules and other items.",Platinyx.png,uncommon,1340,0,0,1340,0
5820,1337,4944,118,Platinyx,"Platinyx is refined and crafted into components, modules and other items.",Platinyx.png,uncommon,1285,0,0,1285,0
5820,1338,4944,105,Silicates,"Silicates are refined and crafted into components, modules and other items.",Silicates.png,abundant,2636,0,0,2636,0
5820,1339,4944,118,Platinyx,"Platinyx is refined and crafted into components, modules and other items.",Platinyx.png,uncommon,5966,0,0,5966,0
5820,8350,11044,107,H2O,"H2O is refined and crafted into components, modules and other items.",H20.png,abundant,5216,0,0,5216,0
5820,8548,11044,114,Ectopolymers,"Ectopolymers are refined and crafted into components, modules and other items.",Ectopolymers.png,common,1475,0,0,1475,0
5820,8549,11044,114,Ectopolymers,"Ectopolymers are refined and crafted into components, modules and other items.",Ectopolymers.png,common,2335,0,0,2335,0
5821,3213,4945,117,Yprasium,"Yprasium is refined and crafted into components, modules and other items.",Yprasium.png,uncommon,1083,0,0,1083,0
5821,3214,4945,117,Yprasium,"Yprasium is refined and crafted into components, modules and other items.",Yprasium.png,uncommon,2080,0,0,2080,0
5821,3215,4945,105,Silicates,"Silicates are refined and crafted into components, modules and other items.",Silicates.png,abundant,5083,0,0,5083,0
5822,835,4946,117,Yprasium,"Yprasium is refined and crafted into components, modules and other items.",Yprasium.png,uncommon,1393,0,0,1393,0
5822,836,4946,109,Titanium,"Titanium is refined and crafted into components, modules and other items.",Titanium.png,common,2116,0,0,2116,0
5828,3462,4952,127,Microorganisms,"Microorganisms are refined and crafted into components, modules and other items.",Microorganism.png,rare,752,0,0,752,0
5828,3463,4952,40,Polymetals,"Polymetals are refined and crafted into components, modules and other items.",Polymetals.png,common,2930,0,0,2930,0
5828,3464,4952,106,Elastomers,"Elastomers are refined and crafted into components, modules and other items.",Elastomers.png,abundant,4023,0,0,4023,0
5829,3216,4953,53,Ignis Ore,"Ignis Ore is refined and crafted into components, modules and other items.",Ignis_Ore.png,rare,894,0,0,894,0
5829,3217,4953,114,Ectopolymers,"Ectopolymers are refined and crafted into components, modules and other items.",Ectopolymers.png,common,2162,0,0,2162,0
5829,3218,4953,107,H2O,"H2O is refined and crafted into components, modules and other items.",H20.png,abundant,4036,0,0,4036,0
5829,3219,4953,105,Silicates,"Silicates are refined and crafted into components, modules and other items.",Silicates.png,abundant,4852,0,0,4852,0
5831,1393,4955,105,Silicates,"Silicates are refined and crafted into components, modules and other items.",Silicates.png,abundant,2943,0,0,2943,0
5831,2605,4955,53,Ignis Ore,"Ignis Ore is refined and crafted into components, modules and other items.",Ignis_Ore.png,rare,899,0,0,899,0
5831,2606,4955,109,Titanium,"Titanium is refined and crafted into components, modules and other items.",Titanium.png,common,4902,0,0,4902,0
5833,2635,4957,105,Silicates,"Silicates are refined and crafted into components, modules and other items.",Silicates.png,abundant,4739,0,0,4739,0
5833,2636,4957,114,Ectopolymers,"Ectopolymers are refined and crafted into components, modules and other items.",Ectopolymers.png,common,2642,0,0,2642,0
5833,6668,4957,53,Ignis Ore,"Ignis Ore is refined and crafted into components, modules and other items.",Ignis_Ore.png,rare,733,0,0,733,0
5833,2637,11057,107,H2O,"H2O is refined and crafted into components, modules and other items.",H20.png,abundant,2361,0,0,2361,0
5833,2638,11057,118,Platinyx,"Platinyx is refined and crafted into components, modules and other items.",Platinyx.png,uncommon,2026,0,0,2026,0
5833,4658,11057,52,Organic Compounds,"Organic Compounds are refined and crafted into components, modules and other items.",Organic_Compound.png,common,5318,0,0,5318,0
5833,6670,11057,117,Yprasium,"Yprasium is refined and crafted into components, modules and other items.",Yprasium.png,uncommon,1239,0,0,1239,0
5839,4837,4963,115,Nanofluids,"Nanofluids are refined and crafted into components, modules and other items.",Nanofluids.png,common,5559,0,0,5559,0
5839,4838,4963,115,Nanofluids,"Nanofluids are refined and crafted into components, modules and other items.",Nanofluids.png,common,1378,0,0,1378,0
5839,12740,4963,109,Titanium,"Titanium is refined and crafted into components, modules and other items.",Titanium.png,common,2162,0,0,2162,0
5841,18286,4965,127,Microorganisms,"Microorganisms are refined and crafted into components, modules and other items.",Microorganism.png,rare,773,0,0,773,0
5841,18287,4965,113,Aerogens,"Aerogens are refined and crafted into components, modules and other items.",Aerogens.png,common,1075,0,0,1075,0
5841,18288,4965,107,H2O,"H2O is refined and crafted into components, modules and other items.",H20.png,abundant,2032,0,0,2032,0
5841,18289,4965,106,Elastomers,"Elastomers are refined and crafted into components, modules and other items.",Elastomers.png,abundant,2002,0,0,2002,0
5841,18290,4965,106,Elastomers,"Elastomers are refined and crafted into components, modules and other items.",Elastomers.png,abundant,4673,0,0,4673,0
5848,1147,4972,106,Elastomers,"Elastomers are refined and crafted into components, modules and other items.",Elastomers.png,abundant,5189,519,0,4670,519
5848,1148,4972,106,Elastomers,"Elastomers are refined and crafted into components, modules and other items.",Elastomers.png,abundant,4455,446,0,4009,446
5848,1294,4972,40,Polymetals,"Polymetals are refined and crafted into components, modules and other items.",Polymetals.png,common,2792,349,0,2443,349
5848,1638,4972,40,Polymetals,"Polymetals are refined and crafted into components, modules and other items.",Polymetals.png,common,1383,277,0,1106,277
5848,1639,4972,120,Metamagnetic Ore,"Metamagnetic Ore is refined and crafted into components, modules and other items.",Metamagnetic_Ore.png,uncommon,1037,1037,0,0,1037
5848,2388,11072,105,Silicates,"Silicates are refined and crafted into components, modules and other items.",Silicates.png,abundant,4743,475,0,4268,475
5848,2550,11072,121,Hypoatomic Substances,"Hypoatomic Substances are refined and crafted into components, modules and other items.",Hypoatomic_Substances.png,uncommon,1320,1320,0,0,1320
5848,2570,11072,42,Base Minerals,"Base Minerals are refined and crafted into components, modules and other items.",Base_Mineral.png,abundant,2732,342,0,2390,342
5849,4117,4973,53,Ignis Ore,"Ignis Ore is refined and crafted into components, modules and other items.",Ignis_Ore.png,rare,742,0,0,742,0
5849,4118,4973,112,Amphoteric Substances,"Amphoteric Substances are refined and crafted into components, modules and other items.",Amphoteric_Substances.png,common,2654,0,0,2654,0
5849,4119,4973,42,Base Minerals,"Base Minerals are refined and crafted into components, modules and other items.",Base_Mineral.png,abundant,5735,0,0,5735,0
5853,3069,4977,107,H2O,"H2O is refined and crafted into components, modules and other items.",H20.png,abundant,2137,1340,0,797,1340
5855,2193,4979,106,Elastomers,"Elastomers are refined and crafted into components, modules and other items.",Elastomers.png,abundant,4180,0,0,4180,0
5855,2231,4979,126,Bruma Particles,"Bruma Particles are refined and crafted into components, modules and other items.",Bruma_Particle.png,rare,886,0,0,886,0
5855,2283,4979,117,Yprasium,"Yprasium is refined and crafted into components, modules and other items.",Yprasium.png,uncommon,2215,0,0,2215,0
5855,4076,11079,126,Bruma Particles,"Bruma Particles are refined and crafted into components, modules and other items.",Bruma_Particle.png,rare,824,0,0,824,0
5855,4077,11079,117,Yprasium,"Yprasium is refined and crafted into components, modules and other items.",Yprasium.png,uncommon,2477,0,0,2477,0
5855,4078,11079,105,Silicates,"Silicates are refined and crafted into components, modules and other items.",Silicates.png,abundant,5480,0,0,5480,0
5856,9869,4980,40,Polymetals,"Polymetals are refined and crafted into components, modules and other items.",Polymetals.png,common,1163,0,0,1163,0
5856,10069,4980,112,Amphoteric Substances,"Amphoteric Substances are refined and crafted into components, modules and other items.",Amphoteric_Substances.png,common,4449,0,0,4449,0
5856,13960,11080,106,Elastomers,"Elastomers are refined and crafted into components, modules and other items.",Elastomers.png,abundant,4902,0,0,4902,0
5859,1394,4983,118,Platinyx,"Platinyx is refined and crafted into components, modules and other items.",Platinyx.png,uncommon,2155,0,0,2155,0
5859,2603,4983,40,Polymetals,"Polymetals are refined and crafted into components, modules and other items.",Polymetals.png,common,1174,0,0,1174,0
5859,2604,4983,110,Plutonium,"Plutonium is refined and crafted into components, modules and other items.",Plutonium.png,common,4917,0,0,4917,0
5862,8454,4986,123,Neolysium,"Neolysium is refined and crafted into components, modules and other items.",Neolysium.png,uncommon,1144,0,0,1144,0
5862,9969,4986,105,Silicates,"Silicates are refined and crafted into components, modules and other items.",Silicates.png,abundant,5889,0,0,5889,0
5862,12574,4986,112,Amphoteric Substances,"Amphoteric Substances are refined and crafted into components, modules and other items.",Amphoteric_Substances.png,common,2862,0,0,2862,0
5863,3040,4987,112,Amphoteric Substances,"Amphoteric Substances are refined and crafted into components, modules and other items.",Amphoteric_Substances.png,common,1349,0,0,1349,0
5863,3708,4987,106,Elastomers,"Elastomers are refined and crafted into components, modules and other items.",Elastomers.png,abundant,2508,0,0,2508,0
5863,7809,4987,107,H2O,"H2O is refined and crafted into components, modules and other items.",H20.png,abundant,4571,458,0,4113,458
5864,8205,4988,105,Silicates,"Silicates are refined and crafted into components, modules and other items.",Silicates.png,abundant,2995,0,0,2995,0
5864,8979,4988,114,Ectopolymers,"Ectopolymers are refined and crafted into components, modules and other items.",Ectopolymers.png,common,1005,0,0,1005,0
5864,10033,4988,107,H2O,"H2O is refined and crafted into components, modules and other items.",H20.png,abundant,5807,0,0,5807,0
5870,637,4994,105,Silicates,"Silicates are refined and crafted into components, modules and other items.",Silicates.png,abundant,5908,0,0,5908,0
5870,638,4994,42,Base Minerals,"Base Minerals are refined and crafted into components, modules and other items.",Base_Mineral.png,abundant,2687,0,0,2687,0
5870,894,4994,115,Nanofluids,"Nanofluids are refined and crafted into components, modules and other items.",Nanofluids.png,common,1032,0,0,1032,0
5872,3465,4996,126,Bruma Particles,"Bruma Particles are refined and crafted into components, modules and other items.",Bruma_Particle.png,rare,681,0,0,681,0
5872,3466,4996,42,Base Minerals,"Base Minerals are refined and crafted into components, modules and other items.",Base_Mineral.png,abundant,2367,0,0,2367,0
5872,3470,4996,107,H2O,"H2O is refined and crafted into components, modules and other items.",H20.png,abundant,5732,0,0,5732,0
5873,2440,4997,126,Bruma Particles,"Bruma Particles are refined and crafted into components, modules and other items.",Bruma_Particle.png,rare,764,0,0,764,0
5873,11749,4997,107,H2O,"H2O is refined and crafted into components, modules and other items.",H20.png,abundant,4048,0,0,4048,0
5881,9604,5005,114,Ectopolymers,"Ectopolymers are refined and crafted into components, modules and other items.",Ectopolymers.png,common,2263,0,0,2263,0
5881,9672,5005,110,Plutonium,"Plutonium is refined and crafted into components, modules and other items.",Plutonium.png,common,1335,0,0,1335,0
5881,9824,5005,110,Plutonium,"Plutonium is refined and crafted into components, modules and other items.",Plutonium.png,common,5078,0,0,5078,0
5881,9868,11105,42,Base Minerals,"Base Minerals are refined and crafted into components, modules and other items.",Base_Mineral.png,abundant,2524,0,0,2524,0
5881,13663,11105,114,Ectopolymers,"Ectopolymers are refined and crafted into components, modules and other items.",Ectopolymers.png,common,5157,0,0,5157,0
5883,2737,5007,110,Plutonium,"Plutonium is refined and crafted into components, modules and other items.",Plutonium.png,common,1448,0,0,1448,0
5883,2738,5007,120,Metamagnetic Ore,"Metamagnetic Ore is refined and crafted into components, modules and other items.",Metamagnetic_Ore.png,uncommon,2326,0,0,2326,0
5883,2739,5007,105,Silicates,"Silicates are refined and crafted into components, modules and other items.",Silicates.png,abundant,4603,0,0,4603,0
5883,2740,11107,119,Novis Compounds,"Novis Compounds are refined and crafted into components, modules and other items.",Novis_Compound.png,uncommon,1126,0,0,1126,0
5883,4192,11107,42,Base Minerals,"Base Minerals are refined and crafted into components, modules and other items.",Base_Mineral.png,abundant,2735,0,0,2735,0
5883,4277,11107,40,Polymetals,"Polymetals are refined and crafted into components, modules and other items.",Polymetals.png,common,5746,0,0,5746,0
5884,1395,5008,120,Metamagnetic Ore,"Metamagnetic Ore is refined and crafted into components, modules and other items.",Metamagnetic_Ore.png,uncommon,2847,0,0,2847,0
5884,2601,5008,128,Tchaikovium,"Tchaikovium is refined and crafted into components, modules and other items.",Tchaikovium.png,rare,884,0,0,884,0
5884,2602,5008,105,Silicates,"Silicates are refined and crafted into components, modules and other items.",Silicates.png,abundant,5526,0,0,5526,0
5889,581,5013,106,Elastomers,"Elastomers are refined and crafted into components, modules and other items.",Elastomers.png,abundant,5206,0,0,5206,0
5889,2634,5013,115,Nanofluids,"Nanofluids are refined and crafted into components, modules and other items.",Nanofluids.png,common,2750,0,0,2750,0
5889,6669,5013,127,Microorganisms,"Microorganisms are refined and crafted into components, modules and other items.",Microorganism.png,rare,896,896,0,0,896
5889,435,11113,52,Organic Compounds,"Organic Compounds are refined and crafted into components, modules and other items.",Organic_Compound.png,common,2236,0,0,2236,0
5889,436,11113,115,Nanofluids,"Nanofluids are refined and crafted into components, modules and other items.",Nanofluids.png,common,2911,0,0,2911,0
5889,582,11113,42,Base Minerals,"Base Minerals are refined and crafted into components, modules and other items.",Base_Mineral.png,abundant,5235,0,0,5235,0
5889,583,11113,115,Nanofluids,"Nanofluids are refined and crafted into components, modules and other items.",Nanofluids.png,common,4939,0,0,4939,0
5889,4266,11113,121,Hypoatomic Substances,"Hypoatomic Substances are refined and crafted into components, modules and other items.",Hypoatomic_Substances.png,uncommon,1309,0,0,1309,0
5889,4267,11113,110,Plutonium,"Plutonium is refined and crafted into components, modules and other items.",Plutonium.png,common,1204,0,0,1204,0
5894,18416,5018,107,H2O,"H2O is refined and crafted into components, modules and other items.",H20.png,abundant,4922,0,0,4922,0
5894,4761,11118,112,Amphoteric Substances,"Amphoteric Substances are refined and crafted into components, modules and other items.",Amphoteric_Substances.png,common,1129,0,0,1129,0
5894,4762,11118,128,Tchaikovium,"Tchaikovium is refined and crafted into components, modules and other items.",Tchaikovium.png,rare,696,0,0,696,0
5894,18417,11118,112,Amphoteric Substances,"Amphoteric Substances are refined and crafted into components, modules and other items.",Amphoteric_Substances.png,common,5325,0,0,5325,0
5897,13641,5021,121,Hypoatomic Substances,"Hypoatomic Substances are refined and crafted into components, modules and other items.",Hypoatomic_Substances.png,uncommon,1024,0,0,1024,0
5897,15150,5021,52,Organic Compounds,"Organic Compounds are refined and crafted into components, modules and other items.",Organic_Compound.png,common,5604,0,0,5604,0
5897,15151,5021,107,H2O,"H2O is refined and crafted into components, modules and other items.",H20.png,abundant,5217,0,0,5217,0
5900,2732,5024,128,Tchaikovium,"Tchaikovium is refined and crafted into components, modules and other items.",Tchaikovium.png,rare,846,0,0,846,0
5900,2733,5024,105,Silicates,"Silicates are refined and crafted into components, modules and other items.",Silicates.png,abundant,2131,0,0,2131,0
5900,2734,5024,105,Silicates,"Silicates are refined and crafted into components, modules and other items.",Silicates.png,abundant,4821,0,0,4821,0
5900,2735,11124,120,Metamagnetic Ore,"Metamagnetic Ore is refined and crafted into components, modules and other items.",Metamagnetic_Ore.png,uncommon,1322,0,0,1322,0
5900,3553,11124,120,Metamagnetic Ore,"Metamagnetic Ore is refined and crafted into components, modules and other items.",Metamagnetic_Ore.png,uncommon,2486,0,0,2486,0
5900,3554,11124,105,Silicates,"Silicates are refined and crafted into components, modules and other items.",Silicates.png,abundant,5321,0,0,5321,0
5903,10672,5027,115,Nanofluids,"Nanofluids are refined and crafted into components, modules and other items.",Nanofluids.png,common,5549,0,0,5549,0
5903,10673,11127,53,Ignis Ore,"Ignis Ore is refined and crafted into components, modules and other items.",Ignis_Ore.png,rare,632,0,0,632,0
5903,10674,11127,41,Xensium,"Xensium is refined and crafted into components, modules and other items.",Xensium.png,uncommon,2508,0,0,2508,0
5903,10675,11127,52,Organic Compounds,"Organic Compounds are refined and crafted into components, modules and other items.",Organic_Compound.png,common,4928,0,0,4928,0
5906,4598,5030,53,Ignis Ore,"Ignis Ore is refined and crafted into components, modules and other items.",Ignis_Ore.png,rare,875,0,0,875,0
5906,4701,5030,42,Base Minerals,"Base Minerals are refined and crafted into components, modules and other items.",Base_Mineral.png,abundant,5467,0,0,5467,0
5906,4728,5030,114,Ectopolymers,"Ectopolymers are refined and crafted into components, modules and other items.",Ectopolymers.png,common,2206,0,0,2206,0
5906,18574,11130,53,Ignis Ore,"Ignis Ore is refined and crafted into components, modules and other items.",Ignis_Ore.png,rare,761,0,0,761,0
5906,18682,11130,107,H2O,"H2O is refined and crafted into components, modules and other items.",H20.png,abundant,5736,0,0,5736,0
5914,3471,5038,123,Neolysium,"Neolysium is refined and crafted into components, modules and other items.",Neolysium.png,uncommon,1208,0,0,1208,0
5914,3472,5038,106,Elastomers,"Elastomers are refined and crafted into components, modules and other items.",Elastomers.png,abundant,2445,0,0,2445,0
5914,3473,5038,113,Aerogens,"Aerogens are refined and crafted into components, modules and other items.",Aerogens.png,common,4294,0,0,4294,0
5918,1396,5042,41,Xensium,"Xensium is refined and crafted into components, modules and other items.",Xensium.png,uncommon,2740,0,0,2740,0
5918,2599,5042,41,Xensium,"Xensium is refined and crafted into components, modules and other items.",Xensium.png,uncommon,1081,0,0,1081,0
5918,2600,5042,115,Nanofluids,"Nanofluids are refined and crafted into components, modules and other items.",Nanofluids.png,common,4893,0,0,4893,0
5921,2058,5045,127,Microorganisms,"Microorganisms are refined and crafted into components, modules and other items.",Microorganism.png,rare,3047,0,0,3047,0
5921,2196,5045,119,Novis Compounds,"Novis Compounds are refined and crafted into components, modules and other items.",Novis_Compound.png,uncommon,2998,0,0,2998,0
5921,13465,5045,119,Novis Compounds,"Novis Compounds are refined and crafted into components, modules and other items.",Novis_Compound.png,uncommon,1325,0,0,1325,0
5921,13466,11145,52,Organic Compounds,"Organic Compounds are refined and crafted into components, modules and other items.",Organic_Compound.png,common,1156,0,0,1156,0
5928,837,5052,120,Metamagnetic Ore,"Metamagnetic Ore is refined and crafted into components, modules and other items.",Metamagnetic_Ore.png,uncommon,1274,0,0,1274,0
5928,838,5052,110,Plutonium,"Plutonium is refined and crafted into components, modules and other items.",Plutonium.png,common,2111,0,0,2111,0
5944,3220,5068,121,Hypoatomic Substances,"Hypoatomic Substances are refined and crafted into components, modules and other items.",Hypoatomic_Substances.png,uncommon,1296,0,0,1296,0
5944,3221,5068,107,H2O,"H2O is refined and crafted into components, modules and other items.",H20.png,abundant,2487,0,0,2487,0
5944,3222,5068,107,H2O,"H2O is refined and crafted into components, modules and other items.",H20.png,abundant,4629,0,0,4629,0
5952,3223,5076,126,Bruma Particles,"Bruma Particles are refined and crafted into components, modules and other items.",Bruma_Particle.png,rare,665,0,0,665,0
5952,3224,5076,106,Elastomers,"Elastomers are refined and crafted into components, modules and other items.",Elastomers.png,abundant,2909,0,0,2909,0
5952,3225,5076,115,Nanofluids,"Nanofluids are refined and crafted into components, modules and other items.",Nanofluids.png,common,5820,0,0,5820,0
5953,3895,5077,106,Elastomers,"Elastomers are refined and crafted into components, modules and other items.",Elastomers.png,abundant,5090,0,0,5090,0
5953,6865,5077,40,Polymetals,"Polymetals are refined and crafted into components, modules and other items.",Polymetals.png,common,1379,0,0,1379,0
5953,7706,5077,54,Hyperspecular Crystals,"Hyperspecular Crystals are refined and crafted into components, modules and other items.",Hyperspecular_Crystals.png,uncommon,2820,0,0,2820,0
5953,3896,11177,42,Base Minerals,"Base Minerals are refined and crafted into components, modules and other items.",Base_Mineral.png,abundant,4154,0,0,4154,0
5953,4486,11177,110,Plutonium,"Plutonium is refined and crafted into components, modules and other items.",Plutonium.png,common,2518,0,0,2518,0
5953,7621,11177,110,Plutonium,"Plutonium is refined and crafted into components, modules and other items.",Plutonium.png,common,1109,0,0,1109,0
5957,1021,5081,128,Tchaikovium,"Tchaikovium is refined and crafted into components, modules and other items.",Tchaikovium.png,rare,602,0,0,602,0
5957,1074,5081,105,Silicates,"Silicates are refined and crafted into components, modules and other items.",Silicates.png,abundant,2792,0,0,2792,0
5957,1093,5081,107,H2O,"H2O is refined and crafted into components, modules and other items.",H20.png,abundant,5204,0,0,5204,0
5957,3299,11181,128,Tchaikovium,"Tchaikovium is refined and crafted into components, modules and other items.",Tchaikovium.png,rare,850,0,0,850,0
5957,7827,11181,40,Polymetals,"Polymetals are refined and crafted into components, modules and other items.",Polymetals.png,common,2065,0,0,2065,0
5957,7828,11181,105,Silicates,"Silicates are refined and crafted into components, modules and other items.",Silicates.png,abundant,5631,0,0,5631,0
5958,19373,5082,112,Amphoteric Substances,"Amphoteric Substances are refined and crafted into components, modules and other items.",Amphoteric_Substances.png,common,1314,0,0,1314,0
5958,19374,5082,40,Polymetals,"Polymetals are refined and crafted into components, modules and other items.",Polymetals.png,common,1362,0,0,1362,0
5958,19438,5082,112,Amphoteric Substances,"Amphoteric Substances are refined and crafted into components, modules and other items.",Amphoteric_Substances.png,common,2891,0,0,2891,0
5958,19439,5082,106,Elastomers,"Elastomers are refined and crafted into components, modules and other items.",Elastomers.png,abundant,5040,0,0,5040,0
5961,839,5085,120,Metamagnetic Ore,"Metamagnetic Ore is refined and crafted into components, modules and other items.",Metamagnetic_Ore.png,uncommon,1079,0,0,1079,0
5961,840,5085,109,Titanium,"Titanium is refined and crafted into components, modules and other items.",Titanium.png,common,2438,0,0,2438,0
5963,1149,5087,106,Elastomers,"Elastomers are refined and crafted into components, modules and other items.",Elastomers.png,abundant,5893,590,0,5303,590
5963,1295,5087,119,Novis Compounds,"Novis Compounds are refined and crafted into components, modules and other items.",Novis_Compound.png,uncommon,2845,356,0,2489,356
5963,1744,5087,128,Tchaikovium,"Tchaikovium is refined and crafted into components, modules and other items.",Tchaikovium.png,rare,848,848,0,0,848
5963,2389,11187,114,Ectopolymers,"Ectopolymers are refined and crafted into components, modules and other items.",Ectopolymers.png,common,5485,549,0,4936,549
5963,2551,11187,128,Tchaikovium,"Tchaikovium is refined and crafted into components, modules and other items.",Tchaikovium.png,rare,818,164,0,654,164
5963,2804,11187,54,Hyperspecular Crystals,"Hyperspecular Crystals are refined and crafted into components, modules and other items.",Hyperspecular_Crystals.png,uncommon,2115,265,0,1850,265
5964,3328,5088,105,Silicates,"Silicates are refined and crafted into components, modules and other items.",Silicates.png,abundant,5769,0,0,5769,0
5964,4252,5088,106,Elastomers,"Elastomers are refined and crafted into components, modules and other items.",Elastomers.png,abundant,2611,0,0,2611,0
5964,4301,5088,128,Tchaikovium,"Tchaikovium is refined and crafted into components, modules and other items.",Tchaikovium.png,rare,605,0,0,605,0
5964,17164,11188,128,Tchaikovium,"Tchaikovium is refined and crafted into components, modules and other items.",Tchaikovium.png,rare,659,0,0,659,0
5964,18547,11188,110,Plutonium,"Plutonium is refined and crafted into components, modules and other items.",Plutonium.png,common,2736,0,0,2736,0
5965,8056,5089,52,Organic Compounds,"Organic Compounds are refined and crafted into components, modules and other items.",Organic_Compound.png,common,5891,0,0,5891,0
5965,9276,5089,53,Ignis Ore,"Ignis Ore is refined and crafted into components, modules and other items.",Ignis_Ore.png,rare,858,0,0,858,0
5965,13234,5089,40,Polymetals,"Polymetals are refined and crafted into components, modules and other items.",Polymetals.png,common,2680,0,0,2680,0
5969,3474,5093,127,Microorganisms,"Microorganisms are refined and crafted into components, modules and other items.",Microorganism.png,rare,611,0,0,611,0
5969,3475,5093,123,Neolysium,"Neolysium is refined and crafted into components, modules and other items.",Neolysium.png,uncommon,2629,0,0,2629,0
5969,3476,5093,42,Base Minerals,"Base Minerals are refined and crafted into components, modules and other items.",Base_Mineral.png,abundant,5594,0,0,5594,0
5981,4120,5105,120,Metamagnetic Ore,"Metamagnetic Ore is refined and crafted into components, modules and other items.",Metamagnetic_Ore.png,uncommon,1349,0,0,1349,0
5981,4121,5105,112,Amphoteric Substances,"Amphoteric Substances are refined and crafted into components, modules and other items.",Amphoteric_Substances.png,common,2965,0,0,2965,0
5981,4122,5105,109,Titanium,"Titanium is refined and crafted into components, modules and other items.",Titanium.png,common,2405,0,0,2405,0
5981,4123,5105,105,Silicates,"Silicates are refined and crafted into components, modules and other items.",Silicates.png,abundant,5579,0,0,5579,0
5989,3477,5113,126,Bruma Particles,"Bruma Particles are refined and crafted into components, modules and other items.",Bruma_Particle.png,rare,863,0,0,863,0
5989,3478,5113,41,Xensium,"Xensium is refined and crafted into components, modules and other items.",Xensium.png,uncommon,2026,0,0,2026,0
5989,3479,5113,107,H2O,"H2O is refined and crafted into components, modules and other items.",H20.png,abundant,4117,0,0,4117,0
5990,4528,5114,40,Polymetals,"Polymetals are refined and crafted into components, modules and other items.",Polymetals.png,common,1287,0,0,1287,0
5993,20448,5117,120,Metamagnetic Ore,"Metamagnetic Ore is refined and crafted into components, modules and other items.",Metamagnetic_Ore.png,uncommon,1163,0,0,1163,0
5993,20449,5117,109,Titanium,"Titanium is refined and crafted into components, modules and other items.",Titanium.png,common,2126,0,0,2126,0
5993,20469,5117,105,Silicates,"Silicates are refined and crafted into components, modules and other items.",Silicates.png,abundant,4906,0,0,4906,0
5996,114,5120,54,Hyperspecular Crystals,"Hyperspecular Crystals are refined and crafted into components, modules and other items.",Hyperspecular_Crystals.png,uncommon,2651,1328,0,1323,1328
5996,1170,5120,40,Polymetals,"Polymetals are refined and crafted into components, modules and other items.",Polymetals.png,common,1253,0,0,1253,0
5996,3804,5120,42,Base Minerals,"Base Minerals are refined and crafted into components, modules and other items.",Base_Mineral.png,abundant,4723,473,0,4250,473
6000,18281,5124,128,Tchaikovium,"Tchaikovium is refined and crafted into components, modules and other items.",Tchaikovium.png,rare,722,0,0,722,0
6000,18282,5124,110,Plutonium,"Plutonium is refined and crafted into components, modules and other items.",Plutonium.png,common,1319,0,0,1319,0
6000,18283,5124,105,Silicates,"Silicates are refined and crafted into components, modules and other items.",Silicates.png,abundant,2734,0,0,2734,0
6000,18284,5124,120,Metamagnetic Ore,"Metamagnetic Ore is refined and crafted into components, modules and other items.",Metamagnetic_Ore.png,uncommon,5160,0,0,5160,0
6009,2717,5133,119,Novis Compounds,"Novis Compounds are refined and crafted into components, modules and other items.",Novis_Compound.png,uncommon,1395,0,0,1395,0
6009,2718,5133,107,H2O,"H2O is refined and crafted into components, modules and other items.",H20.png,abundant,2517,0,0,2517,0
6009,2719,5133,40,Polymetals,"Polymetals are refined and crafted into components, modules and other items.",Polymetals.png,common,5708,0,0,5708,0
6009,2720,11233,127,Microorganisms,"Microorganisms are refined and crafted into components, modules and other items.",Microorganism.png,rare,833,0,0,833,0
6009,3752,11233,115,Nanofluids,"Nanofluids are refined and crafted into components, modules and other items.",Nanofluids.png,common,2394,0,0,2394,0
6009,3753,11233,106,Elastomers,"Elastomers are refined and crafted into components, modules and other items.",Elastomers.png,abundant,5944,0,0,5944,0
6030,20264,5154,105,Silicates,"Silicates are refined and crafted into components, modules and other items.",Silicates.png,abundant,5463,0,0,5463,0
6039,3897,5163,106,Elastomers,"Elastomers are refined and crafted into components, modules and other items.",Elastomers.png,abundant,4251,0,0,4251,0
6039,4196,5163,123,Neolysium,"Neolysium is refined and crafted into components, modules and other items.",Neolysium.png,uncommon,1119,0,0,1119,0
6039,7707,5163,114,Ectopolymers,"Ectopolymers are refined and crafted into components, modules and other items.",Ectopolymers.png,common,2633,0,0,2633,0
6039,4198,11263,105,Silicates,"Silicates are refined and crafted into components, modules and other items.",Silicates.png,abundant,4861,0,0,4861,0
6039,4504,11263,105,Silicates,"Silicates are refined and crafted into components, modules and other items.",Silicates.png,abundant,2553,0,0,2553,0
6039,7708,11263,53,Ignis Ore,"Ignis Ore is refined and crafted into components, modules and other items.",Ignis_Ore.png,rare,647,130,0,517,130
6040,788,5164,118,Platinyx,"Platinyx is refined and crafted into components, modules and other items.",Platinyx.png,uncommon,1479,0,0,1479,0
6040,789,5164,105,Silicates,"Silicates are refined and crafted into components, modules and other items.",Silicates.png,abundant,2914,0,0,2914,0
6040,790,5164,110,Plutonium,"Plutonium is refined and crafted into components, modules and other items.",Plutonium.png,common,5927,0,0,5927,0
6043,841,5167,126,Bruma Particles,"Bruma Particles are refined and crafted into components, modules and other items.",Bruma_Particle.png,rare,1790,0,0,1790,0
6043,842,5167,112,Amphoteric Substances,"Amphoteric Substances are refined and crafted into components, modules and other items.",Amphoteric_Substances.png,common,1325,0,0,1325,0
6046,10957,5170,52,Organic Compounds,"Organic Compounds are refined and crafted into components, modules and other items.",Organic_Compound.png,common,1203,0,0,1203,0
6046,10958,5170,118,Platinyx,"Platinyx is refined and crafted into components, modules and other items.",Platinyx.png,uncommon,1484,0,0,1484,0
6046,11056,5170,107,H2O,"H2O is refined and crafted into components, modules and other items.",H20.png,abundant,2673,0,0,2673,0
6046,11320,5170,107,H2O,"H2O is refined and crafted into components, modules and other items.",H20.png,abundant,4454,0,0,4454,0
6046,11023,11270,52,Organic Compounds,"Organic Compounds are refined and crafted into components, modules and other items.",Organic_Compound.png,common,1043,0,0,1043,0
6046,11386,11270,114,Ectopolymers,"Ectopolymers are refined and crafted into components, modules and other items.",Ectopolymers.png,common,2136,0,0,2136,0
6046,11584,11270,105,Silicates,"Silicates are refined and crafted into components, modules and other items.",Silicates.png,abundant,5092,0,0,5092,0
6048,4877,5172,106,Elastomers,"Elastomers are refined and crafted into components, modules and other items.",Elastomers.png,abundant,5383,0,0,5383,0
6048,5249,5172,126,Bruma Particles,"Bruma Particles are refined and crafted into components, modules and other items.",Bruma_Particle.png,rare,682,0,0,682,0
6048,5584,5172,54,Hyperspecular Crystals,"Hyperspecular Crystals are refined and crafted into components, modules and other items.",Hyperspecular_Crystals.png,uncommon,2088,0,0,2088,0
6048,5585,5172,128,Tchaikovium,"Tchaikovium is refined and crafted into components, modules and other items.",Tchaikovium.png,rare,1824,0,0,1824,0
6048,6602,11272,110,Plutonium,"Plutonium is refined and crafted into components, modules and other items.",Plutonium.png,common,5865,0,0,5865,0
6048,7261,11272,119,Novis Compounds,"Novis Compounds are refined and crafted into components, modules and other items.",Novis_Compound.png,uncommon,1392,0,0,1392,0
6048,7756,11272,110,Plutonium,"Plutonium is refined and crafted into components, modules and other items.",Plutonium.png,common,2495,0,0,2495,0
6059,4756,5183,105,Silicates,"Silicates are refined and crafted into components, modules and other items.",Silicates.png,abundant,4614,0,0,4614,0
6060,3480,5184,121,Hypoatomic Substances,"Hypoatomic Substances are refined and crafted into components, modules and other items.",Hypoatomic_Substances.png,uncommon,1440,0,0,1440,0
6060,3481,5184,52,Organic Compounds,"Organic Compounds are refined and crafted into components, modules and other items.",Organic_Compound.png,common,2103,0,0,2103,0
6060,3580,5184,115,Nanofluids,"Nanofluids are refined and crafted into components, modules and other items.",Nanofluids.png,common,4290,0,0,4290,0
6068,20470,5192,120,Metamagnetic Ore,"Metamagnetic Ore is refined and crafted into components, modules and other items.",Metamagnetic_Ore.png,uncommon,1384,0,0,1384,0
6068,20494,5192,40,Polymetals,"Polymetals are refined and crafted into components, modules and other items.",Polymetals.png,common,2356,0,0,2356,0
6068,20495,5192,107,H2O,"H2O is refined and crafted into components, modules and other items.",H20.png,abundant,5782,0,0,5782,0
6069,20593,5193,115,Nanofluids,"Nanofluids are refined and crafted into components, modules and other items.",Nanofluids.png,common,1433,0,0,1433,0
6069,20594,5193,106,Elastomers,"Elastomers are refined and crafted into components, modules and other items.",Elastomers.png,abundant,2245,0,0,2245,0
6069,20611,5193,42,Base Minerals,"Base Minerals are refined and crafted into components, modules and other items.",Base_Mineral.png,abundant,5806,0,0,5806,0
6071,1397,5195,117,Yprasium,"Yprasium is refined and crafted into components, modules and other items.",Yprasium.png,uncommon,2183,0,0,2183,0
6071,1398,5195,105,Silicates,"Silicates are refined and crafted into components, modules and other items.",Silicates.png,abundant,2853,0,0,2853,0
6071,2596,5195,109,Titanium,"Titanium is refined and crafted into components, modules and other items.",Titanium.png,common,1270,0,0,1270,0
6071,2597,5195,107,H2O,"H2O is refined and crafted into components, modules and other items.",H20.png,abundant,5020,0,0,5020,0
6071,2598,5195,107,H2O,"H2O is refined and crafted into components, modules and other items.",H20.png,abundant,5292,0,0,5292,0
6072,4231,5196,54,Hyperspecular Crystals,"Hyperspecular Crystals are refined and crafted into components, modules and other items.",Hyperspecular_Crystals.png,uncommon,1105,0,0,1105,0
6072,4232,5196,119,Novis Compounds,"Novis Compounds are refined and crafted into components, modules and other items.",Novis_Compound.png,uncommon,2671,0,0,2671,0
6072,4233,5196,105,Silicates,"Silicates are refined and crafted into components, modules and other items.",Silicates.png,abundant,4322,433,0,3889,433
6083,16741,5207,114,Ectopolymers,"Ectopolymers are refined and crafted into components, modules and other items.",Ectopolymers.png,common,1090,0,0,1090,0
6083,16742,5207,107,H2O,"H2O is refined and crafted into components, modules and other items.",H20.png,abundant,2674,0,0,2674,0
6083,16743,5207,107,H2O,"H2O is refined and crafted into components, modules and other items.",H20.png,abundant,4511,0,0,4511,0
6105,193,5229,106,Elastomers,"Elastomers are refined and crafted into components, modules and other items.",Elastomers.png,abundant,5942,0,0,5942,0
6105,709,5229,113,Aerogens,"Aerogens are refined and crafted into components, modules and other items.",Aerogens.png,common,2371,0,0,2371,0
6105,710,5229,53,Ignis Ore,"Ignis Ore is refined and crafted into components, modules and other items.",Ignis_Ore.png,rare,781,0,0,781,0
6105,449,11329,126,Bruma Particles,"Bruma Particles are refined and crafted into components, modules and other items.",Bruma_Particle.png,rare,728,0,0,728,0
6109,4194,5233,52,Organic Compounds,"Organic Compounds are refined and crafted into components, modules and other items.",Organic_Compound.png,common,1167,0,0,1167,0
6109,4195,5233,115,Nanofluids,"Nanofluids are refined and crafted into components, modules and other items.",Nanofluids.png,common,1141,0,0,1141,0
6109,6866,5233,105,Silicates,"Silicates are refined and crafted into components, modules and other items.",Silicates.png,abundant,5749,0,0,5749,0
6109,7625,5233,105,Silicates,"Silicates are refined and crafted into components, modules and other items.",Silicates.png,abundant,2969,0,0,2969,0
6109,7626,5233,117,Yprasium,"Yprasium is refined and crafted into components, modules and other items.",Yprasium.png,uncommon,2348,0,0,2348,0
6109,4197,11333,105,Silicates,"Silicates are refined and crafted into components, modules and other items.",Silicates.png,abundant,5104,0,0,5104,0
6109,4199,11333,121,Hypoatomic Substances,"Hypoatomic Substances are refined and crafted into components, modules and other items.",Hypoatomic_Substances.png,uncommon,2710,0,0,2710,0
6109,7623,11333,118,Platinyx,"Platinyx is refined and crafted into components, modules and other items.",Platinyx.png,uncommon,1095,0,0,1095,0
6111,2059,5235,42,Base Minerals,"Base Minerals are refined and crafted into components, modules and other items.",Base_Mineral.png,abundant,4251,0,0,4251,0
6111,2197,5235,113,Aerogens,"Aerogens are refined and crafted into components, modules and other items.",Aerogens.png,common,2555,0,0,2555,0
6111,8755,11335,126,Bruma Particles,"Bruma Particles are refined and crafted into components, modules and other items.",Bruma_Particle.png,rare,648,0,0,648,0
6112,556,5236,115,Nanofluids,"Nanofluids are refined and crafted into components, modules and other items.",Nanofluids.png,common,1433,0,0,1433,0
6112,681,5236,113,Aerogens,"Aerogens are refined and crafted into components, modules and other items.",Aerogens.png,common,2352,0,0,2352,0
6112,859,5236,106,Elastomers,"Elastomers are refined and crafted into components, modules and other items.",Elastomers.png,abundant,5345,0,0,5345,0
6113,529,5237,113,Aerogens,"Aerogens are refined and crafted into components, modules and other items.",Aerogens.png,common,2959,0,0,2959,0
6113,535,5237,106,Elastomers,"Elastomers are refined and crafted into components, modules and other items.",Elastomers.png,abundant,5457,0,0,5457,0
6113,14752,5237,123,Neolysium,"Neolysium is refined and crafted into components, modules and other items.",Neolysium.png,uncommon,1086,0,0,1086,0
6113,544,11337,54,Hyperspecular Crystals,"Hyperspecular Crystals are refined and crafted into components, modules and other items.",Hyperspecular_Crystals.png,uncommon,2779,0,0,2779,0
6113,3714,11337,109,Titanium,"Titanium is refined and crafted into components, modules and other items.",Titanium.png,common,5929,0,0,5929,0
6113,12973,11337,54,Hyperspecular Crystals,"Hyperspecular Crystals are refined and crafted into components, modules and other items.",Hyperspecular_Crystals.png,uncommon,1411,0,0,1411,0
6123,4540,5247,113,Aerogens,"Aerogens are refined and crafted into components, modules and other items.",Aerogens.png,common,2704,0,0,2704,0
6123,4656,5247,42,Base Minerals,"Base Minerals are refined and crafted into components, modules and other items.",Base_Mineral.png,abundant,4764,0,0,4764,0
6123,4688,5247,126,Bruma Particles,"Bruma Particles are refined and crafted into components, modules and other items.",Bruma_Particle.png,rare,830,0,0,830,0
6126,4839,5250,42,Base Minerals,"Base Minerals are refined and crafted into components, modules and other items.",Base_Mineral.png,abundant,5622,0,0,5622,0
6126,4840,5250,123,Neolysium,"Neolysium is refined and crafted into components, modules and other items.",Neolysium.png,uncommon,1131,0,0,1131,0
6126,12741,5250,105,Silicates,"Silicates are refined and crafted into components, modules and other items.",Silicates.png,abundant,2110,0,0,2110,0
6128,4412,5252,54,Hyperspecular Crystals,"Hyperspecular Crystals are refined and crafted into components, modules and other items.",Hyperspecular_Crystals.png,uncommon,2061,0,0,2061,0
6130,4549,5254,121,Hypoatomic Substances,"Hypoatomic Substances are refined and crafted into components, modules and other items.",Hypoatomic_Substances.png,uncommon,5990,0,0,5990,0
6130,4825,5254,41,Xensium,"Xensium is refined and crafted into components, modules and other items.",Xensium.png,uncommon,1012,0,0,1012,0
6130,4826,5254,42,Base Minerals,"Base Minerals are refined and crafted into components, modules and other items.",Base_Mineral.png,abundant,2269,0,0,2269,0
6130,4878,11354,117,Yprasium,"Yprasium is refined and crafted into components, modules and other items.",Yprasium.png,uncommon,1352,0,0,1352,0
6130,4879,11354,41,Xensium,"Xensium is refined and crafted into components, modules and other items.",Xensium.png,uncommon,1069,0,0,1069,0
6130,4880,11354,107,H2O,"H2O is refined and crafted into components, modules and other items.",H20.png,abundant,2500,0,0,2500,0
6130,4881,11354,107,H2O,"H2O is refined and crafted into components, modules and other items.",H20.png,abundant,2640,0,0,2640,0
6130,4883,11354,40,Polymetals,"Polymetals are refined and crafted into components, modules and other items.",Polymetals.png,common,4468,0,0,4468,0
6133,8266,5257,53,Ignis Ore,"Ignis Ore is refined and crafted into components, modules and other items.",Ignis_Ore.png,rare,861,0,0,861,0
6133,8267,5257,120,Metamagnetic Ore,"Metamagnetic Ore is refined and crafted into components, modules and other items.",Metamagnetic_Ore.png,uncommon,2751,0,0,2751,0
6133,8268,5257,42,Base Minerals,"Base Minerals are refined and crafted into components, modules and other items.",Base_Mineral.png,abundant,5386,0,0,5386,0
6133,8269,5257,107,H2O,"H2O is refined and crafted into components, modules and other items.",H20.png,abundant,5729,0,0,5729,0
6133,8270,11357,120,Metamagnetic Ore,"Metamagnetic Ore is refined and crafted into components, modules and other items.",Metamagnetic_Ore.png,uncommon,2269,0,0,2269,0
6133,16897,11357,113,Aerogens,"Aerogens are refined and crafted into components, modules and other items.",Aerogens.png,common,5783,0,0,5783,0
6133,17195,11357,123,Neolysium,"Neolysium is refined and crafted into components, modules and other items.",Neolysium.png,uncommon,1320,0,0,1320,0
6135,3334,5259,53,Ignis Ore,"Ignis Ore is refined and crafted into components, modules and other items.",Ignis_Ore.png,rare,719,288,0,431,288
6135,11256,5259,52,Organic Compounds,"Organic Compounds are refined and crafted into components, modules and other items.",Organic_Compound.png,common,2540,0,0,2540,0
6135,11257,5259,107,H2O,"H2O is refined and crafted into components, modules and other items.",H20.png,abundant,4899,0,0,4899,0
6142,547,5266,52,Organic Compounds,"Organic Compounds are refined and crafted into components, modules and other items.",Organic_Compound.png,common,1338,804,0,534,804
6142,693,5266,106,Elastomers,"Elastomers are refined and crafted into components, modules and other items.",Elastomers.png,abundant,5448,0,0,5448,0
6142,6205,11366,114,Ectopolymers,"Ectopolymers are refined and crafted into components, modules and other items.",Ectopolymers.png,common,2344,0,0,2344,0
6144,4799,5268,41,Xensium,"Xensium is refined and crafted into components, modules and other items.",Xensium.png,uncommon,1445,0,0,1445,0
6144,10370,5268,107,H2O,"H2O is refined and crafted into components, modules and other items.",H20.png,abundant,5955,0,0,5955,0
6144,13300,5268,40,Polymetals,"Polymetals are refined and crafted into components, modules and other items.",Polymetals.png,common,2140,0,0,2140,0
6148,3226,5272,120,Metamagnetic Ore,"Metamagnetic Ore is refined and crafted into components, modules and other items.",Metamagnetic_Ore.png,uncommon,1170,0,0,1170,0
6148,3227,5272,52,Organic Compounds,"Organic Compounds are refined and crafted into components, modules and other items.",Organic_Compound.png,common,2300,0,0,2300,0
6148,3228,5272,42,Base Minerals,"Base Minerals are refined and crafted into components, modules and other items.",Base_Mineral.png,abundant,5310,0,0,5310,0
6150,20612,5274,119,Novis Compounds,"Novis Compounds are refined and crafted into components, modules and other items.",Novis_Compound.png,uncommon,1052,0,0,1052,0
6150,20626,5274,52,Organic Compounds,"Organic Compounds are refined and crafted into components, modules and other items.",Organic_Compound.png,common,2571,0,0,2571,0
6150,20627,5274,42,Base Minerals,"Base Minerals are refined and crafted into components, modules and other items.",Base_Mineral.png,abundant,5428,0,0,5428,0
6153,593,5277,115,Nanofluids,"Nanofluids are refined and crafted into components, modules and other items.",Nanofluids.png,common,2511,0,0,2511,0
6153,1110,5277,106,Elastomers,"Elastomers are refined and crafted into components, modules and other items.",Elastomers.png,abundant,5375,0,0,5375,0
6153,2702,5277,126,Bruma Particles,"Bruma Particles are refined and crafted into components, modules and other items.",Bruma_Particle.png,rare,794,0,0,794,0
6153,3908,11377,126,Bruma Particles,"Bruma Particles are refined and crafted into components, modules and other items.",Bruma_Particle.png,rare,799,0,0,799,0
6153,3932,11377,113,Aerogens,"Aerogens are refined and crafted into components, modules and other items.",Aerogens.png,common,2118,0,0,2118,0
6153,4285,11377,106,Elastomers,"Elastomers are refined and crafted into components, modules and other items.",Elastomers.png,abundant,4321,0,0,4321,0
6158,276,5282,112,Amphoteric Substances,"Amphoteric Substances are refined and crafted into components, modules and other items.",Amphoteric_Substances.png,common,4854,0,0,4854,0
6158,301,5282,41,Xensium,"Xensium is refined and crafted into components, modules and other items.",Xensium.png,uncommon,2746,0,0,2746,0
6158,329,5282,112,Amphoteric Substances,"Amphoteric Substances are refined and crafted into components, modules and other items.",Amphoteric_Substances.png,common,1204,0,0,1204,0
6158,4079,11382,53,Ignis Ore,"Ignis Ore is refined and crafted into components, modules and other items.",Ignis_Ore.png,rare,828,0,0,828,0
6158,4080,11382,115,Nanofluids,"Nanofluids are refined and crafted into components, modules and other items.",Nanofluids.png,common,2001,0,0,2001,0
6158,4081,11382,106,Elastomers,"Elastomers are refined and crafted into components, modules and other items.",Elastomers.png,abundant,5814,0,0,5814,0
6164,217,5288,105,Silicates,"Silicates are refined and crafted into components, modules and other items.",Silicates.png,abundant,5852,0,0,5852,0
6164,230,5288,126,Bruma Particles,"Bruma Particles are refined and crafted into components, modules and other items.",Bruma_Particle.png,rare,700,0,0,700,0
6164,244,5288,113,Aerogens,"Aerogens are refined and crafted into components, modules and other items.",Aerogens.png,common,2952,0,0,2952,0
6164,245,5288,113,Aerogens,"Aerogens are refined and crafted into components, modules and other items.",Aerogens.png,common,2651,0,0,2651,0
6165,5386,5289,114,Ectopolymers,"Ectopolymers are refined and crafted into components, modules and other items.",Ectopolymers.png,common,1436,0,0,1436,0
6165,8286,5289,106,Elastomers,"Elastomers are refined and crafted into components, modules and other items.",Elastomers.png,abundant,5732,0,0,5732,0
6165,9439,5289,40,Polymetals,"Polymetals are refined and crafted into components, modules and other items.",Polymetals.png,common,2226,0,0,2226,0
6167,3044,5291,53,Ignis Ore,"Ignis Ore is refined and crafted into components, modules and other items.",Ignis_Ore.png,rare,890,534,0,356,534
6167,3709,5291,115,Nanofluids,"Nanofluids are refined and crafted into components, modules and other items.",Nanofluids.png,common,2696,337,0,2359,337
6167,7810,5291,52,Organic Compounds,"Organic Compounds are refined and crafted into components, modules and other items.",Organic_Compound.png,common,5642,1130,0,4512,1130
6173,4288,5297,119,Novis Compounds,"Novis Compounds are refined and crafted into components, modules and other items.",Novis_Compound.png,uncommon,1342,0,0,1342,0
6173,8780,5297,107,H2O,"H2O is refined and crafted into components, modules and other items.",H20.png,abundant,2686,0,0,2686,0
6173,8816,5297,106,Elastomers,"Elastomers are refined and crafted into components, modules and other items.",Elastomers.png,abundant,4723,0,0,4723,0
6173,15190,11397,112,Amphoteric Substances,"Amphoteric Substances are refined and crafted into components, modules and other items.",Amphoteric_Substances.png,common,1415,0,0,1415,0
6173,15191,11397,41,Xensium,"Xensium is refined and crafted into components, modules and other items.",Xensium.png,uncommon,2075,0,0,2075,0
6173,16006,11397,106,Elastomers,"Elastomers are refined and crafted into components, modules and other items.",Elastomers.png,abundant,4481,0,0,4481,0
6181,1868,5305,128,Tchaikovium,"Tchaikovium is refined and crafted into components, modules and other items.",Tchaikovium.png,rare,884,354,0,530,354
6181,2378,5305,110,Plutonium,"Plutonium is refined and crafted into components, modules and other items.",Plutonium.png,common,2503,626,0,1877,626
6181,2431,5305,42,Base Minerals,"Base Minerals are refined and crafted into components, modules and other items.",Base_Mineral.png,abundant,4894,0,0,4894,0
6182,899,5306,114,Ectopolymers,"Ectopolymers are refined and crafted into components, modules and other items.",Ectopolymers.png,common,4845,0,0,4845,0
6182,936,5306,114,Ectopolymers,"Ectopolymers are refined and crafted into components, modules and other items.",Ectopolymers.png,common,1113,0,0,1113,0
6182,944,5306,114,Ectopolymers,"Ectopolymers are refined and crafted into components, modules and other items.",Ectopolymers.png,common,2135,0,0,2135,0
6182,18096,11406,128,Tchaikovium,"Tchaikovium is refined and crafted into components, modules and other items.",Tchaikovium.png,rare,708,0,0,708,0
6182,18097,11406,54,Hyperspecular Crystals,"Hyperspecular Crystals are refined and crafted into components, modules and other items.",Hyperspecular_Crystals.png,uncommon,2065,0,0,2065,0
6182,18098,11406,107,H2O,"H2O is refined and crafted into components, modules and other items.",H20.png,abundant,4730,0,0,4730,0
6185,4336,5309,112,Amphoteric Substances,"Amphoteric Substances are refined and crafted into components, modules and other items.",Amphoteric_Substances.png,common,1023,0,0,1023,0
6185,4337,5309,110,Plutonium,"Plutonium is refined and crafted into components, modules and other items.",Plutonium.png,common,2706,0,0,2706,0
6185,4338,5309,105,Silicates,"Silicates are refined and crafted into components, modules and other items.",Silicates.png,abundant,5572,0,0,5572,0
6185,4339,11409,110,Plutonium,"Plutonium is refined and crafted into components, modules and other items.",Plutonium.png,common,1311,0,0,1311,0
6185,4340,11409,40,Polymetals,"Polymetals are refined and crafted into components, modules and other items.",Polymetals.png,common,2761,0,0,2761,0
6185,4341,11409,107,H2O,"H2O is refined and crafted into components, modules and other items.",H20.png,abundant,5184,0,0,5184,0
6185,4342,11409,107,H2O,"H2O is refined and crafted into components, modules and other items.",H20.png,abundant,5114,0,0,5114,0
6189,4841,5313,115,Nanofluids,"Nanofluids are refined and crafted into components, modules and other items.",Nanofluids.png,common,1136,0,0,1136,0
6189,12219,5313,110,Plutonium,"Plutonium is refined and crafted into components, modules and other items.",Plutonium.png,common,5333,0,0,5333,0
6189,12742,5313,42,Base Minerals,"Base Minerals are refined and crafted into components, modules and other items.",Base_Mineral.png,abundant,2260,0,0,2260,0
6191,15951,5315,106,Elastomers,"Elastomers are refined and crafted into components, modules and other items.",Elastomers.png,abundant,5209,0,0,5209,0
6191,16212,5315,126,Bruma Particles,"Bruma Particles are refined and crafted into components, modules and other items.",Bruma_Particle.png,rare,610,0,0,610,0
6191,17493,5315,42,Base Minerals,"Base Minerals are refined and crafted into components, modules and other items.",Base_Mineral.png,abundant,2656,0,0,2656,0
6191,16213,11415,126,Bruma Particles,"Bruma Particles are refined and crafted into components, modules and other items.",Bruma_Particle.png,rare,844,0,0,844,0
6194,2228,5318,126,Bruma Particles,"Bruma Particles are refined and crafted into components, modules and other items.",Bruma_Particle.png,rare,883,0,0,883,0
6197,3335,5321,126,Bruma Particles,"Bruma Particles are refined and crafted into components, modules and other items.",Bruma_Particle.png,rare,701,0,0,701,0
6197,3711,5321,105,Silicates,"Silicates are refined and crafted into components, modules and other items.",Silicates.png,abundant,2519,630,0,1889,630
6197,5587,5321,106,Elastomers,"Elastomers are refined and crafted into components, modules and other items.",Elastomers.png,abundant,5010,0,0,5010,0
6199,8453,5323,127,Microorganisms,"Microorganisms are refined and crafted into components, modules and other items.",Microorganism.png,rare,834,0,0,834,0
6199,10364,5323,105,Silicates,"Silicates are refined and crafted into components, modules and other items.",Silicates.png,abundant,5618,0,0,5618,0
6199,15214,5323,117,Yprasium,"Yprasium is refined and crafted into components, modules and other items.",Yprasium.png,uncommon,2882,0,0,2882,0
6202,3544,5326,40,Polymetals,"Polymetals are refined and crafted into components, modules and other items.",Polymetals.png,common,1356,0,0,1356,0
6202,3545,5326,40,Polymetals,"Polymetals are refined and crafted into components, modules and other items.",Polymetals.png,common,2203,0,0,2203,0
6202,3546,5326,110,Plutonium,"Plutonium is refined and crafted into components, modules and other items.",Plutonium.png,common,5229,0,0,5229,0
6203,1891,5327,113,Aerogens,"Aerogens are refined and crafted into components, modules and other items.",Aerogens.png,common,1108,0,0,1108,0
6203,2049,5327,106,Elastomers,"Elastomers are refined and crafted into components, modules and other items.",Elastomers.png,abundant,5955,1192,0,4763,1192
6203,2050,5327,113,Aerogens,"Aerogens are refined and crafted into components, modules and other items.",Aerogens.png,common,4047,1215,0,2832,1215
6203,2420,5327,105,Silicates,"Silicates are refined and crafted into components, modules and other items.",Silicates.png,abundant,2784,0,0,2784,0
6207,290,5331,110,Plutonium,"Plutonium is refined and crafted into components, modules and other items.",Plutonium.png,common,5071,0,0,5071,0
6207,291,5331,121,Hypoatomic Substances,"Hypoatomic Substances are refined and crafted into components, modules and other items.",Hypoatomic_Substances.png,uncommon,4484,0,0,4484,0
6207,304,5331,128,Tchaikovium,"Tchaikovium is refined and crafted into components, modules and other items.",Tchaikovium.png,rare,720,0,0,720,0
6207,317,5331,118,Platinyx,"Platinyx is refined and crafted into components, modules and other items.",Platinyx.png,uncommon,2032,0,0,2032,0
6207,18099,11431,119,Novis Compounds,"Novis Compounds are refined and crafted into components, modules and other items.",Novis_Compound.png,uncommon,1307,0,0,1307,0
6207,18100,11431,41,Xensium,"Xensium is refined and crafted into components, modules and other items.",Xensium.png,uncommon,2434,0,0,2434,0
6207,18101,11431,106,Elastomers,"Elastomers are refined and crafted into components, modules and other items.",Elastomers.png,abundant,5869,0,0,5869,0
6209,2677,5333,53,Ignis Ore,"Ignis Ore is refined and crafted into components, modules and other items.",Ignis_Ore.png,rare,875,0,0,875,0
6209,2678,5333,110,Plutonium,"Plutonium is refined and crafted into components, modules and other items.",Plutonium.png,common,2350,0,0,2350,0
6209,2679,5333,120,Metamagnetic Ore,"Metamagnetic Ore is refined and crafted into components, modules and other items.",Metamagnetic_Ore.png,uncommon,4149,0,0,4149,0
6209,2680,11433,53,Ignis Ore,"Ignis Ore is refined and crafted into components, modules and other items.",Ignis_Ore.png,rare,735,0,0,735,0
6209,3547,11433,120,Metamagnetic Ore,"Metamagnetic Ore is refined and crafted into components, modules and other items.",Metamagnetic_Ore.png,uncommon,2993,0,0,2993,0
6209,3548,11433,106,Elastomers,"Elastomers are refined and crafted into components, modules and other items.",Elastomers.png,abundant,5403,0,0,5403,0
6219,2673,5343,126,Bruma Particles,"Bruma Particles are refined and crafted into components, modules and other items.",Bruma_Particle.png,rare,620,0,0,620,0
6219,2674,5343,42,Base Minerals,"Base Minerals are refined and crafted into components, modules and other items.",Base_Mineral.png,abundant,2055,0,0,2055,0
6219,2675,5343,106,Elastomers,"Elastomers are refined and crafted into components, modules and other items.",Elastomers.png,abundant,4094,0,0,4094,0
6219,2676,11443,54,Hyperspecular Crystals,"Hyperspecular Crystals are refined and crafted into components, modules and other items.",Hyperspecular_Crystals.png,uncommon,1417,0,0,1417,0
6219,3750,11443,54,Hyperspecular Crystals,"Hyperspecular Crystals are refined and crafted into components, modules and other items.",Hyperspecular_Crystals.png,uncommon,2074,0,0,2074,0
6219,3751,11443,42,Base Minerals,"Base Minerals are refined and crafted into components, modules and other items.",Base_Mineral.png,abundant,5849,0,0,5849,0
6225,3067,5349,128,Tchaikovium,"Tchaikovium is refined and crafted into components, modules and other items.",Tchaikovium.png,rare,715,0,0,715,0
6225,4607,5349,42,Base Minerals,"Base Minerals are refined and crafted into components, modules and other items.",Base_Mineral.png,abundant,2410,0,0,2410,0
6225,8272,5349,110,Plutonium,"Plutonium is refined and crafted into components, modules and other items.",Plutonium.png,common,4298,1290,0,3008,1290
6226,10495,5350,53,Ignis Ore,"Ignis Ore is refined and crafted into components, modules and other items.",Ignis_Ore.png,rare,893,0,0,893,0
6226,10693,5350,110,Plutonium,"Plutonium is refined and crafted into components, modules and other items.",Plutonium.png,common,2797,0,0,2797,0
6226,10759,5350,109,Titanium,"Titanium is refined and crafted into components, modules and other items.",Titanium.png,common,5389,0,0,5389,0
6227,3386,5351,128,Tchaikovium,"Tchaikovium is refined and crafted into components, modules and other items.",Tchaikovium.png,rare,893,0,0,893,0
6227,3387,5351,128,Tchaikovium,"Tchaikovium is refined and crafted into components, modules and other items.",Tchaikovium.png,rare,791,0,0,791,0
6227,3388,5351,119,Novis Compounds,"Novis Compounds are refined and crafted into components, modules and other items.",Novis_Compound.png,uncommon,2054,0,0,2054,0
6227,3389,5351,106,Elastomers,"Elastomers are refined and crafted into components, modules and other items.",Elastomers.png,abundant,4169,0,0,4169,0
6235,3602,5359,118,Platinyx,"Platinyx is refined and crafted into components, modules and other items.",Platinyx.png,uncommon,1058,0,0,1058,0
6235,3603,5359,113,Aerogens,"Aerogens are refined and crafted into components, modules and other items.",Aerogens.png,common,1442,0,0,1442,0
6235,3659,5359,40,Polymetals,"Polymetals are refined and crafted into components, modules and other items.",Polymetals.png,common,2721,0,0,2721,0
6235,3745,5359,42,Base Minerals,"Base Minerals are refined and crafted into components, modules and other items.",Base_Mineral.png,abundant,4074,408,0,3666,408
6241,1600,5365,106,Elastomers,"Elastomers are refined and crafted into components, modules and other items.",Elastomers.png,abundant,5835,0,0,5835,0
6241,1601,5365,115,Nanofluids,"Nanofluids are refined and crafted into components, modules and other items.",Nanofluids.png,common,1406,0,0,1406,0
6241,2032,5365,52,Organic Compounds,"Organic Compounds are refined and crafted into components, modules and other items.",Organic_Compound.png,common,2463,0,0,2463,0
6241,1867,11465,41,Xensium,"Xensium is refined and crafted into components, modules and other items.",Xensium.png,uncommon,2279,0,0,2279,0
6241,2419,11465,53,Ignis Ore,"Ignis Ore is refined and crafted into components, modules and other items.",Ignis_Ore.png,rare,754,0,0,754,0
6243,20726,5367,113,Aerogens,"Aerogens are refined and crafted into components, modules and other items.",Aerogens.png,common,1397,0,0,1397,0
6243,20730,5367,118,Platinyx,"Platinyx is refined and crafted into components, modules and other items.",Platinyx.png,uncommon,2767,0,0,2767,0
6243,20731,5367,42,Base Minerals,"Base Minerals are refined and crafted into components, modules and other items.",Base_Mineral.png,abundant,4360,0,0,4360,0
6249,3604,5373,40,Polymetals,"Polymetals are refined and crafted into components, modules and other items.",Polymetals.png,common,1260,252,0,1008,252
6249,3746,5373,105,Silicates,"Silicates are refined and crafted into components, modules and other items.",Silicates.png,abundant,4784,0,0,4784,0
6249,4315,5373,123,Neolysium,"Neolysium is refined and crafted into components, modules and other items.",Neolysium.png,uncommon,2965,0,0,2965,0
6259,4241,5383,112,Amphoteric Substances,"Amphoteric Substances are refined and crafted into components, modules and other items.",Amphoteric_Substances.png,common,1056,424,0,632,424
6259,4316,5383,121,Hypoatomic Substances,"Hypoatomic Substances are refined and crafted into components, modules and other items.",Hypoatomic_Substances.png,uncommon,2384,0,0,2384,0
6259,4317,5383,115,Nanofluids,"Nanofluids are refined and crafted into components, modules and other items.",Nanofluids.png,common,2050,0,0,2050,0
6259,4843,5383,114,Ectopolymers,"Ectopolymers are refined and crafted into components, modules and other items.",Ectopolymers.png,common,5744,0,0,5744,0
6265,843,5389,127,Microorganisms,"Microorganisms are refined and crafted into components, modules and other items.",Microorganism.png,rare,860,0,0,860,0
6265,844,5389,119,Novis Compounds,"Novis Compounds are refined and crafted into components, modules and other items.",Novis_Compound.png,uncommon,2637,0,0,2637,0
6267,845,5391,119,Novis Compounds,"Novis Compounds are refined and crafted into components, modules and other items.",Novis_Compound.png,uncommon,1451,0,0,1451,0
6267,846,5391,114,Ectopolymers,"Ectopolymers are refined and crafted into components, modules and other items.",Ectopolymers.png,common,1333,0,0,1333,0
6267,847,5391,110,Plutonium,"Plutonium is refined and crafted into components, modules and other items.",Plutonium.png,common,2509,0,0,2509,0
6276,2592,5400,109,Titanium,"Titanium is refined and crafted into components, modules and other items.",Titanium.png,common,1017,0,0,1017,0
6276,2593,5400,120,Metamagnetic Ore,"Metamagnetic Ore is refined and crafted into components, modules and other items.",Metamagnetic_Ore.png,uncommon,1113,0,0,1113,0
6276,2594,5400,120,Metamagnetic Ore,"Metamagnetic Ore is refined and crafted into components, modules and other items.",Metamagnetic_Ore.png,uncommon,2812,0,0,2812,0
6276,2595,5400,106,Elastomers,"Elastomers are refined and crafted into components, modules and other items.",Elastomers.png,abundant,5302,0,0,5302,0
6277,3229,5401,126,Bruma Particles,"Bruma Particles are refined and crafted into components, modules and other items.",Bruma_Particle.png,rare,887,0,0,887,0
6277,3230,5401,126,Bruma Particles,"Bruma Particles are refined and crafted into components, modules and other items.",Bruma_Particle.png,rare,778,0,0,778,0
6277,3231,5401,115,Nanofluids,"Nanofluids are refined and crafted into components, modules and other items.",Nanofluids.png,common,2311,0,0,2311,0
6277,3232,5401,115,Nanofluids,"Nanofluids are refined and crafted into components, modules and other items.",Nanofluids.png,common,5759,0,0,5759,0
6290,18556,5414,53,Ignis Ore,"Ignis Ore is refined and crafted into components, modules and other items.",Ignis_Ore.png,rare,775,0,0,775,0
6290,18563,5414,105,Silicates,"Silicates are refined and crafted into components, modules and other items.",Silicates.png,abundant,5655,0,0,5655,0
6290,18564,5414,112,Amphoteric Substances,"Amphoteric Substances are refined and crafted into components, modules and other items.",Amphoteric_Substances.png,common,2760,0,0,2760,0
6293,2384,5417,113,Aerogens,"Aerogens are refined and crafted into components, modules and other items.",Aerogens.png,common,2662,0,0,2662,0
6293,2530,5417,117,Yprasium,"Yprasium is refined and crafted into components, modules and other items.",Yprasium.png,uncommon,1431,0,0,1431,0
6293,16270,5417,106,Elastomers,"Elastomers are refined and crafted into components, modules and other items.",Elastomers.png,abundant,5477,0,0,5477,0
6293,2531,11517,126,Bruma Particles,"Bruma Particles are refined and crafted into components, modules and other items.",Bruma_Particle.png,rare,800,0,0,800,0
6293,2532,11517,113,Aerogens,"Aerogens are refined and crafted into components, modules and other items.",Aerogens.png,common,5582,0,0,5582,0
6293,16271,11517,121,Hypoatomic Substances,"Hypoatomic Substances are refined and crafted into components, modules and other items.",Hypoatomic_Substances.png,uncommon,2870,0,0,2870,0
6294,478,5418,128,Tchaikovium,"Tchaikovium is refined and crafted into components, modules and other items.",Tchaikovium.png,rare,634,0,0,634,0
6294,479,5418,119,Novis Compounds,"Novis Compounds are refined and crafted into components, modules and other items.",Novis_Compound.png,uncommon,2969,0,0,2969,0
6294,480,5418,115,Nanofluids,"Nanofluids are refined and crafted into components, modules and other items.",Nanofluids.png,common,4314,0,0,4314,0
6294,481,11518,127,Microorganisms,"Microorganisms are refined and crafted into components, modules and other items.",Microorganism.png,rare,844,0,0,844,0
6296,3390,5420,119,Novis Compounds,"Novis Compounds are refined and crafted into components, modules and other items.",Novis_Compound.png,uncommon,1343,0,0,1343,0
6296,3391,5420,106,Elastomers,"Elastomers are refined and crafted into components, modules and other items.",Elastomers.png,abundant,2205,0,0,2205,0
6296,3392,5420,42,Base Minerals,"Base Minerals are refined and crafted into components, modules and other items.",Base_Mineral.png,abundant,4246,0,0,4246,0
6297,20648,5421,127,Microorganisms,"Microorganisms are refined and crafted into components, modules and other items.",Microorganism.png,rare,611,0,0,611,0
6297,20649,5421,52,Organic Compounds,"Organic Compounds are refined and crafted into components, modules and other items.",Organic_Compound.png,common,2614,0,0,2614,0
6297,20659,5421,114,Ectopolymers,"Ectopolymers are refined and crafted into components, modules and other items.",Ectopolymers.png,common,4031,0,0,4031,0
6303,7723,5427,41,Xensium,"Xensium is refined and crafted into components, modules and other items.",Xensium.png,uncommon,1134,0,0,1134,0
6303,7724,5427,128,Tchaikovium,"Tchaikovium is refined and crafted into components, modules and other items.",Tchaikovium.png,rare,767,0,0,767,0
6303,7725,5427,127,Microorganisms,"Microorganisms are refined and crafted into components, modules and other items.",Microorganism.png,rare,1333,0,0,1333,0
6303,7726,5427,107,H2O,"H2O is refined and crafted into components, modules and other items.",H20.png,abundant,5808,0,0,5808,0
6304,3066,5428,128,Tchaikovium,"Tchaikovium is refined and crafted into components, modules and other items.",Tchaikovium.png,rare,852,513,0,339,513
6304,4802,5428,105,Silicates,"Silicates are refined and crafted into components, modules and other items.",Silicates.png,abundant,2748,0,0,2748,0
6304,7799,5428,105,Silicates,"Silicates are refined and crafted into components, modules and other items.",Silicates.png,abundant,5724,1146,0,4578,1146
6305,1380,5429,106,Elastomers,"Elastomers are refined and crafted into components, modules and other items.",Elastomers.png,abundant,2422,0,0,2422,0
6305,2589,5429,112,Amphoteric Substances,"Amphoteric Substances are refined and crafted into components, modules and other items.",Amphoteric_Substances.png,common,1157,0,0,1157,0
6305,2590,5429,127,Microorganisms,"Microorganisms are refined and crafted into components, modules and other items.",Microorganism.png,rare,883,0,0,883,0
6305,2591,5429,107,H2O,"H2O is refined and crafted into components, modules and other items.",H20.png,abundant,4108,0,0,4108,0
6309,18571,5433,107,H2O,"H2O is refined and crafted into components, modules and other items.",H20.png,abundant,4961,0,0,4961,0
6317,12409,5441,126,Bruma Particles,"Bruma Particles are refined and crafted into components, modules and other items.",Bruma_Particle.png,rare,814,0,0,814,0
6317,12838,5441,119,Novis Compounds,"Novis Compounds are refined and crafted into components, modules and other items.",Novis_Compound.png,uncommon,2331,0,0,2331,0
6317,17938,5441,113,Aerogens,"Aerogens are refined and crafted into components, modules and other items.",Aerogens.png,common,4312,0,0,4312,0
6317,18184,11541,106,Elastomers,"Elastomers are refined and crafted into components, modules and other items.",Elastomers.png,abundant,5730,0,0,5730,0
6323,6306,5447,105,Silicates,"Silicates are refined and crafted into components, modules and other items.",Silicates.png,abundant,4290,0,0,4290,0
6323,7195,5447,126,Bruma Particles,"Bruma Particles are refined and crafted into components, modules and other items.",Bruma_Particle.png,rare,757,757,0,0,757
6323,7624,5447,105,Silicates,"Silicates are refined and crafted into components, modules and other items.",Silicates.png,abundant,2777,0,0,2777,0
6323,4505,11547,105,Silicates,"Silicates are refined and crafted into components, modules and other items.",Silicates.png,abundant,2729,0,0,2729,0
6323,4682,11547,106,Elastomers,"Elastomers are refined and crafted into components, modules and other items.",Elastomers.png,abundant,4280,0,0,4280,0
6323,7622,11547,118,Platinyx,"Platinyx is refined and crafted into components, modules and other items.",Platinyx.png,uncommon,1239,0,0,1239,0
6325,20660,5449,110,Plutonium,"Plutonium is refined and crafted into components, modules and other items.",Plutonium.png,common,1012,0,0,1012,0
6325,20662,5449,42,Base Minerals,"Base Minerals are refined and crafted into components, modules and other items.",Base_Mineral.png,abundant,2832,0,0,2832,0
6325,20663,5449,110,Plutonium,"Plutonium is refined and crafted into components, modules and other items.",Plutonium.png,common,2243,0,0,2243,0
6325,20664,5449,107,H2O,"H2O is refined and crafted into components, modules and other items.",H20.png,abundant,5488,0,0,5488,0
6328,1068,5452,114,Ectopolymers,"Ectopolymers are refined and crafted into components, modules and other items.",Ectopolymers.png,common,2855,0,0,2855,0
6328,1069,5452,110,Plutonium,"Plutonium is refined and crafted into components, modules and other items.",Plutonium.png,common,2745,0,0,2745,0
6328,2142,5452,128,Tchaikovium,"Tchaikovium is refined and crafted into components, modules and other items.",Tchaikovium.png,rare,662,0,0,662,0
6328,4775,5452,105,Silicates,"Silicates are refined and crafted into components, modules and other items.",Silicates.png,abundant,4339,0,0,4339,0
6331,3952,5455,123,Neolysium,"Neolysium is refined and crafted into components, modules and other items.",Neolysium.png,uncommon,1004,0,0,1004,0
6331,3953,5455,114,Ectopolymers,"Ectopolymers are refined and crafted into components, modules and other items.",Ectopolymers.png,common,1075,0,0,1075,0
6331,4392,5455,114,Ectopolymers,"Ectopolymers are refined and crafted into components, modules and other items.",Ectopolymers.png,common,2972,0,0,2972,0
6331,4776,5455,114,Ectopolymers,"Ectopolymers are refined and crafted into components, modules and other items.",Ectopolymers.png,common,4581,0,0,4581,0
6333,1957,5457,52,Organic Compounds,"Organic Compounds are refined and crafted into components, modules and other items.",Organic_Compound.png,common,1399,0,0,1399,0
6333,2376,5457,113,Aerogens,"Aerogens are refined and crafted into components, modules and other items.",Aerogens.png,common,2164,0,0,2164,0
6333,2581,5457,42,Base Minerals,"Base Minerals are refined and crafted into components, modules and other items.",Base_Mineral.png,abundant,5683,569,0,5114,569
6340,3951,5464,120,Metamagnetic Ore,"Metamagnetic Ore is refined and crafted into components, modules and other items.",Metamagnetic_Ore.png,uncommon,1394,0,0,1394,0
6340,4730,5464,106,Elastomers,"Elastomers are refined and crafted into components, modules and other items.",Elastomers.png,abundant,5760,0,0,5760,0
6340,7496,5464,105,Silicates,"Silicates are refined and crafted into components, modules and other items.",Silicates.png,abundant,2479,0,0,2479,0
6347,1381,5471,107,H2O,"H2O is refined and crafted into components, modules and other items.",H20.png,abundant,2011,0,0,2011,0
6347,2587,5471,121,Hypoatomic Substances,"Hypoatomic Substances are refined and crafted into components, modules and other items.",Hypoatomic_Substances.png,uncommon,1224,0,0,1224,0
6347,2588,5471,107,H2O,"H2O is refined and crafted into components, modules and other items.",H20.png,abundant,4716,0,0,4716,0
6349,848,5473,119,Novis Compounds,"Novis Compounds are refined and crafted into components, modules and other items.",Novis_Compound.png,uncommon,1191,0,0,1191,0
6349,849,5473,54,Hyperspecular Crystals,"Hyperspecular Crystals are refined and crafted into components, modules and other items.",Hyperspecular_Crystals.png,uncommon,2680,0,0,2680,0
6352,3189,5476,119,Novis Compounds,"Novis Compounds are refined and crafted into components, modules and other items.",Novis_Compound.png,uncommon,1216,0,0,1216,0
6352,3190,5476,128,Tchaikovium,"Tchaikovium is refined and crafted into components, modules and other items.",Tchaikovium.png,rare,1831,0,0,1831,0
6352,3191,5476,106,Elastomers,"Elastomers are refined and crafted into components, modules and other items.",Elastomers.png,abundant,5779,0,0,5779,0
6354,4295,5478,42,Base Minerals,"Base Minerals are refined and crafted into components, modules and other items.",Base_Mineral.png,abundant,2685,0,0,2685,0
6362,3186,5486,41,Xensium,"Xensium is refined and crafted into components, modules and other items.",Xensium.png,uncommon,1203,0,0,1203,0
6362,3187,5486,52,Organic Compounds,"Organic Compounds are refined and crafted into components, modules and other items.",Organic_Compound.png,common,2966,0,0,2966,0
6362,3188,5486,52,Organic Compounds,"Organic Compounds are refined and crafted into components, modules and other items.",Organic_Compound.png,common,4153,0,0,4153,0
6376,19830,5500,41,Xensium,"Xensium is refined and crafted into components, modules and other items.",Xensium.png,uncommon,1391,0,0,1391,0
6376,19831,5500,115,Nanofluids,"Nanofluids are refined and crafted into components, modules and other items.",Nanofluids.png,common,2659,0,0,2659,0
6376,19832,5500,106,Elastomers,"Elastomers are refined and crafted into components, modules and other items.",Elastomers.png,abundant,4771,0,0,4771,0
6376,19833,11600,115,Nanofluids,"Nanofluids are refined and crafted into components, modules and other items.",Nanofluids.png,common,1468,0,0,1468,0
6376,19834,11600,119,Novis Compounds,"Novis Compounds are refined and crafted into components, modules and other items.",Novis_Compound.png,uncommon,2380,0,0,2380,0
6376,19835,11600,107,H2O,"H2O is refined and crafted into components, modules and other items.",H20.png,abundant,5197,0,0,5197,0
6377,1623,5501,126,Bruma Particles,"Bruma Particles are refined and crafted into components, modules and other items.",Bruma_Particle.png,rare,622,0,0,622,0
6377,1624,5501,126,Bruma Particles,"Bruma Particles are refined and crafted into components, modules and other items.",Bruma_Particle.png,rare,663,0,0,663,0
6377,1917,5501,123,Neolysium,"Neolysium is refined and crafted into components, modules and other items.",Neolysium.png,uncommon,2242,0,0,2242,0
6377,2985,5501,126,Bruma Particles,"Bruma Particles are refined and crafted into components, modules and other items.",Bruma_Particle.png,rare,2811,0,0,2811,0
6377,20629,11601,113,Aerogens,"Aerogens are refined and crafted into components, modules and other items.",Aerogens.png,common,1126,0,0,1126,0
6377,20630,11601,42,Base Minerals,"Base Minerals are refined and crafted into components, modules and other items.",Base_Mineral.png,abundant,2494,0,0,2494,0
6377,20631,11601,123,Neolysium,"Neolysium is refined and crafted into components, modules and other items.",Neolysium.png,uncommon,2670,0,0,2670,0
6377,20661,11601,42,Base Minerals,"Base Minerals are refined and crafted into components, modules and other items.",Base_Mineral.png,abundant,5893,0,0,5893,0
6393,3030,5517,112,Amphoteric Substances,"Amphoteric Substances are refined and crafted into components, modules and other items.",Amphoteric_Substances.png,common,2726,0,0,2726,0
6397,2667,5521,126,Bruma Particles,"Bruma Particles are refined and crafted into components, modules and other items.",Bruma_Particle.png,rare,606,0,0,606,0
6397,2668,5521,40,Polymetals,"Polymetals are refined and crafted into components, modules and other items.",Polymetals.png,common,2902,0,0,2902,0
6397,2669,5521,106,Elastomers,"Elastomers are refined and crafted into components, modules and other items.",Elastomers.png,abundant,4675,0,0,4675,0
6397,2670,11621,54,Hyperspecular Crystals,"Hyperspecular Crystals are refined and crafted into components, modules and other items.",Hyperspecular_Crystals.png,uncommon,1290,0,0,1290,0
6397,2671,11621,123,Neolysium,"Neolysium is refined and crafted into components, modules and other items.",Neolysium.png,uncommon,2270,0,0,2270,0
6397,3557,11621,105,Silicates,"Silicates are refined and crafted into components, modules and other items.",Silicates.png,abundant,5328,0,0,5328,0
6415,9241,5539,126,Bruma Particles,"Bruma Particles are refined and crafted into components, modules and other items.",Bruma_Particle.png,rare,866,0,0,866,0
6415,10363,5539,105,Silicates,"Silicates are refined and crafted into components, modules and other items.",Silicates.png,abundant,5671,0,0,5671,0
6415,15215,5539,115,Nanofluids,"Nanofluids are refined and crafted into components, modules and other items.",Nanofluids.png,common,2089,0,0,2089,0
6425,3183,5549,127,Microorganisms,"Microorganisms are refined and crafted into components, modules and other items.",Microorganism.png,rare,827,0,0,827,0
6425,3184,5549,40,Polymetals,"Polymetals are refined and crafted into components, modules and other items.",Polymetals.png,common,2655,0,0,2655,0
6425,3185,5549,42,Base Minerals,"Base Minerals are refined and crafted into components, modules and other items.",Base_Mineral.png,abundant,4233,0,0,4233,0
6436,4842,5560,126,Bruma Particles,"Bruma Particles are refined and crafted into components, modules and other items.",Bruma_Particle.png,rare,799,0,0,799,0
6436,12220,5560,107,H2O,"H2O is refined and crafted into components, modules and other items.",H20.png,abundant,4733,0,0,4733,0
6436,12743,5560,115,Nanofluids,"Nanofluids are refined and crafted into components, modules and other items.",Nanofluids.png,common,2533,0,0,2533,0
6438,14626,5562,53,Ignis Ore,"Ignis Ore is refined and crafted into components, modules and other items.",Ignis_Ore.png,rare,796,0,0,796,0
6438,14627,5562,109,Titanium,"Titanium is refined and crafted into components, modules and other items.",Titanium.png,common,2960,0,0,2960,0
6438,14628,5562,105,Silicates,"Silicates are refined and crafted into components, modules and other items.",Silicates.png,abundant,5154,0,0,5154,0
6449,15,5573,118,Platinyx,"Platinyx is refined and crafted into components, modules and other items.",Platinyx.png,uncommon,1099,220,0,879,220
6449,133,5573,110,Plutonium,"Plutonium is refined and crafted into components, modules and other items.",Plutonium.png,common,2896,0,0,2896,0
6449,413,5573,106,Elastomers,"Elastomers are refined and crafted into components, modules and other items.",Elastomers.png,abundant,4275,0,0,4275,0
6449,4984,11673,118,Platinyx,"Platinyx is refined and crafted into components, modules and other items.",Platinyx.png,uncommon,1435,287,0,1148,287
6449,4985,11673,105,Silicates,"Silicates are refined and crafted into components, modules and other items.",Silicates.png,abundant,2967,0,0,2967,0
6449,5349,11673,105,Silicates,"Silicates are refined and crafted into components, modules and other items.",Silicates.png,abundant,5760,0,0,5760,0
6459,1644,5583,115,Nanofluids,"Nanofluids are refined and crafted into components, modules and other items.",Nanofluids.png,common,1039,0,0,1039,0
6459,1730,5583,117,Yprasium,"Yprasium is refined and crafted into components, modules and other items.",Yprasium.png,uncommon,2594,0,0,2594,0
6459,1770,5583,105,Silicates,"Silicates are refined and crafted into components, modules and other items.",Silicates.png,abundant,4707,0,0,4707,0
6459,7505,11683,121,Hypoatomic Substances,"Hypoatomic Substances are refined and crafted into components, modules and other items.",Hypoatomic_Substances.png,uncommon,1310,0,0,1310,0
6459,7510,11683,121,Hypoatomic Substances,"Hypoatomic Substances are refined and crafted into components, modules and other items.",Hypoatomic_Substances.png,uncommon,2530,0,0,2530,0
6459,7609,11683,115,Nanofluids,"Nanofluids are refined and crafted into components, modules and other items.",Nanofluids.png,common,5420,0,0,5420,0
6459,7610,11683,109,Titanium,"Titanium is refined and crafted into components, modules and other items.",Titanium.png,common,5814,0,0,5814,0
6465,1022,5589,53,Ignis Ore,"Ignis Ore is refined and crafted into components, modules and other items.",Ignis_Ore.png,rare,693,0,0,693,0
6465,1094,5589,42,Base Minerals,"Base Minerals are refined and crafted into components, modules and other items.",Base_Mineral.png,abundant,4648,0,0,4648,0
6465,1105,5589,114,Ectopolymers,"Ectopolymers are refined and crafted into components, modules and other items.",Ectopolymers.png,common,2348,0,0,2348,0
6465,1106,5589,42,Base Minerals,"Base Minerals are refined and crafted into components, modules and other items.",Base_Mineral.png,abundant,2459,1540,0,919,1540
6465,3312,11689,54,Hyperspecular Crystals,"Hyperspecular Crystals are refined and crafted into components, modules and other items.",Hyperspecular_Crystals.png,uncommon,1044,0,0,1044,0
6465,8585,11689,114,Ectopolymers,"Ectopolymers are refined and crafted into components, modules and other items.",Ectopolymers.png,common,4601,0,0,4601,0
6465,8586,11689,52,Organic Compounds,"Organic Compounds are refined and crafted into components, modules and other items.",Organic_Compound.png,common,4483,0,0,4483,0
6465,8759,11689,105,Silicates,"Silicates are refined and crafted into components, modules and other items.",Silicates.png,abundant,2393,0,0,2393,0
6474,4328,5598,115,Nanofluids,"Nanofluids are refined and crafted into components, modules and other items.",Nanofluids.png,common,1210,0,0,1210,0
6474,4329,5598,117,Yprasium,"Yprasium is refined and crafted into components, modules and other items.",Yprasium.png,uncommon,2827,0,0,2827,0
6474,4330,5598,127,Microorganisms,"Microorganisms are refined and crafted into components, modules and other items.",Microorganism.png,rare,3817,0,0,3817,0
6474,4331,11698,115,Nanofluids,"Nanofluids are refined and crafted into components, modules and other items.",Nanofluids.png,common,1200,0,0,1200,0
6474,4332,11698,109,Titanium,"Titanium is refined and crafted into components, modules and other items.",Titanium.png,common,2239,0,0,2239,0
6474,4333,11698,106,Elastomers,"Elastomers are refined and crafted into components, modules and other items.",Elastomers.png,abundant,5003,0,0,5003,0
6475,17407,5599,127,Microorganisms,"Microorganisms are refined and crafted into components, modules and other items.",Microorganism.png,rare,628,0,0,628,0
6475,17408,5599,127,Microorganisms,"Microorganisms are refined and crafted into components, modules and other items.",Microorganism.png,rare,1742,0,0,1742,0
6475,17409,5599,121,Hypoatomic Substances,"Hypoatomic Substances are refined and crafted into components, modules and other items.",Hypoatomic_Substances.png,uncommon,2486,0,0,2486,0
6475,17410,5599,107,H2O,"H2O is refined and crafted into components, modules and other items.",H20.png,abundant,4777,0,0,4777,0
6476,2346,5600,127,Microorganisms,"Microorganisms are refined and crafted into components, modules and other items.",Microorganism.png,rare,883,0,0,883,0
6476,2347,5600,112,Amphoteric Substances,"Amphoteric Substances are refined and crafted into components, modules and other items.",Amphoteric_Substances.png,common,2677,0,0,2677,0
6476,4550,5600,107,H2O,"H2O is refined and crafted into components, modules and other items.",H20.png,abundant,5829,0,0,5829,0
6476,2348,11700,40,Polymetals,"Polymetals are refined and crafted into components, modules and other items.",Polymetals.png,common,2466,0,0,2466,0
6476,5350,11700,127,Microorganisms,"Microorganisms are refined and crafted into components, modules and other items.",Microorganism.png,rare,706,0,0,706,0
6476,5351,11700,107,H2O,"H2O is refined and crafted into components, modules and other items.",H20.png,abundant,5954,0,0,5954,0
6480,1960,5604,113,Aerogens,"Aerogens are refined and crafted into components, modules and other items.",Aerogens.png,common,4682,0,0,4682,0
6484,12750,5608,127,Microorganisms,"Microorganisms are refined and crafted into components, modules and other items.",Microorganism.png,rare,862,0,0,862,0
6484,12937,5608,123,Neolysium,"Neolysium is refined and crafted into components, modules and other items.",Neolysium.png,uncommon,2879,0,0,2879,0
6484,17940,5608,107,H2O,"H2O is refined and crafted into components, modules and other items.",H20.png,abundant,5911,0,0,5911,0
6484,17791,11708,107,H2O,"H2O is refined and crafted into components, modules and other items.",H20.png,abundant,4619,0,0,4619,0
6495,1382,5619,107,H2O,"H2O is refined and crafted into components, modules and other items.",H20.png,abundant,2318,0,0,2318,0
6495,1383,5619,106,Elastomers,"Elastomers are refined and crafted into components, modules and other items.",Elastomers.png,abundant,2562,0,0,2562,0
6495,2585,5619,126,Bruma Particles,"Bruma Particles are refined and crafted into components, modules and other items.",Bruma_Particle.png,rare,617,0,0,617,0
6495,2586,5619,107,H2O,"H2O is refined and crafted into components, modules and other items.",H20.png,abundant,4046,0,0,4046,0
6496,12974,5620,42,Base Minerals,"Base Minerals are refined and crafted into components, modules and other items.",Base_Mineral.png,abundant,4279,0,0,4279,0
6496,14753,5620,53,Ignis Ore,"Ignis Ore is refined and crafted into components, modules and other items.",Ignis_Ore.png,rare,893,0,0,893,0
6496,15709,5620,110,Plutonium,"Plutonium is refined and crafted into components, modules and other items.",Plutonium.png,common,2592,0,0,2592,0
6496,12975,11720,109,Titanium,"Titanium is refined and crafted into components, modules and other items.",Titanium.png,common,1047,0,0,1047,0
6496,12976,11720,109,Titanium,"Titanium is refined and crafted into components, modules and other items.",Titanium.png,common,2201,0,0,2201,0
6496,14785,11720,105,Silicates,"Silicates are refined and crafted into components, modules and other items.",Silicates.png,abundant,4095,0,0,4095,0
6500,1546,5624,118,Platinyx,"Platinyx is refined and crafted into components, modules and other items.",Platinyx.png,uncommon,4094,0,0,4094,0
6500,1655,5624,127,Microorganisms,"Microorganisms are refined and crafted into components, modules and other items.",Microorganism.png,rare,686,0,0,686,0
6500,2447,5624,52,Organic Compounds,"Organic Compounds are refined and crafted into components, modules and other items.",Organic_Compound.png,common,2882,0,0,2882,0
6501,10666,11725,109,Titanium,"Titanium is refined and crafted into components, modules and other items.",Titanium.png,common,1097,0,0,1097,0
6501,10667,11725,119,Novis Compounds,"Novis Compounds are refined and crafted into components, modules and other items.",Novis_Compound.png,uncommon,2951,0,0,2951,0
6501,10668,11725,106,Elastomers,"Elastomers are refined and crafted into components, modules and other items.",Elastomers.png,abundant,5010,0,0,5010,0
6505,2337,5629,126,Bruma Particles,"Bruma Particles are refined and crafted into components, modules and other items.",Bruma_Particle.png,rare,600,0,0,600,0
6505,2338,5629,109,Titanium,"Titanium is refined and crafted into components, modules and other items.",Titanium.png,common,1266,0,0,1266,0
6507,1924,5631,52,Organic Compounds,"Organic Compounds are refined and crafted into components, modules and other items.",Organic_Compound.png,common,2320,0,0,2320,0
6511,2662,5635,127,Microorganisms,"Microorganisms are refined and crafted into components, modules and other items.",Microorganism.png,rare,691,0,0,691,0
6511,2663,5635,127,Microorganisms,"Microorganisms are refined and crafted into components, modules and other items.",Microorganism.png,rare,1586,0,0,1586,0
6511,2664,5635,105,Silicates,"Silicates are refined and crafted into components, modules and other items.",Silicates.png,abundant,5900,0,0,5900,0
6511,2665,11735,127,Microorganisms,"Microorganisms are refined and crafted into components, modules and other items.",Microorganism.png,rare,668,0,0,668,0
6511,2666,11735,107,H2O,"H2O is refined and crafted into components, modules and other items.",H20.png,abundant,2396,0,0,2396,0
6511,4184,11735,115,Nanofluids,"Nanofluids are refined and crafted into components, modules and other items.",Nanofluids.png,common,5604,0,0,5604,0
6516,1029,5640,114,Ectopolymers,"Ectopolymers are refined and crafted into components, modules and other items.",Ectopolymers.png,common,1009,0,0,1009,0
6516,1030,5640,120,Metamagnetic Ore,"Metamagnetic Ore is refined and crafted into components, modules and other items.",Metamagnetic_Ore.png,uncommon,1381,0,0,1381,0
6516,1122,5640,106,Elastomers,"Elastomers are refined and crafted into components, modules and other items.",Elastomers.png,abundant,2135,0,0,2135,0
6516,1133,5640,106,Elastomers,"Elastomers are refined and crafted into components, modules and other items.",Elastomers.png,abundant,4857,0,0,4857,0
6516,4580,11740,119,Novis Compounds,"Novis Compounds are refined and crafted into components, modules and other items.",Novis_Compound.png,uncommon,1076,0,0,1076,0
6516,4696,11740,54,Hyperspecular Crystals,"Hyperspecular Crystals are refined and crafted into components, modules and other items.",Hyperspecular_Crystals.png,uncommon,2469,0,0,2469,0
6516,4723,11740,114,Ectopolymers,"Ectopolymers are refined and crafted into components, modules and other items.",Ectopolymers.png,common,4219,0,0,4219,0
6518,1096,5642,54,Hyperspecular Crystals,"Hyperspecular Crystals are refined and crafted into components, modules and other items.",Hyperspecular_Crystals.png,uncommon,1232,0,0,1232,0
6518,1114,5642,114,Ectopolymers,"Ectopolymers are refined and crafted into components, modules and other items.",Ectopolymers.png,common,5259,0,0,5259,0
6518,1115,5642,119,Novis Compounds,"Novis Compounds are refined and crafted into components, modules and other items.",Novis_Compound.png,uncommon,5158,0,0,5158,0
6518,1125,5642,114,Ectopolymers,"Ectopolymers are refined and crafted into components, modules and other items.",Ectopolymers.png,common,2724,0,0,2724,0
6518,4589,11742,115,Nanofluids,"Nanofluids are refined and crafted into components, modules and other items.",Nanofluids.png,common,1070,0,0,1070,0
6518,4740,11742,110,Plutonium,"Plutonium is refined and crafted into components, modules and other items.",Plutonium.png,common,2430,1216,0,1214,1216
6518,4745,11742,110,Plutonium,"Plutonium is refined and crafted into components, modules and other items.",Plutonium.png,common,4415,0,0,4415,0
6518,4746,11742,42,Base Minerals,"Base Minerals are refined and crafted into components, modules and other items.",Base_Mineral.png,abundant,5185,0,0,5185,0
6535,4335,5659,126,Bruma Particles,"Bruma Particles are refined and crafted into components, modules and other items.",Bruma_Particle.png,rare,835,0,0,835,0
6535,4729,5659,107,H2O,"H2O is refined and crafted into components, modules and other items.",H20.png,abundant,5076,0,0,5076,0
6535,7497,5659,107,H2O,"H2O is refined and crafted into components, modules and other items.",H20.png,abundant,2454,0,0,2454,0
6539,1023,5663,109,Titanium,"Titanium is refined and crafted into components, modules and other items.",Titanium.png,common,1318,0,0,1318,0
6539,1107,5663,54,Hyperspecular Crystals,"Hyperspecular Crystals are refined and crafted into components, modules and other items.",Hyperspecular_Crystals.png,uncommon,2245,0,0,2245,0
6539,1108,5663,121,Hypoatomic Substances,"Hypoatomic Substances are refined and crafted into components, modules and other items.",Hypoatomic_Substances.png,uncommon,4617,0,0,4617,0
6539,3517,11763,109,Titanium,"Titanium is refined and crafted into components, modules and other items.",Titanium.png,common,1114,0,0,1114,0
6539,8779,11763,54,Hyperspecular Crystals,"Hyperspecular Crystals are refined and crafted into components, modules and other items.",Hyperspecular_Crystals.png,uncommon,2085,0,0,2085,0
6539,9473,11763,126,Bruma Particles,"Bruma Particles are refined and crafted into components, modules and other items.",Bruma_Particle.png,rare,3635,0,0,3635,0
6541,3609,5665,110,Plutonium,"Plutonium is refined and crafted into components, modules and other items.",Plutonium.png,common,2406,0,0,2406,0
6541,4870,5665,106,Elastomers,"Elastomers are refined and crafted into components, modules and other items.",Elastomers.png,abundant,5064,0,0,5064,0
6541,4871,5665,106,Elastomers,"Elastomers are refined and crafted into components, modules and other items.",Elastomers.png,abundant,4840,0,0,4840,0
6541,7262,5665,127,Microorganisms,"Microorganisms are refined and crafted into components, modules and other items.",Microorganism.png,rare,814,814,0,0,814
6541,4681,11765,107,H2O,"H2O is refined and crafted into components, modules and other items.",H20.png,abundant,4824,0,0,4824,0
6541,4727,11765,119,Novis Compounds,"Novis Compounds are refined and crafted into components, modules and other items.",Novis_Compound.png,uncommon,2849,0,0,2849,0
6541,4874,11765,128,Tchaikovium,"Tchaikovium is refined and crafted into components, modules and other items.",Tchaikovium.png,rare,691,556,0,135,556
6549,4124,5673,41,Xensium,"Xensium is refined and crafted into components, modules and other items.",Xensium.png,uncommon,1472,0,0,1472,0
6549,4125,5673,106,Elastomers,"Elastomers are refined and crafted into components, modules and other items.",Elastomers.png,abundant,2848,0,0,2848,0
6549,4126,5673,126,Bruma Particles,"Bruma Particles are refined and crafted into components, modules and other items.",Bruma_Particle.png,rare,3368,0,0,3368,0
6553,4281,5677,52,Organic Compounds,"Organic Compounds are refined and crafted into components, modules and other items.",Organic_Compound.png,common,1185,0,0,1185,0
6553,4312,5677,121,Hypoatomic Substances,"Hypoatomic Substances are refined and crafted into components, modules and other items.",Hypoatomic_Substances.png,uncommon,2554,320,0,2234,320
6553,4348,5677,107,H2O,"H2O is refined and crafted into components, modules and other items.",H20.png,abundant,4067,0,0,4067,0
6553,4569,11777,115,Nanofluids,"Nanofluids are refined and crafted into components, modules and other items.",Nanofluids.png,common,2699,0,0,2699,0
6553,4793,11777,127,Microorganisms,"Microorganisms are refined and crafted into components, modules and other items.",Microorganism.png,rare,897,720,0,177,720
6553,4794,11777,121,Hypoatomic Substances,"Hypoatomic Substances are refined and crafted into components, modules and other items.",Hypoatomic_Substances.png,uncommon,1353,0,0,1353,0
6557,712,5681,105,Silicates,"Silicates are refined and crafted into components, modules and other items.",Silicates.png,abundant,5995,0,0,5995,0
6557,713,5681,105,Silicates,"Silicates are refined and crafted into components, modules and other items.",Silicates.png,abundant,2459,0,0,2459,0
6559,8753,5683,52,Organic Compounds,"Organic Compounds are refined and crafted into components, modules and other items.",Organic_Compound.png,common,1356,0,0,1356,0
6559,11983,5683,114,Ectopolymers,"Ectopolymers are refined and crafted into components, modules and other items.",Ectopolymers.png,common,2939,0,0,2939,0
6559,15379,5683,105,Silicates,"Silicates are refined and crafted into components, modules and other items.",Silicates.png,abundant,4679,0,0,4679,0
6559,8754,11783,117,Yprasium,"Yprasium is refined and crafted into components, modules and other items.",Yprasium.png,uncommon,1376,0,0,1376,0
6559,15380,11783,105,Silicates,"Silicates are refined and crafted into components, modules and other items.",Silicates.png,abundant,4147,0,0,4147,0
6559,15445,11783,107,H2O,"H2O is refined and crafted into components, modules and other items.",H20.png,abundant,2204,0,0,2204,0
6567,3180,5691,53,Ignis Ore,"Ignis Ore is refined and crafted into components, modules and other items.",Ignis_Ore.png,rare,647,0,0,647,0
6567,3181,5691,117,Yprasium,"Yprasium is refined and crafted into components, modules and other items.",Yprasium.png,uncommon,2251,0,0,2251,0
6567,3182,5691,114,Ectopolymers,"Ectopolymers are refined and crafted into components, modules and other items.",Ectopolymers.png,common,5606,0,0,5606,0
6579,1271,5703,110,Plutonium,"Plutonium is refined and crafted into components, modules and other items.",Plutonium.png,common,1488,0,0,1488,0
6579,1272,5703,128,Tchaikovium,"Tchaikovium is refined and crafted into components, modules and other items.",Tchaikovium.png,rare,1652,0,0,1652,0
6579,1273,5703,106,Elastomers,"Elastomers are refined and crafted into components, modules and other items.",Elastomers.png,abundant,4886,0,0,4886,0
6579,18102,11803,128,Tchaikovium,"Tchaikovium is refined and crafted into components, modules and other items.",Tchaikovium.png,rare,761,0,0,761,0
6579,18103,11803,106,Elastomers,"Elastomers are refined and crafted into components, modules and other items.",Elastomers.png,abundant,2716,0,0,2716,0
6579,18104,11803,42,Base Minerals,"Base Minerals are refined and crafted into components, modules and other items.",Base_Mineral.png,abundant,4808,0,0,4808,0
6582,9208,5706,126,Bruma Particles,"Bruma Particles are refined and crafted into components, modules and other items.",Bruma_Particle.png,rare,885,0,0,885,0
6590,1150,5714,105,Silicates,"Silicates are refined and crafted into components, modules and other items.",Silicates.png,abundant,4204,421,0,3783,421
6590,1296,5714,105,Silicates,"Silicates are refined and crafted into components, modules and other items.",Silicates.png,abundant,2836,355,0,2481,355
6590,1745,5714,117,Yprasium,"Yprasium is refined and crafted into components, modules and other items.",Yprasium.png,uncommon,1460,292,0,1168,292
6590,2412,11814,105,Silicates,"Silicates are refined and crafted into components, modules and other items.",Silicates.png,abundant,5151,516,0,4635,516
6590,2413,11814,113,Aerogens,"Aerogens are refined and crafted into components, modules and other items.",Aerogens.png,common,4293,430,0,3863,430
6590,2798,11814,126,Bruma Particles,"Bruma Particles are refined and crafted into components, modules and other items.",Bruma_Particle.png,rare,895,895,0,0,895
6590,2799,11814,113,Aerogens,"Aerogens are refined and crafted into components, modules and other items.",Aerogens.png,common,2573,322,0,2251,322
6593,18588,5717,42,Base Minerals,"Base Minerals are refined and crafted into components, modules and other items.",Base_Mineral.png,abundant,5558,0,0,5558,0
6596,4861,5720,120,Metamagnetic Ore,"Metamagnetic Ore is refined and crafted into components, modules and other items.",Metamagnetic_Ore.png,uncommon,1014,0,0,1014,0
6596,12221,5720,42,Base Minerals,"Base Minerals are refined and crafted into components, modules and other items.",Base_Mineral.png,abundant,5415,0,0,5415,0
6596,12744,5720,118,Platinyx,"Platinyx is refined and crafted into components, modules and other items.",Platinyx.png,uncommon,2338,0,0,2338,0
6598,12907,5722,115,Nanofluids,"Nanofluids are refined and crafted into components, modules and other items.",Nanofluids.png,common,2123,0,0,2123,0
6598,14886,5722,106,Elastomers,"Elastomers are refined and crafted into components, modules and other items.",Elastomers.png,abundant,5938,0,0,5938,0
6599,18278,5723,52,Organic Compounds,"Organic Compounds are refined and crafted into components, modules and other items.",Organic_Compound.png,common,1356,0,0,1356,0
6599,18279,5723,127,Microorganisms,"Microorganisms are refined and crafted into components, modules and other items.",Microorganism.png,rare,1560,0,0,1560,0
6599,18280,5723,42,Base Minerals,"Base Minerals are refined and crafted into components, modules and other items.",Base_Mineral.png,abundant,4569,0,0,4569,0
6600,4127,5724,109,Titanium,"Titanium is refined and crafted into components, modules and other items.",Titanium.png,common,1163,0,0,1163,0
6600,4128,5724,54,Hyperspecular Crystals,"Hyperspecular Crystals are refined and crafted into components, modules and other items.",Hyperspecular_Crystals.png,uncommon,2176,0,0,2176,0
6600,4129,5724,114,Ectopolymers,"Ectopolymers are refined and crafted into components, modules and other items.",Ectopolymers.png,common,4171,0,0,4171,0
6601,3599,5725,128,Tchaikovium,"Tchaikovium is refined and crafted into components, modules and other items.",Tchaikovium.png,rare,879,879,0,0,879
6601,4086,5725,120,Metamagnetic Ore,"Metamagnetic Ore is refined and crafted into components, modules and other items.",Metamagnetic_Ore.png,uncommon,5016,0,0,5016,0
6601,4584,5725,110,Plutonium,"Plutonium is refined and crafted into components, modules and other items.",Plutonium.png,common,2131,0,0,2131,0
6601,4585,11825,120,Metamagnetic Ore,"Metamagnetic Ore is refined and crafted into components, modules and other items.",Metamagnetic_Ore.png,uncommon,2376,0,0,2376,0
6601,13498,11825,42,Base Minerals,"Base Minerals are refined and crafted into components, modules and other items.",Base_Mineral.png,abundant,4091,0,0,4091,0
6610,1274,5734,128,Tchaikovium,"Tchaikovium is refined and crafted into components, modules and other items.",Tchaikovium.png,rare,723,0,0,723,0
6610,1275,5734,119,Novis Compounds,"Novis Compounds are refined and crafted into components, modules and other items.",Novis_Compound.png,uncommon,2284,0,0,2284,0
6610,1323,5734,107,H2O,"H2O is refined and crafted into components, modules and other items.",H20.png,abundant,4781,0,0,4781,0
6610,18105,11834,119,Novis Compounds,"Novis Compounds are refined and crafted into components, modules and other items.",Novis_Compound.png,uncommon,1068,0,0,1068,0
6610,18106,11834,54,Hyperspecular Crystals,"Hyperspecular Crystals are refined and crafted into components, modules and other items.",Hyperspecular_Crystals.png,uncommon,2668,0,0,2668,0
6610,18107,11834,106,Elastomers,"Elastomers are refined and crafted into components, modules and other items.",Elastomers.png,abundant,5368,0,0,5368,0
6622,3176,5746,117,Yprasium,"Yprasium is refined and crafted into components, modules and other items.",Yprasium.png,uncommon,1376,0,0,1376,0
6622,3177,5746,112,Amphoteric Substances,"Amphoteric Substances are refined and crafted into components, modules and other items.",Amphoteric_Substances.png,common,2840,0,0,2840,0
6622,3178,5746,42,Base Minerals,"Base Minerals are refined and crafted into components, modules and other items.",Base_Mineral.png,abundant,4916,0,0,4916,0
6622,3179,5746,42,Base Minerals,"Base Minerals are refined and crafted into components, modules and other items.",Base_Mineral.png,abundant,4856,0,0,4856,0
6625,864,5749,128,Tchaikovium,"Tchaikovium is refined and crafted into components, modules and other items.",Tchaikovium.png,rare,835,0,0,835,0
6625,865,5749,119,Novis Compounds,"Novis Compounds are refined and crafted into components, modules and other items.",Novis_Compound.png,uncommon,1073,0,0,1073,0
6625,2023,5749,115,Nanofluids,"Nanofluids are refined and crafted into components, modules and other items.",Nanofluids.png,common,2929,0,0,2929,0
6625,4254,5749,112,Amphoteric Substances,"Amphoteric Substances are refined and crafted into components, modules and other items.",Amphoteric_Substances.png,common,4268,0,0,4268,0
6625,4255,11849,115,Nanofluids,"Nanofluids are refined and crafted into components, modules and other items.",Nanofluids.png,common,2879,0,0,2879,0
6625,10166,11849,105,Silicates,"Silicates are refined and crafted into components, modules and other items.",Silicates.png,abundant,4426,0,0,4426,0
6625,15247,11849,126,Bruma Particles,"Bruma Particles are refined and crafted into components, modules and other items.",Bruma_Particle.png,rare,759,0,0,759,0
6626,2657,5750,115,Nanofluids,"Nanofluids are refined and crafted into components, modules and other items.",Nanofluids.png,common,1459,0,0,1459,0
6626,2658,5750,115,Nanofluids,"Nanofluids are refined and crafted into components, modules and other items.",Nanofluids.png,common,2367,0,0,2367,0
6626,2659,5750,52,Organic Compounds,"Organic Compounds are refined and crafted into components, modules and other items.",Organic_Compound.png,common,5608,0,0,5608,0
6626,2660,11850,126,Bruma Particles,"Bruma Particles are refined and crafted into components, modules and other items.",Bruma_Particle.png,rare,803,0,0,803,0
6626,2661,11850,117,Yprasium,"Yprasium is refined and crafted into components, modules and other items.",Yprasium.png,uncommon,2750,0,0,2750,0
6626,3796,11850,105,Silicates,"Silicates are refined and crafted into components, modules and other items.",Silicates.png,abundant,4361,0,0,4361,0
6636,7720,5760,52,Organic Compounds,"Organic Compounds are refined and crafted into components, modules and other items.",Organic_Compound.png,common,1371,0,0,1371,0
6636,7721,5760,114,Ectopolymers,"Ectopolymers are refined and crafted into components, modules and other items.",Ectopolymers.png,common,2446,0,0,2446,0
6636,7722,5760,52,Organic Compounds,"Organic Compounds are refined and crafted into components, modules and other items.",Organic_Compound.png,common,5289,0,0,5289,0
6640,3393,5764,127,Microorganisms,"Microorganisms are refined and crafted into components, modules and other items.",Microorganism.png,rare,699,0,0,699,0
6640,3394,5764,127,Microorganisms,"Microorganisms are refined and crafted into components, modules and other items.",Microorganism.png,rare,1565,0,0,1565,0
6640,3395,5764,40,Polymetals,"Polymetals are refined and crafted into components, modules and other items.",Polymetals.png,common,5764,0,0,5764,0
6647,1384,5771,52,Organic Compounds,"Organic Compounds are refined and crafted into components, modules and other items.",Organic_Compound.png,common,2305,0,0,2305,0
6647,2528,5771,127,Microorganisms,"Microorganisms are refined and crafted into components, modules and other items.",Microorganism.png,rare,608,0,0,608,0
6647,2529,5771,105,Silicates,"Silicates are refined and crafted into components, modules and other items.",Silicates.png,abundant,4223,0,0,4223,0
6649,8152,5773,126,Bruma Particles,"Bruma Particles are refined and crafted into components, modules and other items.",Bruma_Particle.png,rare,733,0,0,733,0
6649,8196,5773,113,Aerogens,"Aerogens are refined and crafted into components, modules and other items.",Aerogens.png,common,5759,0,0,5759,0
6661,20967,5785,107,H2O,"H2O is refined and crafted into components, modules and other items.",H20.png,abundant,5742,0,0,5742,0
6672,7825,5796,127,Microorganisms,"Microorganisms are refined and crafted into components, modules and other items.",Microorganism.png,rare,888,0,0,888,0
6672,7826,5796,40,Polymetals,"Polymetals are refined and crafted into components, modules and other items.",Polymetals.png,common,2977,0,0,2977,0
6672,9736,5796,106,Elastomers,"Elastomers are refined and crafted into components, modules and other items.",Elastomers.png,abundant,4996,0,0,4996,0
6675,3173,5799,53,Ignis Ore,"Ignis Ore is refined and crafted into components, modules and other items.",Ignis_Ore.png,rare,755,0,0,755,0
6675,3174,5799,107,H2O,"H2O is refined and crafted into components, modules and other items.",H20.png,abundant,2675,0,0,2675,0
6675,3175,5799,109,Titanium,"Titanium is refined and crafted into components, modules and other items.",Titanium.png,common,4835,0,0,4835,0
6678,3885,5802,115,Nanofluids,"Nanofluids are refined and crafted into components, modules and other items.",Nanofluids.png,common,2521,0,0,2521,0
6678,7064,5802,115,Nanofluids,"Nanofluids are refined and crafted into components, modules and other items.",Nanofluids.png,common,1473,0,0,1473,0
6678,7196,5802,106,Elastomers,"Elastomers are refined and crafted into components, modules and other items.",Elastomers.png,abundant,4880,0,0,4880,0
6678,4697,11902,105,Silicates,"Silicates are refined and crafted into components, modules and other items.",Silicates.png,abundant,4780,0,0,4780,0
6678,4698,11902,54,Hyperspecular Crystals,"Hyperspecular Crystals are refined and crafted into components, modules and other items.",Hyperspecular_Crystals.png,uncommon,2528,0,0,2528,0
6678,4872,11902,54,Hyperspecular Crystals,"Hyperspecular Crystals are refined and crafted into components, modules and other items.",Hyperspecular_Crystals.png,uncommon,1335,0,0,1335,0
6684,10431,5808,106,Elastomers,"Elastomers are refined and crafted into components, modules and other items.",Elastomers.png,abundant,4297,0,0,4297,0
6684,17930,5808,123,Neolysium,"Neolysium is refined and crafted into components, modules and other items.",Neolysium.png,uncommon,1006,0,0,1006,0
6684,17931,5808,107,H2O,"H2O is refined and crafted into components, modules and other items.",H20.png,abundant,2312,0,0,2312,0
6684,17932,11908,54,Hyperspecular Crystals,"Hyperspecular Crystals are refined and crafted into components, modules and other items.",Hyperspecular_Crystals.png,uncommon,2104,0,0,2104,0
6684,18483,11908,123,Neolysium,"Neolysium is refined and crafted into components, modules and other items.",Neolysium.png,uncommon,4409,0,0,4409,0
6686,18752,5810,42,Base Minerals,"Base Minerals are refined and crafted into components, modules and other items.",Base_Mineral.png,abundant,5942,0,0,5942,0
6686,19538,5810,120,Metamagnetic Ore,"Metamagnetic Ore is refined and crafted into components, modules and other items.",Metamagnetic_Ore.png,uncommon,2408,0,0,2408,0
6686,19603,5810,40,Polymetals,"Polymetals are refined and crafted into components, modules and other items.",Polymetals.png,common,1401,0,0,1401,0
6686,19604,11910,42,Base Minerals,"Base Minerals are refined and crafted into components, modules and other items.",Base_Mineral.png,abundant,5900,0,0,5900,0
6688,4862,5812,128,Tchaikovium,"Tchaikovium is refined and crafted into components, modules and other items.",Tchaikovium.png,rare,800,0,0,800,0
6688,12222,5812,112,Amphoteric Substances,"Amphoteric Substances are refined and crafted into components, modules and other items.",Amphoteric_Substances.png,common,4119,0,0,4119,0
6688,12745,5812,41,Xensium,"Xensium is refined and crafted into components, modules and other items.",Xensium.png,uncommon,2229,0,0,2229,0
6692,3396,5816,114,Ectopolymers,"Ectopolymers are refined and crafted into components, modules and other items.",Ectopolymers.png,common,1202,0,0,1202,0
6692,3397,5816,123,Neolysium,"Neolysium is refined and crafted into components, modules and other items.",Neolysium.png,uncommon,2824,0,0,2824,0
6692,3398,5816,106,Elastomers,"Elastomers are refined and crafted into components, modules and other items.",Elastomers.png,abundant,4387,0,0,4387,0
6698,1385,5822,110,Plutonium,"Plutonium is refined and crafted into components, modules and other items.",Plutonium.png,common,2622,0,0,2622,0
6698,2525,5822,110,Plutonium,"Plutonium is refined and crafted into components, modules and other items.",Plutonium.png,common,5505,0,0,5505,0
6698,2526,5822,53,Ignis Ore,"Ignis Ore is refined and crafted into components, modules and other items.",Ignis_Ore.png,rare,612,0,0,612,0
6698,2527,5822,128,Tchaikovium,"Tchaikovium is refined and crafted into components, modules and other items.",Tchaikovium.png,rare,785,0,0,785,0
6701,2040,5825,127,Microorganisms,"Microorganisms are refined and crafted into components, modules and other items.",Microorganism.png,rare,651,0,0,651,0
6701,2041,5825,42,Base Minerals,"Base Minerals are refined and crafted into components, modules and other items.",Base_Mineral.png,abundant,2729,0,0,2729,0
6701,2042,5825,106,Elastomers,"Elastomers are refined and crafted into components, modules and other items.",Elastomers.png,abundant,4105,0,0,4105,0
6701,2043,5825,106,Elastomers,"Elastomers are refined and crafted into components, modules and other items.",Elastomers.png,abundant,4805,0,0,4805,0
6703,4130,5827,128,Tchaikovium,"Tchaikovium is refined and crafted into components, modules and other items.",Tchaikovium.png,rare,759,0,0,759,0
6703,4131,5827,110,Plutonium,"Plutonium is refined and crafted into components, modules and other items.",Plutonium.png,common,2637,0,0,2637,0
6703,4132,5827,107,H2O,"H2O is refined and crafted into components, modules and other items.",H20.png,abundant,5541,0,0,5541,0
6712,1151,5836,105,Silicates,"Silicates are refined and crafted into components, modules and other items.",Silicates.png,abundant,5242,525,0,4717,525
6712,1521,5836,115,Nanofluids,"Nanofluids are refined and crafted into components, modules and other items.",Nanofluids.png,common,2916,365,0,2551,365
6712,1802,5836,53,Ignis Ore,"Ignis Ore is refined and crafted into components, modules and other items.",Ignis_Ore.png,rare,869,174,0,695,174
6712,2414,11936,42,Base Minerals,"Base Minerals are refined and crafted into components, modules and other items.",Base_Mineral.png,abundant,4423,443,0,3980,443
6712,2415,11936,107,H2O,"H2O is refined and crafted into components, modules and other items.",H20.png,abundant,5310,531,0,4779,531
6712,2800,11936,114,Ectopolymers,"Ectopolymers are refined and crafted into components, modules and other items.",Ectopolymers.png,common,1029,206,0,823,206
6712,2801,11936,106,Elastomers,"Elastomers are refined and crafted into components, modules and other items.",Elastomers.png,abundant,2029,254,0,1775,254
6713,2651,5837,126,Bruma Particles,"Bruma Particles are refined and crafted into components, modules and other items.",Bruma_Particle.png,rare,646,0,0,646,0
6713,2652,5837,126,Bruma Particles,"Bruma Particles are refined and crafted into components, modules and other items.",Bruma_Particle.png,rare,1375,0,0,1375,0
6713,2653,5837,106,Elastomers,"Elastomers are refined and crafted into components, modules and other items.",Elastomers.png,abundant,4111,0,0,4111,0
6713,2654,11937,127,Microorganisms,"Microorganisms are refined and crafted into components, modules and other items.",Microorganism.png,rare,769,0,0,769,0
6713,2655,11937,40,Polymetals,"Polymetals are refined and crafted into components, modules and other items.",Polymetals.png,common,2023,0,0,2023,0
6713,2656,11937,40,Polymetals,"Polymetals are refined and crafted into components, modules and other items.",Polymetals.png,common,5840,0,0,5840,0
6720,3783,5844,121,Hypoatomic Substances,"Hypoatomic Substances are refined and crafted into components, modules and other items.",Hypoatomic_Substances.png,uncommon,2871,0,0,2871,0
6720,3785,5844,126,Bruma Particles,"Bruma Particles are refined and crafted into components, modules and other items.",Bruma_Particle.png,rare,691,691,0,0,691
6720,5645,5844,106,Elastomers,"Elastomers are refined and crafted into components, modules and other items.",Elastomers.png,abundant,4978,0,0,4978,0
6720,4346,11944,121,Hypoatomic Substances,"Hypoatomic Substances are refined and crafted into components, modules and other items.",Hypoatomic_Substances.png,uncommon,2111,0,0,2111,0
6720,4738,11944,115,Nanofluids,"Nanofluids are refined and crafted into components, modules and other items.",Nanofluids.png,common,5605,0,0,5605,0
6720,4873,11944,117,Yprasium,"Yprasium is refined and crafted into components, modules and other items.",Yprasium.png,uncommon,1168,0,0,1168,0
6722,3399,5846,126,Bruma Particles,"Bruma Particles are refined and crafted into components, modules and other items.",Bruma_Particle.png,rare,665,0,0,665,0
6722,3400,5846,113,Aerogens,"Aerogens are refined and crafted into components, modules and other items.",Aerogens.png,common,2898,0,0,2898,0
6722,3401,5846,42,Base Minerals,"Base Minerals are refined and crafted into components, modules and other items.",Base_Mineral.png,abundant,4951,0,0,4951,0
6723,1554,5847,52,Organic Compounds,"Organic Compounds are refined and crafted into components, modules and other items.",Organic_Compound.png,common,2751,0,0,2751,0
6723,1591,5847,106,Elastomers,"Elastomers are refined and crafted into components, modules and other items.",Elastomers.png,abundant,4973,0,0,4973,0
6723,7063,5847,126,Bruma Particles,"Bruma Particles are refined and crafted into components, modules and other items.",Bruma_Particle.png,rare,742,742,0,0,742
6723,4739,11947,107,H2O,"H2O is refined and crafted into components, modules and other items.",H20.png,abundant,2587,0,0,2587,0
6723,4831,11947,121,Hypoatomic Substances,"Hypoatomic Substances are refined and crafted into components, modules and other items.",Hypoatomic_Substances.png,uncommon,1130,0,0,1130,0
6723,4858,11947,42,Base Minerals,"Base Minerals are refined and crafted into components, modules and other items.",Base_Mineral.png,abundant,5694,0,0,5694,0
6723,4859,11947,106,Elastomers,"Elastomers are refined and crafted into components, modules and other items.",Elastomers.png,abundant,5238,0,0,5238,0
6724,1555,5848,112,Amphoteric Substances,"Amphoteric Substances are refined and crafted into components, modules and other items.",Amphoteric_Substances.png,common,4238,0,0,4238,0
6724,2448,5848,127,Microorganisms,"Microorganisms are refined and crafted into components, modules and other items.",Microorganism.png,rare,782,0,0,782,0
6727,3402,5851,126,Bruma Particles,"Bruma Particles are refined and crafted into components, modules and other items.",Bruma_Particle.png,rare,884,0,0,884,0
6727,3403,5851,117,Yprasium,"Yprasium is refined and crafted into components, modules and other items.",Yprasium.png,uncommon,2309,0,0,2309,0
6727,3404,5851,115,Nanofluids,"Nanofluids are refined and crafted into components, modules and other items.",Nanofluids.png,common,4115,0,0,4115,0
6730,1477,5854,115,Nanofluids,"Nanofluids are refined and crafted into components, modules and other items.",Nanofluids.png,common,2011,0,0,2011,0
6730,1934,5854,107,H2O,"H2O is refined and crafted into components, modules and other items.",H20.png,abundant,4254,0,0,4254,0
6730,2436,5854,121,Hypoatomic Substances,"Hypoatomic Substances are refined and crafted into components, modules and other items.",Hypoatomic_Substances.png,uncommon,1052,0,0,1052,0
6737,12112,5861,54,Hyperspecular Crystals,"Hyperspecular Crystals are refined and crafted into components, modules and other items.",Hyperspecular_Crystals.png,uncommon,1091,0,0,1091,0
6737,18590,11961,126,Bruma Particles,"Bruma Particles are refined and crafted into components, modules and other items.",Bruma_Particle.png,rare,877,0,0,877,0
6750,3405,5874,114,Ectopolymers,"Ectopolymers are refined and crafted into components, modules and other items.",Ectopolymers.png,common,1047,0,0,1047,0
6750,3406,5874,119,Novis Compounds,"Novis Compounds are refined and crafted into components, modules and other items.",Novis_Compound.png,uncommon,2149,0,0,2149,0
6750,3407,5874,106,Elastomers,"Elastomers are refined and crafted into components, modules and other items.",Elastomers.png,abundant,5513,0,0,5513,0
6751,9794,5875,117,Yprasium,"Yprasium is refined and crafted into components, modules and other items.",Yprasium.png,uncommon,1416,0,0,1416,0
6753,20132,5877,112,Amphoteric Substances,"Amphoteric Substances are refined and crafted into components, modules and other items.",Amphoteric_Substances.png,common,5900,0,0,5900,0
6755,4133,5879,54,Hyperspecular Crystals,"Hyperspecular Crystals are refined and crafted into components, modules and other items.",Hyperspecular_Crystals.png,uncommon,1419,0,0,1419,0
6755,4134,5879,110,Plutonium,"Plutonium is refined and crafted into components, modules and other items.",Plutonium.png,common,2125,0,0,2125,0
6755,4135,5879,106,Elastomers,"Elastomers are refined and crafted into components, modules and other items.",Elastomers.png,abundant,5450,0,0,5450,0
6760,1522,5884,106,Elastomers,"Elastomers are refined and crafted into components, modules and other items.",Elastomers.png,abundant,2287,286,0,2001,286
6760,1803,5884,123,Neolysium,"Neolysium is refined and crafted into components, modules and other items.",Neolysium.png,uncommon,1085,217,0,868,217
6760,1804,5884,123,Neolysium,"Neolysium is refined and crafted into components, modules and other items.",Neolysium.png,uncommon,1192,239,0,953,239
6760,1978,5884,107,H2O,"H2O is refined and crafted into components, modules and other items.",H20.png,abundant,5438,544,0,4894,544
6760,2542,11984,107,H2O,"H2O is refined and crafted into components, modules and other items.",H20.png,abundant,5412,542,0,4870,542
6760,2802,11984,127,Microorganisms,"Microorganisms are refined and crafted into components, modules and other items.",Microorganism.png,rare,728,146,0,582,146
6760,2803,11984,52,Organic Compounds,"Organic Compounds are refined and crafted into components, modules and other items.",Organic_Compound.png,common,2979,373,0,2606,373
6764,3169,5888,115,Nanofluids,"Nanofluids are refined and crafted into components, modules and other items.",Nanofluids.png,common,1002,0,0,1002,0
6764,3170,5888,115,Nanofluids,"Nanofluids are refined and crafted into components, modules and other items.",Nanofluids.png,common,1479,0,0,1479,0
6764,3171,5888,115,Nanofluids,"Nanofluids are refined and crafted into components, modules and other items.",Nanofluids.png,common,2742,0,0,2742,0
6764,3172,5888,107,H2O,"H2O is refined and crafted into components, modules and other items.",H20.png,abundant,5265,0,0,5265,0
6766,2704,5890,107,H2O,"H2O is refined and crafted into components, modules and other items.",H20.png,abundant,2790,0,0,2790,0
6766,2705,5890,107,H2O,"H2O is refined and crafted into components, modules and other items.",H20.png,abundant,2144,0,0,2144,0
6766,3514,5890,107,H2O,"H2O is refined and crafted into components, modules and other items.",H20.png,abundant,5605,1122,0,4483,1122
6769,14639,5893,112,Amphoteric Substances,"Amphoteric Substances are refined and crafted into components, modules and other items.",Amphoteric_Substances.png,common,2817,0,0,2817,0
6773,383,5897,123,Neolysium,"Neolysium is refined and crafted into components, modules and other items.",Neolysium.png,uncommon,1308,0,0,1308,0
6773,384,5897,53,Ignis Ore,"Ignis Ore is refined and crafted into components, modules and other items.",Ignis_Ore.png,rare,899,0,0,899,0
6773,385,5897,112,Amphoteric Substances,"Amphoteric Substances are refined and crafted into components, modules and other items.",Amphoteric_Substances.png,common,2745,0,0,2745,0
6773,386,5897,109,Titanium,"Titanium is refined and crafted into components, modules and other items.",Titanium.png,common,5556,0,0,5556,0
6773,387,11997,52,Organic Compounds,"Organic Compounds are refined and crafted into components, modules and other items.",Organic_Compound.png,common,4995,0,0,4995,0
6774,646,5898,42,Base Minerals,"Base Minerals are refined and crafted into components, modules and other items.",Base_Mineral.png,abundant,5022,0,0,5022,0
6780,1276,5904,128,Tchaikovium,"Tchaikovium is refined and crafted into components, modules and other items.",Tchaikovium.png,rare,696,0,0,696,0
6780,1324,5904,106,Elastomers,"Elastomers are refined and crafted into components, modules and other items.",Elastomers.png,abundant,5862,0,0,5862,0
6780,1325,5904,114,Ectopolymers,"Ectopolymers are refined and crafted into components, modules and other items.",Ectopolymers.png,common,4075,0,0,4075,0
6780,1476,5904,114,Ectopolymers,"Ectopolymers are refined and crafted into components, modules and other items.",Ectopolymers.png,common,2326,0,0,2326,0
6780,18108,12004,114,Ectopolymers,"Ectopolymers are refined and crafted into components, modules and other items.",Ectopolymers.png,common,1445,0,0,1445,0
6780,18109,12004,106,Elastomers,"Elastomers are refined and crafted into components, modules and other items.",Elastomers.png,abundant,2002,0,0,2002,0
6780,18110,12004,119,Novis Compounds,"Novis Compounds are refined and crafted into components, modules and other items.",Novis_Compound.png,uncommon,5296,0,0,5296,0
6789,3408,5913,127,Microorganisms,"Microorganisms are refined and crafted into components, modules and other items.",Microorganism.png,rare,678,0,0,678,0
6789,3409,5913,40,Polymetals,"Polymetals are refined and crafted into components, modules and other items.",Polymetals.png,common,2406,0,0,2406,0
6789,3410,5913,106,Elastomers,"Elastomers are refined and crafted into components, modules and other items.",Elastomers.png,abundant,5488,0,0,5488,0
6791,1757,5915,40,Polymetals,"Polymetals are refined and crafted into components, modules and other items.",Polymetals.png,common,2251,0,0,2251,0
6791,3574,5915,127,Microorganisms,"Microorganisms are refined and crafted into components, modules and other items.",Microorganism.png,rare,629,0,0,629,0
6791,5283,5915,106,Elastomers,"Elastomers are refined and crafted into components, modules and other items.",Elastomers.png,abundant,5120,0,0,5120,0
6791,3518,12015,41,Xensium,"Xensium is refined and crafted into components, modules and other items.",Xensium.png,uncommon,1128,0,0,1128,0
6791,3712,12015,106,Elastomers,"Elastomers are refined and crafted into components, modules and other items.",Elastomers.png,abundant,5591,0,0,5591,0
6793,649,5917,106,Elastomers,"Elastomers are refined and crafted into components, modules and other items.",Elastomers.png,abundant,4477,0,0,4477,0
6801,3411,5925,52,Organic Compounds,"Organic Compounds are refined and crafted into components, modules and other items.",Organic_Compound.png,common,1456,0,0,1456,0
6801,3412,5925,107,H2O,"H2O is refined and crafted into components, modules and other items.",H20.png,abundant,2241,0,0,2241,0
6801,3413,5925,52,Organic Compounds,"Organic Compounds are refined and crafted into components, modules and other items.",Organic_Compound.png,common,2353,0,0,2353,0
6801,3414,5925,105,Silicates,"Silicates are refined and crafted into components, modules and other items.",Silicates.png,abundant,4770,0,0,4770,0
6804,1756,5928,128,Tchaikovium,"Tchaikovium is refined and crafted into components, modules and other items.",Tchaikovium.png,rare,777,0,0,777,0
6804,1871,5928,110,Plutonium,"Plutonium is refined and crafted into components, modules and other items.",Plutonium.png,common,2925,0,0,2925,0
6804,1872,5928,106,Elastomers,"Elastomers are refined and crafted into components, modules and other items.",Elastomers.png,abundant,4322,0,0,4322,0
6806,7716,5930,113,Aerogens,"Aerogens are refined and crafted into components, modules and other items.",Aerogens.png,common,1440,0,0,1440,0
6806,7717,5930,109,Titanium,"Titanium is refined and crafted into components, modules and other items.",Titanium.png,common,2538,0,0,2538,0
6806,7718,5930,113,Aerogens,"Aerogens are refined and crafted into components, modules and other items.",Aerogens.png,common,5913,0,0,5913,0
6806,7719,5930,107,H2O,"H2O is refined and crafted into components, modules and other items.",H20.png,abundant,5911,0,0,5911,0
6808,3415,5932,52,Organic Compounds,"Organic Compounds are refined and crafted into components, modules and other items.",Organic_Compound.png,common,1428,0,0,1428,0
6808,3416,5932,52,Organic Compounds,"Organic Compounds are refined and crafted into components, modules and other items.",Organic_Compound.png,common,2048,0,0,2048,0
6808,3417,5932,123,Neolysium,"Neolysium is refined and crafted into components, modules and other items.",Neolysium.png,uncommon,4442,0,0,4442,0
6821,2332,5945,110,Plutonium,"Plutonium is refined and crafted into components, modules and other items.",Plutonium.png,common,1022,0,0,1022,0
6821,2333,5945,114,Ectopolymers,"Ectopolymers are refined and crafted into components, modules and other items.",Ectopolymers.png,common,2274,0,0,2274,0
6821,2334,5945,114,Ectopolymers,"Ectopolymers are refined and crafted into components, modules and other items.",Ectopolymers.png,common,5548,0,0,5548,0
6821,5352,12045,110,Plutonium,"Plutonium is refined and crafted into components, modules and other items.",Plutonium.png,common,2566,0,0,2566,0
6821,5519,12045,126,Bruma Particles,"Bruma Particles are refined and crafted into components, modules and other items.",Bruma_Particle.png,rare,791,0,0,791,0
6821,5743,12045,106,Elastomers,"Elastomers are refined and crafted into components, modules and other items.",Elastomers.png,abundant,5948,0,0,5948,0
6823,102,5947,123,Neolysium,"Neolysium is refined and crafted into components, modules and other items.",Neolysium.png,uncommon,1041,0,0,1041,0
6823,1599,5947,112,Amphoteric Substances,"Amphoteric Substances are refined and crafted into components, modules and other items.",Amphoteric_Substances.png,common,5169,0,0,5169,0
6823,1724,5947,106,Elastomers,"Elastomers are refined and crafted into components, modules and other items.",Elastomers.png,abundant,2736,0,0,2736,0
6823,3877,12047,109,Titanium,"Titanium is refined and crafted into components, modules and other items.",Titanium.png,common,2589,0,0,2589,0
6823,3889,12047,53,Ignis Ore,"Ignis Ore is refined and crafted into components, modules and other items.",Ignis_Ore.png,rare,737,0,0,737,0
6823,4284,12047,105,Silicates,"Silicates are refined and crafted into components, modules and other items.",Silicates.png,abundant,4103,0,0,4103,0
6828,15546,5952,109,Titanium,"Titanium is refined and crafted into components, modules and other items.",Titanium.png,common,1359,0,0,1359,0
6828,17095,5952,53,Ignis Ore,"Ignis Ore is refined and crafted into components, modules and other items.",Ignis_Ore.png,rare,1327,0,0,1327,0
6828,18516,5952,113,Aerogens,"Aerogens are refined and crafted into components, modules and other items.",Aerogens.png,common,4762,0,0,4762,0
6841,1680,5965,109,Titanium,"Titanium is refined and crafted into components, modules and other items.",Titanium.png,common,1255,0,0,1255,0
6841,1771,5965,118,Platinyx,"Platinyx is refined and crafted into components, modules and other items.",Platinyx.png,uncommon,2608,0,0,2608,0
6841,1773,5965,105,Silicates,"Silicates are refined and crafted into components, modules and other items.",Silicates.png,abundant,5959,0,0,5959,0
6841,7620,12065,119,Novis Compounds,"Novis Compounds are refined and crafted into components, modules and other items.",Novis_Compound.png,uncommon,1348,0,0,1348,0
6841,7664,12065,114,Ectopolymers,"Ectopolymers are refined and crafted into components, modules and other items.",Ectopolymers.png,common,2698,0,0,2698,0
6841,7695,12065,107,H2O,"H2O is refined and crafted into components, modules and other items.",H20.png,abundant,4839,0,0,4839,0
6844,138,5968,40,Polymetals,"Polymetals are refined and crafted into components, modules and other items.",Polymetals.png,common,4698,0,0,4698,0
6844,711,5968,53,Ignis Ore,"Ignis Ore is refined and crafted into components, modules and other items.",Ignis_Ore.png,rare,1412,354,0,1058,354
6845,793,5969,126,Bruma Particles,"Bruma Particles are refined and crafted into components, modules and other items.",Bruma_Particle.png,rare,609,0,0,609,0
6845,794,5969,123,Neolysium,"Neolysium is refined and crafted into components, modules and other items.",Neolysium.png,uncommon,1045,0,0,1045,0
6845,795,5969,126,Bruma Particles,"Bruma Particles are refined and crafted into components, modules and other items.",Bruma_Particle.png,rare,1678,0,0,1678,0
6845,796,5969,105,Silicates,"Silicates are refined and crafted into components, modules and other items.",Silicates.png,abundant,2810,0,0,2810,0
6845,797,5969,42,Base Minerals,"Base Minerals are refined and crafted into components, modules and other items.",Base_Mineral.png,abundant,4491,0,0,4491,0
6845,69,12069,126,Bruma Particles,"Bruma Particles are refined and crafted into components, modules and other items.",Bruma_Particle.png,rare,644,129,0,515,129
6845,16864,12069,54,Hyperspecular Crystals,"Hyperspecular Crystals are refined and crafted into components, modules and other items.",Hyperspecular_Crystals.png,uncommon,2569,0,0,2569,0
6845,16865,12069,42,Base Minerals,"Base Minerals are refined and crafted into components, modules and other items.",Base_Mineral.png,abundant,4046,0,0,4046,0
6856,292,5980,114,Ectopolymers,"Ectopolymers are refined and crafted into components, modules and other items.",Ectopolymers.png,common,1159,232,0,927,232
6856,10233,5980,105,Silicates,"Silicates are refined and crafted into components, modules and other items.",Silicates.png,abundant,4646,0,0,4646,0
6856,10594,5980,52,Organic Compounds,"Organic Compounds are refined and crafted into components, modules and other items.",Organic_Compound.png,common,2086,0,0,2086,0
6856,10595,12080,53,Ignis Ore,"Ignis Ore is refined and crafted into components, modules and other items.",Ignis_Ore.png,rare,1681,0,0,1681,0
6861,3166,5985,117,Yprasium,"Yprasium is refined and crafted into components, modules and other items.",Yprasium.png,uncommon,1091,0,0,1091,0
6861,3167,5985,109,Titanium,"Titanium is refined and crafted into components, modules and other items.",Titanium.png,common,2183,0,0,2183,0
6861,3168,5985,105,Silicates,"Silicates are refined and crafted into components, modules and other items.",Silicates.png,abundant,5390,0,0,5390,0
6874,1039,5998,53,Ignis Ore,"Ignis Ore is refined and crafted into components, modules and other items.",Ignis_Ore.png,rare,887,0,0,887,0
6874,1112,5998,109,Titanium,"Titanium is refined and crafted into components, modules and other items.",Titanium.png,common,2066,0,0,2066,0
6874,1113,5998,42,Base Minerals,"Base Minerals are refined and crafted into components, modules and other items.",Base_Mineral.png,abundant,4296,0,0,4296,0
6874,3742,12098,109,Titanium,"Titanium is refined and crafted into components, modules and other items.",Titanium.png,common,1095,0,0,1095,0
6874,8878,12098,109,Titanium,"Titanium is refined and crafted into components, modules and other items.",Titanium.png,common,2642,0,0,2642,0
6874,9542,12098,109,Titanium,"Titanium is refined and crafted into components, modules and other items.",Titanium.png,common,4844,0,0,4844,0
6878,567,6002,53,Ignis Ore,"Ignis Ore is refined and crafted into components, modules and other items.",Ignis_Ore.png,rare,672,0,0,672,0
6878,2646,6002,54,Hyperspecular Crystals,"Hyperspecular Crystals are refined and crafted into components, modules and other items.",Hyperspecular_Crystals.png,uncommon,2239,0,0,2239,0
6878,2647,6002,110,Plutonium,"Plutonium is refined and crafted into components, modules and other items.",Plutonium.png,common,5355,0,0,5355,0
6878,2648,6002,42,Base Minerals,"Base Minerals are refined and crafted into components, modules and other items.",Base_Mineral.png,abundant,5950,0,0,5950,0
6878,1086,12102,113,Aerogens,"Aerogens are refined and crafted into components, modules and other items.",Aerogens.png,common,2079,0,0,2079,0
6878,2649,12102,126,Bruma Particles,"Bruma Particles are refined and crafted into components, modules and other items.",Bruma_Particle.png,rare,828,0,0,828,0
6878,2650,12102,42,Base Minerals,"Base Minerals are refined and crafted into components, modules and other items.",Base_Mineral.png,abundant,5318,0,0,5318,0
6879,3426,6003,41,Xensium,"Xensium is refined and crafted into components, modules and other items.",Xensium.png,uncommon,1473,0,0,1473,0
6879,3427,6003,107,H2O,"H2O is refined and crafted into components, modules and other items.",H20.png,abundant,2350,0,0,2350,0
6879,3428,6003,107,H2O,"H2O is refined and crafted into components, modules and other items.",H20.png,abundant,5725,0,0,5725,0
6884,1386,6008,41,Xensium,"Xensium is refined and crafted into components, modules and other items.",Xensium.png,uncommon,2954,0,0,2954,0
6884,2523,6008,126,Bruma Particles,"Bruma Particles are refined and crafted into components, modules and other items.",Bruma_Particle.png,rare,713,0,0,713,0
6884,2524,6008,107,H2O,"H2O is refined and crafted into components, modules and other items.",H20.png,abundant,5018,0,0,5018,0
6891,3162,6015,41,Xensium,"Xensium is refined and crafted into components, modules and other items.",Xensium.png,uncommon,1000,0,0,1000,0
6891,3163,6015,119,Novis Compounds,"Novis Compounds are refined and crafted into components, modules and other items.",Novis_Compound.png,uncommon,2466,0,0,2466,0
6891,3164,6015,41,Xensium,"Xensium is refined and crafted into components, modules and other items.",Xensium.png,uncommon,2263,0,0,2263,0
6891,3165,6015,40,Polymetals,"Polymetals are refined and crafted into components, modules and other items.",Polymetals.png,common,5913,0,0,5913,0
6895,3159,6019,40,Polymetals,"Polymetals are refined and crafted into components, modules and other items.",Polymetals.png,common,1498,0,0,1498,0
6895,3160,6019,40,Polymetals,"Polymetals are refined and crafted into components, modules and other items.",Polymetals.png,common,2022,0,0,2022,0
6895,3161,6019,107,H2O,"H2O is refined and crafted into components, modules and other items.",H20.png,abundant,4248,0,0,4248,0
6897,16737,6021,53,Ignis Ore,"Ignis Ore is refined and crafted into components, modules and other items.",Ignis_Ore.png,rare,809,0,0,809,0
6897,16738,6021,127,Microorganisms,"Microorganisms are refined and crafted into components, modules and other items.",Microorganism.png,rare,809,0,0,809,0
6897,16739,6021,52,Organic Compounds,"Organic Compounds are refined and crafted into components, modules and other items.",Organic_Compound.png,common,2245,0,0,2245,0
6897,16740,6021,107,H2O,"H2O is refined and crafted into components, modules and other items.",H20.png,abundant,5936,0,0,5936,0
6899,2640,6023,127,Microorganisms,"Microorganisms are refined and crafted into components, modules and other items.",Microorganism.png,rare,792,0,0,792,0
6899,2641,6023,112,Amphoteric Substances,"Amphoteric Substances are refined and crafted into components, modules and other items.",Amphoteric_Substances.png,common,2466,0,0,2466,0
6899,2642,6023,112,Amphoteric Substances,"Amphoteric Substances are refined and crafted into components, modules and other items.",Amphoteric_Substances.png,common,4140,0,0,4140,0
6899,2643,12123,127,Microorganisms,"Microorganisms are refined and crafted into components, modules and other items.",Microorganism.png,rare,762,0,0,762,0
6899,2644,12123,120,Metamagnetic Ore,"Metamagnetic Ore is refined and crafted into components, modules and other items.",Metamagnetic_Ore.png,uncommon,2136,0,0,2136,0
6899,2645,12123,106,Elastomers,"Elastomers are refined and crafted into components, modules and other items.",Elastomers.png,abundant,5846,0,0,5846,0
6905,2065,6029,40,Polymetals,"Polymetals are refined and crafted into components, modules and other items.",Polymetals.png,common,1282,0,0,1282,0
6905,2328,6029,110,Plutonium,"Plutonium is refined and crafted into components, modules and other items.",Plutonium.png,common,2245,562,0,1683,562
6905,2582,6029,128,Tchaikovium,"Tchaikovium is refined and crafted into components, modules and other items.",Tchaikovium.png,rare,3958,1188,0,2770,1188
6910,3782,6034,109,Titanium,"Titanium is refined and crafted into components, modules and other items.",Titanium.png,common,2515,0,0,2515,0
6910,3784,6034,123,Neolysium,"Neolysium is refined and crafted into components, modules and other items.",Neolysium.png,uncommon,1488,0,0,1488,0
6910,5644,6034,109,Titanium,"Titanium is refined and crafted into components, modules and other items.",Titanium.png,common,4505,0,0,4505,0
6910,4735,12134,113,Aerogens,"Aerogens are refined and crafted into components, modules and other items.",Aerogens.png,common,2243,0,0,2243,0
6910,4830,12134,121,Hypoatomic Substances,"Hypoatomic Substances are refined and crafted into components, modules and other items.",Hypoatomic_Substances.png,uncommon,1464,0,0,1464,0
6910,4857,12134,42,Base Minerals,"Base Minerals are refined and crafted into components, modules and other items.",Base_Mineral.png,abundant,4828,0,0,4828,0
6914,18275,6038,54,Hyperspecular Crystals,"Hyperspecular Crystals are refined and crafted into components, modules and other items.",Hyperspecular_Crystals.png,uncommon,1454,0,0,1454,0
6914,18276,6038,114,Ectopolymers,"Ectopolymers are refined and crafted into components, modules and other items.",Ectopolymers.png,common,2016,0,0,2016,0
6914,18277,6038,114,Ectopolymers,"Ectopolymers are refined and crafted into components, modules and other items.",Ectopolymers.png,common,5631,0,0,5631,0
6915,911,6039,106,Elastomers,"Elastomers are refined and crafted into components, modules and other items.",Elastomers.png,abundant,5458,0,0,5458,0
6915,945,6039,107,H2O,"H2O is refined and crafted into components, modules and other items.",H20.png,abundant,2530,0,0,2530,0
6915,1135,6039,128,Tchaikovium,"Tchaikovium is refined and crafted into components, modules and other items.",Tchaikovium.png,rare,729,0,0,729,0
6915,18111,12139,54,Hyperspecular Crystals,"Hyperspecular Crystals are refined and crafted into components, modules and other items.",Hyperspecular_Crystals.png,uncommon,1280,0,0,1280,0
6915,18112,12139,121,Hypoatomic Substances,"Hypoatomic Substances are refined and crafted into components, modules and other items.",Hypoatomic_Substances.png,uncommon,2915,0,0,2915,0
6915,18113,12139,106,Elastomers,"Elastomers are refined and crafted into components, modules and other items.",Elastomers.png,abundant,4687,0,0,4687,0
6934,1950,6058,105,Silicates,"Silicates are refined and crafted into components, modules and other items.",Silicates.png,abundant,5243,0,0,5243,0
6934,1951,6058,109,Titanium,"Titanium is refined and crafted into components, modules and other items.",Titanium.png,common,2264,0,0,2264,0
6934,7263,6058,53,Ignis Ore,"Ignis Ore is refined and crafted into components, modules and other items.",Ignis_Ore.png,rare,734,294,0,440,294
6934,4736,12158,112,Amphoteric Substances,"Amphoteric Substances are refined and crafted into components, modules and other items.",Amphoteric_Substances.png,common,2783,0,0,2783,0
6934,4829,12158,109,Titanium,"Titanium is refined and crafted into components, modules and other items.",Titanium.png,common,1123,0,0,1123,0
6934,4855,12158,115,Nanofluids,"Nanofluids are refined and crafted into components, modules and other items.",Nanofluids.png,common,4828,0,0,4828,0
6934,4856,12158,109,Titanium,"Titanium is refined and crafted into components, modules and other items.",Titanium.png,common,4656,0,0,4656,0
6935,380,6059,105,Silicates,"Silicates are refined and crafted into components, modules and other items.",Silicates.png,abundant,5692,0,0,5692,0
6935,2316,6059,110,Plutonium,"Plutonium is refined and crafted into components, modules and other items.",Plutonium.png,common,1378,0,0,1378,0
6935,2575,6059,105,Silicates,"Silicates are refined and crafted into components, modules and other items.",Silicates.png,abundant,2015,0,0,2015,0
6935,2576,6059,128,Tchaikovium,"Tchaikovium is refined and crafted into components, modules and other items.",Tchaikovium.png,rare,1302,0,0,1302,0
6935,3942,12159,106,Elastomers,"Elastomers are refined and crafted into components, modules and other items.",Elastomers.png,abundant,2461,0,0,2461,0
6935,4236,12159,110,Plutonium,"Plutonium is refined and crafted into components, modules and other items.",Plutonium.png,common,1335,0,0,1335,0
6935,4283,12159,42,Base Minerals,"Base Minerals are refined and crafted into components, modules and other items.",Base_Mineral.png,abundant,5756,0,0,5756,0
6939,13036,6063,120,Metamagnetic Ore,"Metamagnetic Ore is refined and crafted into components, modules and other items.",Metamagnetic_Ore.png,uncommon,2791,0,0,2791,0
6939,13089,6063,109,Titanium,"Titanium is refined and crafted into components, modules and other items.",Titanium.png,common,1196,0,0,1196,0
6939,18582,6063,110,Plutonium,"Plutonium is refined and crafted into components, modules and other items.",Plutonium.png,common,4235,0,0,4235,0
6940,7712,6064,53,Ignis Ore,"Ignis Ore is refined and crafted into components, modules and other items.",Ignis_Ore.png,rare,836,0,0,836,0
6940,7713,6064,107,H2O,"H2O is refined and crafted into components, modules and other items.",H20.png,abundant,2913,0,0,2913,0
6940,7714,6064,105,Silicates,"Silicates are refined and crafted into components, modules and other items.",Silicates.png,abundant,5566,0,0,5566,0
6940,7715,6064,109,Titanium,"Titanium is refined and crafted into components, modules and other items.",Titanium.png,common,4025,0,0,4025,0
6946,1863,6070,109,Titanium,"Titanium is refined and crafted into components, modules and other items.",Titanium.png,common,1070,0,0,1070,0
6946,1864,6070,123,Neolysium,"Neolysium is refined and crafted into components, modules and other items.",Neolysium.png,uncommon,1159,0,0,1159,0
6946,1928,6070,118,Platinyx,"Platinyx is refined and crafted into components, modules and other items.",Platinyx.png,uncommon,2899,726,0,2173,726
6946,2029,6070,42,Base Minerals,"Base Minerals are refined and crafted into components, modules and other items.",Base_Mineral.png,abundant,5625,0,0,5625,0
6946,1865,12170,126,Bruma Particles,"Bruma Particles are refined and crafted into components, modules and other items.",Bruma_Particle.png,rare,752,0,0,752,0
6946,1958,12170,118,Platinyx,"Platinyx is refined and crafted into components, modules and other items.",Platinyx.png,uncommon,2278,0,0,2278,0
6946,1959,12170,123,Neolysium,"Neolysium is refined and crafted into components, modules and other items.",Neolysium.png,uncommon,2385,0,0,2385,0
6948,4084,6072,109,Titanium,"Titanium is refined and crafted into components, modules and other items.",Titanium.png,common,2086,0,0,2086,0
6948,4085,6072,106,Elastomers,"Elastomers are refined and crafted into components, modules and other items.",Elastomers.png,abundant,4876,0,0,4876,0
6948,4205,6072,121,Hypoatomic Substances,"Hypoatomic Substances are refined and crafted into components, modules and other items.",Hypoatomic_Substances.png,uncommon,1465,0,0,1465,0
6948,4684,12172,121,Hypoatomic Substances,"Hypoatomic Substances are refined and crafted into components, modules and other items.",Hypoatomic_Substances.png,uncommon,2489,0,0,2489,0
6948,20432,12172,121,Hypoatomic Substances,"Hypoatomic Substances are refined and crafted into components, modules and other items.",Hypoatomic_Substances.png,uncommon,5986,0,0,5986,0
6949,2325,6073,126,Bruma Particles,"Bruma Particles are refined and crafted into components, modules and other items.",Bruma_Particle.png,rare,889,0,0,889,0
6949,2326,6073,107,H2O,"H2O is refined and crafted into components, modules and other items.",H20.png,abundant,2746,0,0,2746,0
6949,2327,6073,107,H2O,"H2O is refined and crafted into components, modules and other items.",H20.png,abundant,4286,0,0,4286,0
6949,4564,12173,127,Microorganisms,"Microorganisms are refined and crafted into components, modules and other items.",Microorganism.png,rare,1851,0,0,1851,0
6949,4848,12173,107,H2O,"H2O is refined and crafted into components, modules and other items.",H20.png,abundant,5421,0,0,5421,0
6949,5545,12173,112,Amphoteric Substances,"Amphoteric Substances are refined and crafted into components, modules and other items.",Amphoteric_Substances.png,common,1092,0,0,1092,0
6949,5546,12173,119,Novis Compounds,"Novis Compounds are refined and crafted into components, modules and other items.",Novis_Compound.png,uncommon,1115,0,0,1115,0
6950,3156,6074,53,Ignis Ore,"Ignis Ore is refined and crafted into components, modules and other items.",Ignis_Ore.png,rare,857,0,0,857,0
6950,3157,6074,41,Xensium,"Xensium is refined and crafted into components, modules and other items.",Xensium.png,uncommon,2312,0,0,2312,0
6950,3158,6074,112,Amphoteric Substances,"Amphoteric Substances are refined and crafted into components, modules and other items.",Amphoteric_Substances.png,common,4721,0,0,4721,0
6953,3418,6077,118,Platinyx,"Platinyx is refined and crafted into components, modules and other items.",Platinyx.png,uncommon,1467,0,0,1467,0
6953,3419,6077,118,Platinyx,"Platinyx is refined and crafted into components, modules and other items.",Platinyx.png,uncommon,2177,0,0,2177,0
6953,3420,6077,110,Plutonium,"Plutonium is refined and crafted into components, modules and other items.",Plutonium.png,common,5524,0,0,5524,0
6965,1387,6089,114,Ectopolymers,"Ectopolymers are refined and crafted into components, modules and other items.",Ectopolymers.png,common,2654,0,0,2654,0
6965,2521,6089,115,Nanofluids,"Nanofluids are refined and crafted into components, modules and other items.",Nanofluids.png,common,1004,0,0,1004,0
6965,2522,6089,106,Elastomers,"Elastomers are refined and crafted into components, modules and other items.",Elastomers.png,abundant,5005,0,0,5005,0
6970,18565,6094,110,Plutonium,"Plutonium is refined and crafted into components, modules and other items.",Plutonium.png,common,2128,0,0,2128,0
6970,18566,6094,106,Elastomers,"Elastomers are refined and crafted into components, modules and other items.",Elastomers.png,abundant,2592,0,0,2592,0
6970,18567,6094,42,Base Minerals,"Base Minerals are refined and crafted into components, modules and other items.",Base_Mineral.png,abundant,4841,0,0,4841,0
6973,3068,6097,123,Neolysium,"Neolysium is refined and crafted into components, modules and other items.",Neolysium.png,uncommon,1106,444,0,662,444
6973,5579,6097,107,H2O,"H2O is refined and crafted into components, modules and other items.",H20.png,abundant,2287,0,0,2287,0
6973,7798,6097,107,H2O,"H2O is refined and crafted into components, modules and other items.",H20.png,abundant,4272,1284,0,2988,1284
6976,1892,6100,107,H2O,"H2O is refined and crafted into components, modules and other items.",H20.png,abundant,4740,948,0,3792,948
6976,1926,6100,118,Platinyx,"Platinyx is refined and crafted into components, modules and other items.",Platinyx.png,uncommon,1490,894,0,596,894
6976,2330,6100,126,Bruma Particles,"Bruma Particles are refined and crafted into components, modules and other items.",Bruma_Particle.png,rare,1602,804,0,798,804
7045,18650,12269,41,Xensium,"Xensium is refined and crafted into components, modules and other items.",Xensium.png,uncommon,1341,0,0,1341,0
7474,20827,12698,127,Microorganisms,"Microorganisms are refined and crafted into components, modules and other items.",Microorganism.png,rare,746,0,0,746,0
7474,20828,12698,41,Xensium,"Xensium is refined and crafted into components, modules and other items.",Xensium.png,uncommon,2674,0,0,2674,0
7474,20829,12698,115,Nanofluids,"Nanofluids are refined and crafted into components, modules and other items.",Nanofluids.png,common,5935,0,0,5935,0
7474,20830,17198,53,Ignis Ore,"Ignis Ore is refined and crafted into components, modules and other items.",Ignis_Ore.png,rare,669,0,0,669,0
7474,20831,17198,121,Hypoatomic Substances,"Hypoatomic Substances are refined and crafted into components, modules and other items.",Hypoatomic_Substances.png,uncommon,2270,0,0,2270,0
7861,19900,13085,109,Titanium,"Titanium is refined and crafted into components, modules and other items.",Titanium.png,common,2364,0,0,2364,0
7861,19967,13085,107,H2O,"H2O is refined and crafted into components, modules and other items.",H20.png,abundant,4357,0,0,4357,0
7861,19968,17585,109,Titanium,"Titanium is refined and crafted into components, modules and other items.",Titanium.png,common,2876,0,0,2876,0
7970,20836,13194,107,H2O,"H2O is refined and crafted into components, modules and other items.",H20.png,abundant,2208,0,0,2208,0
8309,20531,13533,53,Ignis Ore,"Ignis Ore is refined and crafted into components, modules and other items.",Ignis_Ore.png,rare,733,0,0,733,0
8309,20535,13533,40,Polymetals,"Polymetals are refined and crafted into components, modules and other items.",Polymetals.png,common,2018,0,0,2018,0
8309,20560,13533,107,H2O,"H2O is refined and crafted into components, modules and other items.",H20.png,abundant,4775,0,0,4775,0
8309,20561,13533,107,H2O,"H2O is refined and crafted into components, modules and other items.",H20.png,abundant,4705,0,0,4705,0
8309,20692,18033,117,Yprasium,"Yprasium is refined and crafted into components, modules and other items.",Yprasium.png,uncommon,1246,0,0,1246,0
8309,20701,18033,107,H2O,"H2O is refined and crafted into components, modules and other items.",H20.png,abundant,2657,0,0,2657,0
8309,20702,18033,105,Silicates,"Silicates are refined and crafted into components, modules and other items.",Silicates.png,abundant,5716,0,0,5716,0
8309,20703,18033,107,H2O,"H2O is refined and crafted into components, modules and other items.",H20.png,abundant,5889,0,0,5889,0
8328,20791,13552,40,Polymetals,"Polymetals are refined and crafted into components, modules and other items.",Polymetals.png,common,2316,0,0,2316,0
8358,20437,13582,110,Plutonium,"Plutonium is refined and crafted into components, modules and other items.",Plutonium.png,common,1445,0,0,1445,0
8358,20438,13582,40,Polymetals,"Polymetals are refined and crafted into components, modules and other items.",Polymetals.png,common,2216,0,0,2216,0
8358,20439,13582,40,Polymetals,"Polymetals are refined and crafted into components, modules and other items.",Polymetals.png,common,5521,0,0,5521,0
8465,19405,13689,112,Amphoteric Substances,"Amphoteric Substances are refined and crafted into components, modules and other items.",Amphoteric_Substances.png,common,2774,0,0,2774,0
8465,20101,13689,42,Base Minerals,"Base Minerals are refined and crafted into components, modules and other items.",Base_Mineral.png,abundant,4188,0,0,4188,0
8465,20166,13689,123,Neolysium,"Neolysium is refined and crafted into components, modules and other items.",Neolysium.png,uncommon,1361,0,0,1361,0
8786,20968,14010,113,Aerogens,"Aerogens are refined and crafted into components, modules and other items.",Aerogens.png,common,2339,0,0,2339,0
8893,19636,14117,54,Hyperspecular Crystals,"Hyperspecular Crystals are refined and crafted into components, modules and other items.",Hyperspecular_Crystals.png,uncommon,1443,0,0,1443,0
8893,20296,14117,119,Novis Compounds,"Novis Compounds are refined and crafted into components, modules and other items.",Novis_Compound.png,uncommon,2933,0,0,2933,0
8954,18877,14178,107,H2O,"H2O is refined and crafted into components, modules and other items.",H20.png,abundant,4069,0,0,4069,0
8954,19243,14178,112,Amphoteric Substances,"Amphoteric Substances are refined and crafted into components, modules and other items.",Amphoteric_Substances.png,common,2284,286,0,1998,286
8954,19244,14178,118,Platinyx,"Platinyx is refined and crafted into components, modules and other items.",Platinyx.png,uncommon,1381,0,0,1381,0
9048,20647,14272,121,Hypoatomic Substances,"Hypoatomic Substances are refined and crafted into components, modules and other items.",Hypoatomic_Substances.png,uncommon,2340,0,0,2340,0
9928,19009,15152,107,H2O,"H2O is refined and crafted into components, modules and other items.",H20.png,abundant,2290,0,0,2290,0
9928,19933,15152,42,Base Minerals,"Base Minerals are refined and crafted into components, modules and other items.",Base_Mineral.png,abundant,5139,0,0,5139,0
9928,20164,15152,114,Ectopolymers,"Ectopolymers are refined and crafted into components, modules and other items.",Ectopolymers.png,common,1088,0,0,1088,0
9928,20165,19652,107,H2O,"H2O is refined and crafted into components, modules and other items.",H20.png,abundant,2637,0,0,2637,0
10372,18943,15596,105,Silicates,"Silicates are refined and crafted into components, modules and other items.",Silicates.png,abundant,4388,0,0,4388,0
10530,20404,15754,52,Organic Compounds,"Organic Compounds are refined and crafted into components, modules and other items.",Organic_Compound.png,common,2707,0,0,2707,0
10791,20792,16015,127,Microorganisms,"Microorganisms are refined and crafted into components, modules and other items.",Microorganism.png,rare,661,0,0,661,0
10791,20825,16015,107,H2O,"H2O is refined and crafted into components, modules and other items.",H20.png,abundant,2069,0,0,2069,0
10791,20833,16015,112,Amphoteric Substances,"Amphoteric Substances are refined and crafted into components, modules and other items.",Amphoteric_Substances.png,common,4058,0,0,4058,0
10791,20834,16015,107,H2O,"H2O is refined and crafted into components, modules and other items.",H20.png,abundant,4634,0,0,4634,0
10791,20835,20515,119,Novis Compounds,"Novis Compounds are refined and crafted into components, modules and other items.",Novis_Compound.png,uncommon,1016,0,0,1016,0
10791,20857,20515,112,Amphoteric Substances,"Amphoteric Substances are refined and crafted into components, modules and other items.",Amphoteric_Substances.png,common,2476,0,0,2476,0
10791,20957,20515,106,Elastomers,"Elastomers are refined and crafted into components, modules and other items.",Elastomers.png,abundant,4156,0,0,4156,0
10851,20527,16075,109,Titanium,"Titanium is refined and crafted into components, modules and other items.",Titanium.png,common,2966,0,0,2966,0
10893,20795,16117,126,Bruma Particles,"Bruma Particles are refined and crafted into components, modules and other items.",Bruma_Particle.png,rare,696,0,0,696,0
10893,20796,16117,113,Aerogens,"Aerogens are refined and crafted into components, modules and other items.",Aerogens.png,common,2938,0,0,2938,0
10893,20797,16117,42,Base Minerals,"Base Minerals are refined and crafted into components, modules and other items.",Base_Mineral.png,abundant,5631,0,0,5631,0
10893,20798,20617,126,Bruma Particles,"Bruma Particles are refined and crafted into components, modules and other items.",Bruma_Particle.png,rare,621,0,0,621,0
10893,20799,20617,114,Ectopolymers,"Ectopolymers are refined and crafted into components, modules and other items.",Ectopolymers.png,common,2416,0,0,2416,0
10893,20800,20617,113,Aerogens,"Aerogens are refined and crafted into components, modules and other items.",Aerogens.png,common,4511,0,0,4511,0
10893,20801,20617,105,Silicates,"Silicates are refined and crafted into components, modules and other items.",Silicates.png,abundant,5664,0,0,5664,0
11177,20610,16401,114,Ectopolymers,"Ectopolymers are refined and crafted into components, modules and other items.",Ectopolymers.png,common,1155,0,0,1155,0
11177,20650,16401,119,Novis Compounds,"Novis Compounds are refined and crafted into components, modules and other items.",Novis_Compound.png,uncommon,2490,0,0,2490,0
11177,20698,16401,106,Elastomers,"Elastomers are refined and crafted into components, modules and other items.",Elastomers.png,abundant,5651,0,0,5651,0
11177,20760,20901,127,Microorganisms,"Microorganisms are refined and crafted into components, modules and other items.",Microorganism.png,rare,815,0,0,815,0
11177,20761,20901,54,Hyperspecular Crystals,"Hyperspecular Crystals are refined and crafted into components, modules and other items.",Hyperspecular_Crystals.png,uncommon,1458,0,0,1458,0
11177,20793,20901,42,Base Minerals,"Base Minerals are refined and crafted into components, modules and other items.",Base_Mineral.png,abundant,2369,0,0,2369,0
11177,20824,20901,106,Elastomers,"Elastomers are refined and crafted into components, modules and other items.",Elastomers.png,abundant,4478,0,0,4478,0
11251,19306,16475,109,Titanium,"Titanium is refined and crafted into components, modules and other items.",Titanium.png,common,2598,0,0,2598,0
11251,19471,16475,112,Amphoteric Substances,"Amphoteric Substances are refined and crafted into components, modules and other items.",Amphoteric_Substances.png,common,4123,0,0,4123,0
11251,19572,16475,53,Ignis Ore,"Ignis Ore is refined and crafted into components, modules and other items.",Ignis_Ore.png,rare,894,0,0,894,0
11466,20802,16690,127,Microorganisms,"Microorganisms are refined and crafted into components, modules and other items.",Microorganism.png,rare,679,0,0,679,0
11466,20803,16690,106,Elastomers,"Elastomers are refined and crafted into components, modules and other items.",Elastomers.png,abundant,2104,0,0,2104,0
